BAY,BAM,BTM,Gender,Score,RAY,RAM,RTM,D,RLD
10,1,121,M,5,5,5,65,-56,Severe
10,1,121,F,23,6,4,76,-45,Severe
6,10,82,M,60,9,2,110,28,Well
7,5,89,M,110,14,3,171,82,Well
10,10,130,M,91,12,4,148,18,Well
14,9,177,F,99,13,1,157,-20,Severe
5,8,68,F,89,12,1,145,77,Well
13,2,158,F,26,6,6,78,-80,Severe
7,7,91,F,33,6,11,83,-8,Severe
9,2,110,M,82,11,5,137,27,Well
16,0,192,F,19,6,1,73,-119,Severe
11,3,135,F,61,9,3,111,-24,Severe
5,3,63,F,21,6,2,74,11,Well
16,3,195,M,101,13,4,160,-35,Severe
12,10,154,F,81,11,4,136,-18,Severe
8,5,101,F,77,10,11,131,30,Well
17,3,207,F,11,5,8,68,-139,Severe
16,5,197,M,107,13,11,167,-30,Severe
12,8,152,F,17,6,0,72,-80,Severe
15,5,185,M,95,12,9,153,-32,Severe
18,10,226,M,16,5,11,71,-155,Severe
15,1,181,F,17,6,0,72,-109,Severe
17,1,205,F,8,5,6,66,-139,Severe
9,3,111,F,61,9,3,111,0,Neutral
11,2,134,F,70,10,2,122,-12,Severe
15,5,185,M,33,6,11,83,-102,Severe
7,4,88,M,79,11,1,133,45,Well
16,1,193,M,90,12,3,147,-46,Severe
12,1,145,M,27,6,7,79,-66,Severe
10,3,123,F,11,5,8,68,-55,Severe
17,2,206,M,44,7,9,93,-113,Severe
5,0,60,F,49,8,2,98,38,Well
18,1,217,F,44,7,9,93,-124,Severe
6,0,72,F,77,10,11,131,59,Well
10,6,126,F,82,11,5,137,11,Well
11,9,141,M,108,14,0,168,27,Well
6,1,73,F,40,7,5,89,16,Well
8,7,103,F,17,6,0,72,-31,Severe
5,2,62,F,76,10,10,130,68,Well
10,10,130,F,100,13,3,159,29,Well
17,8,212,M,18,6,1,73,-139,Severe
6,0,72,F,36,7,2,86,14,Well
17,9,213,M,40,7,5,89,-124,Severe
5,5,65,M,18,6,1,73,8,Well
18,10,226,M,30,6,9,81,-145,Severe
18,8,224,F,69,10,1,121,-103,Severe
11,9,141,M,72,10,4,124,-17,Severe
11,1,133,M,12,5,9,69,-64,Severe
14,0,168,M,42,7,7,91,-77,Severe
9,6,114,F,39,7,5,89,-25,Severe
13,5,161,F,98,13,0,156,-5,Mild
14,3,171,F,82,11,5,137,-34,Severe
18,6,222,M,10,5,7,67,-155,Severe
16,8,200,M,82,11,5,137,-63,Severe
11,5,137,M,103,13,6,162,25,Well
14,6,174,F,88,12,0,144,-30,Severe
7,3,87,F,66,9,9,117,30,Well
15,1,181,M,51,8,4,100,-81,Severe
18,11,227,F,72,10,4,124,-103,Severe
18,11,227,F,80,11,3,135,-92,Severe
14,3,171,F,9,5,7,67,-104,Severe
7,4,88,F,94,12,7,151,63,Well
5,1,61,M,12,5,9,69,8,Well
18,7,223,M,52,8,5,101,-122,Severe
6,4,76,F,108,14,0,168,92,Well
15,7,187,M,106,13,10,166,-21,Severe
18,9,225,M,52,8,5,101,-124,Severe
14,9,177,M,51,8,4,100,-77,Severe
12,3,147,F,40,7,5,89,-58,Severe
7,9,93,F,48,8,1,97,4,Good
18,7,223,M,27,6,7,79,-144,Severe
13,7,163,F,95,12,9,153,-10,Severe
5,6,66,M,29,6,8,80,14,Well
6,5,77,F,55,8,8,104,27,Well
9,2,110,F,22,6,3,75,-35,Severe
15,10,190,M,66,9,9,117,-73,Severe
7,11,95,F,56,8,9,105,10,Well
12,10,154,M,48,8,1,97,-57,Severe
12,9,153,F,55,8,8,104,-49,Severe
15,0,180,M,41,7,6,90,-90,Severe
14,10,178,F,8,5,6,66,-112,Severe
8,7,103,F,86,11,10,142,39,Well
12,5,149,M,52,8,5,101,-48,Severe
13,10,166,M,84,11,7,139,-27,Severe
12,4,148,F,58,9,0,108,-40,Severe
5,9,69,M,70,10,2,122,53,Well
10,3,123,F,60,9,2,110,-13,Severe
12,10,154,F,96,12,10,154,0,Neutral
10,4,124,F,103,13,6,162,38,Well
9,2,110,M,2,5,3,63,-47,Severe
13,2,158,M,49,8,2,98,-60,Severe
7,0,84,M,78,11,0,132,48,Well
12,7,151,F,61,9,3,111,-40,Severe
9,3,111,F,10,5,7,67,-44,Severe
17,1,205,F,95,12,9,153,-52,Severe
17,0,204,M,16,5,11,71,-133,Severe
10,1,121,F,6,5,5,65,-56,Severe
8,9,105,F,103,13,6,162,57,Well
10,11,131,F,29,6,8,80,-51,Severe
18,11,227,F,73,10,6,126,-101,Severe
8,1,97,F,17,6,0,72,-25,Severe
16,6,198,F,14,5,10,70,-128,Severe
10,3,123,M,38,7,4,88,-35,Severe
18,10,226,M,34,7,0,84,-142,Severe
13,5,161,M,29,6,8,80,-81,Severe
13,3,159,F,67,9,10,118,-41,Severe
8,2,98,F,67,9,10,118,20,Well
9,11,119,F,20,6,2,74,-45,Severe
5,11,71,M,49,8,2,98,27,Well
16,10,202,F,13,5,9,69,-133,Severe
11,2,134,M,69,10,1,121,-13,Severe
7,3,87,F,5,5,5,65,-22,Severe
15,4,184,M,73,10,6,126,-58,Severe
18,4,220,F,95,12,9,153,-67,Severe
14,7,175,M,64,9,7,115,-60,Severe
17,3,207,M,75,10,9,129,-78,Severe
10,3,123,F,83,11,6,138,15,Well
6,11,83,M,80,11,3,135,52,Well
8,1,97,F,57,8,10,106,9,Well
8,3,99,M,37,7,3,87,-12,Severe
14,1,169,M,75,10,9,129,-40,Severe
9,11,119,F,78,11,0,132,13,Well
10,7,127,F,37,7,3,87,-40,Severe
6,9,81,F,34,7,0,84,3,Good
6,3,75,M,75,10,9,129,54,Well
14,11,179,M,14,5,10,70,-109,Severe
9,4,112,M,11,5,8,68,-44,Severe
7,2,86,M,22,6,3,75,-11,Severe
10,7,127,F,66,9,9,117,-10,Severe
8,3,99,F,60,9,2,110,11,Well
17,9,213,M,67,9,10,118,-95,Severe
9,3,111,M,3,5,3,63,-48,Severe
16,7,199,M,91,12,4,148,-51,Severe
17,0,204,F,78,11,0,132,-72,Severe
6,8,80,F,70,10,2,122,42,Well
8,1,97,F,82,11,5,137,40,Well
16,11,203,M,60,9,2,110,-93,Severe
5,9,69,M,53,8,6,102,33,Well
13,3,159,M,43,7,8,92,-67,Severe
13,3,159,F,34,7,0,84,-75,Severe
15,2,182,M,48,8,1,97,-85,Severe
8,3,99,F,11,5,8,68,-31,Severe
12,3,147,M,67,9,10,118,-29,Severe
9,11,119,M,44,7,9,93,-26,Severe
15,0,180,M,8,5,6,66,-114,Severe
13,11,167,M,91,12,4,148,-19,Severe
8,8,104,M,8,5,6,66,-38,Severe
7,3,87,M,84,11,7,139,52,Well
15,9,189,F,86,11,10,142,-47,Severe
12,6,150,M,5,5,5,65,-85,Severe
6,2,74,F,74,10,7,127,53,Well
14,5,173,F,64,9,7,115,-58,Severe
16,11,203,M,4,5,4,64,-139,Severe
12,1,145,F,49,8,2,98,-47,Severe
16,7,199,F,107,13,11,167,-32,Severe
14,8,176,F,60,9,2,110,-66,Severe
18,3,219,M,72,10,4,124,-95,Severe
14,8,176,F,95,12,9,153,-23,Severe
13,3,159,M,108,14,0,168,9,Well
17,10,214,M,39,7,5,89,-125,Severe
14,2,170,M,22,6,3,75,-95,Severe
17,11,215,F,77,10,11,131,-84,Severe
17,10,214,M,108,14,0,168,-46,Severe
12,2,146,M,64,9,7,115,-31,Severe
14,11,179,M,38,7,4,88,-91,Severe
10,8,128,M,63,9,6,114,-14,Severe
14,3,171,F,93,12,6,150,-21,Severe
11,5,137,M,101,13,4,160,23,Well
15,10,190,F,56,8,9,105,-85,Severe
7,6,90,M,101,13,4,160,70,Well
8,3,99,M,5,5,5,65,-34,Severe
14,3,171,F,55,8,8,104,-67,Severe
16,3,195,M,62,9,4,112,-83,Severe
11,4,136,F,63,9,6,114,-22,Severe
6,3,75,F,62,9,4,112,37,Well
8,5,101,M,62,9,4,112,11,Well
9,8,116,M,27,6,7,79,-37,Severe
8,3,99,M,53,8,6,102,3,Good
5,5,65,F,24,6,5,77,12,Well
7,4,88,F,69,10,1,121,33,Well
9,8,116,F,25,6,5,77,-39,Severe
12,6,150,F,13,5,9,69,-81,Severe
15,9,189,M,43,7,8,92,-97,Severe
7,11,95,F,3,5,3,63,-32,Severe
5,3,63,M,32,6,10,82,19,Well
16,11,203,F,28,6,8,80,-123,Severe
17,10,214,F,9,5,7,67,-147,Severe
14,6,174,F,90,12,3,147,-27,Severe
8,4,100,M,7,5,6,66,-34,Severe
10,8,128,F,10,5,7,67,-61,Severe
10,2,122,F,56,8,9,105,-17,Severe
15,5,185,M,59,9,1,109,-76,Severe
17,3,207,M,104,13,7,163,-44,Severe
17,11,215,M,93,12,6,150,-65,Severe
6,1,73,F,63,9,6,114,41,Well
12,4,148,F,72,10,4,124,-24,Severe
16,1,193,F,73,10,6,126,-67,Severe
15,3,183,M,49,8,2,98,-85,Severe
18,10,226,F,90,12,3,147,-79,Severe
15,8,188,M,71,10,3,123,-65,Severe
6,3,75,M,91,12,4,148,73,Well
10,9,129,F,36,7,2,86,-43,Severe
14,3,171,M,103,13,6,162,-9,Severe
5,5,65,M,41,7,6,90,25,Well
17,8,212,M,16,5,11,71,-141,Severe
6,3,75,F,23,6,4,76,1,Good
17,7,211,M,43,7,8,92,-119,Severe
9,2,110,M,46,7,11,95,-15,Severe
18,3,219,M,9,5,7,67,-152,Severe
7,2,86,M,68,10,0,120,34,Well
15,6,186,F,9,5,7,67,-119,Severe
11,11,143,M,95,12,9,153,10,Well
9,9,117,M,108,14,0,168,51,Well
6,2,74,F,75,10,9,129,55,Well
9,5,113,M,71,10,3,123,10,Well
13,9,165,M,108,14,0,168,3,Good
9,4,112,F,18,6,1,73,-39,Severe
9,9,117,F,92,12,5,149,32,Well
16,0,192,F,109,14,1,169,-23,Severe
11,11,143,F,109,14,1,169,26,Well
10,3,123,F,18,6,1,73,-50,Severe
16,8,200,F,66,9,9,117,-83,Severe
11,6,138,F,32,6,10,82,-56,Severe
16,3,195,M,87,11,11,143,-52,Severe
18,9,225,M,51,8,4,100,-125,Severe
8,9,105,M,57,8,10,106,1,Good
12,8,152,F,36,7,2,86,-66,Severe
11,0,132,M,61,9,3,111,-21,Severe
14,1,169,M,78,11,0,132,-37,Severe
8,6,102,M,106,13,10,166,64,Well
13,5,161,M,79,11,1,133,-28,Severe
9,9,117,M,78,11,0,132,15,Well
5,3,63,F,62,9,4,112,49,Well
15,0,180,M,11,5,8,68,-112,Severe
9,7,115,M,102,13,6,162,47,Well
12,7,151,F,80,11,3,135,-16,Severe
17,4,208,M,92,12,5,149,-59,Severe
18,5,221,F,52,8,5,101,-120,Severe
10,2,122,M,36,7,2,86,-36,Severe
16,8,200,M,28,6,8,80,-120,Severe
8,11,107,F,50,8,3,99,-8,Severe
5,7,67,M,37,7,3,87,20,Well
18,11,227,M,110,14,3,171,-56,Severe
13,1,157,M,36,7,2,86,-71,Severe
16,1,193,M,35,7,1,85,-108,Severe
14,4,172,F,62,9,4,112,-60,Severe
12,3,147,M,78,11,0,132,-15,Severe
6,10,82,M,55,8,8,104,22,Well
12,2,146,M,32,6,10,82,-64,Severe
12,9,153,M,50,8,3,99,-54,Severe
11,4,136,M,15,5,11,71,-65,Severe
8,0,96,F,90,12,3,147,51,Well
8,7,103,M,100,13,3,159,56,Well
16,5,197,F,43,7,8,92,-105,Severe
18,3,219,M,60,9,2,110,-109,Severe
11,5,137,F,60,9,2,110,-27,Severe
7,4,88,F,103,13,6,162,74,Well
7,0,84,F,39,7,5,89,5,Good
5,8,68,F,13,5,9,69,1,Good
12,6,150,M,39,7,5,89,-61,Severe
10,10,130,F,67,9,10,118,-12,Severe
6,4,76,M,40,7,5,89,13,Well
6,4,76,M,60,9,2,110,34,Well
7,0,84,M,22,6,3,75,-9,Severe
7,5,89,M,39,7,5,89,0,Neutral
14,3,171,F,89,12,1,145,-26,Severe
16,10,202,M,37,7,3,87,-115,Severe
9,11,119,F,72,10,4,124,5,Good
17,6,210,M,4,5,4,64,-146,Severe
15,3,183,M,72,10,4,124,-59,Severe
11,7,139,F,97,12,11,155,16,Well
18,3,219,F,98,13,0,156,-63,Severe
9,6,114,M,69,10,1,121,7,Well
16,8,200,F,7,5,6,66,-134,Severe
9,0,108,F,65,9,8,116,8,Well
17,10,214,M,47,8,0,96,-118,Severe
12,9,153,M,14,5,10,70,-83,Severe
11,11,143,M,104,13,7,163,20,Well
10,2,122,M,56,8,9,105,-17,Severe
8,8,104,M,63,9,6,114,10,Well
9,3,111,F,110,14,3,171,60,Well
11,4,136,F,31,6,9,81,-55,Severe
16,6,198,F,46,7,11,95,-103,Severe
12,2,146,F,45,7,10,94,-52,Severe
8,5,101,F,57,8,10,106,5,Good
9,7,115,F,83,11,6,138,23,Well
5,5,65,F,104,13,7,163,98,Well
12,7,151,M,3,5,3,63,-88,Severe
15,3,183,F,67,9,10,118,-65,Severe
9,2,110,F,93,12,6,150,40,Well
17,10,214,F,28,6,8,80,-134,Severe
13,6,162,F,77,10,11,131,-31,Severe
11,2,134,F,41,7,6,90,-44,Severe
13,0,156,F,68,10,0,120,-36,Severe
17,6,210,M,36,7,2,86,-124,Severe
13,9,165,M,18,6,1,73,-92,Severe
11,7,139,M,100,13,3,159,20,Well
16,3,195,F,105,13,9,165,-30,Severe
10,3,123,M,15,5,11,71,-52,Severe
12,5,149,M,102,13,6,162,13,Well
16,8,200,M,46,7,11,95,-105,Severe
15,1,181,F,50,8,3,99,-82,Severe
7,11,95,F,41,7,6,90,-5,Mild
13,4,160,M,4,5,4,64,-96,Severe
6,7,79,F,68,10,0,120,41,Well
13,6,162,F,47,8,0,96,-66,Severe
18,10,226,M,13,5,9,69,-157,Severe
12,2,146,M,7,5,6,66,-80,Severe
10,10,130,F,62,9,4,112,-18,Severe
16,3,195,F,106,13,10,166,-29,Severe
8,8,104,M,64,9,7,115,11,Well
8,2,98,F,56,8,9,105,7,Well
5,11,71,F,7,5,6,66,-5,Mild
14,4,172,M,29,6,8,80,-92,Severe
17,3,207,M,43,7,8,92,-115,Severe
6,0,72,M,60,9,2,110,38,Well
7,3,87,M,95,12,9,153,66,Well
17,7,211,F,5,5,5,65,-146,Severe
14,5,173,M,81,11,4,136,-37,Severe
6,4,76,M,49,8,2,98,22,Well
17,10,214,F,46,7,11,95,-119,Severe
18,8,224,M,43,7,8,92,-132,Severe
16,4,196,F,103,13,6,162,-34,Severe
10,3,123,M,16,5,11,71,-52,Severe
6,0,72,M,5,5,5,65,-7,Severe
15,8,188,F,9,5,7,67,-121,Severe
11,6,138,F,52,8,5,101,-37,Severe
12,7,151,M,4,5,4,64,-87,Severe
16,11,203,F,101,13,4,160,-43,Severe
7,9,93,M,76,10,10,130,37,Well
16,1,193,M,44,7,9,93,-100,Severe
17,4,208,M,4,5,4,64,-144,Severe
7,3,87,F,110,14,3,171,84,Well
13,0,156,F,70,10,2,122,-34,Severe
12,9,153,M,5,5,5,65,-88,Severe
16,9,201,F,71,10,3,123,-78,Severe
15,6,186,M,29,6,8,80,-106,Severe
6,11,83,F,11,5,8,68,-15,Severe
18,4,220,F,36,7,2,86,-134,Severe
5,3,63,F,84,11,7,139,76,Well
7,0,84,F,102,13,6,162,78,Well
5,3,63,M,4,5,4,64,1,Good
9,1,109,M,108,14,0,168,59,Well
13,9,165,F,100,13,3,159,-6,Severe
6,3,75,M,25,6,5,77,2,Good
17,3,207,F,27,6,7,79,-128,Severe
8,7,103,M,3,5,3,63,-40,Severe
5,10,70,M,32,6,10,82,12,Well
10,9,129,F,3,5,3,63,-66,Severe
9,10,118,M,82,11,5,137,19,Well
13,7,163,F,23,6,4,76,-87,Severe
11,10,142,M,51,8,4,100,-42,Severe
14,1,169,F,79,11,1,133,-36,Severe
14,2,170,M,32,6,10,82,-88,Severe
14,5,173,F,34,7,0,84,-89,Severe
12,3,147,F,60,9,2,110,-37,Severe
10,8,128,F,106,13,10,166,38,Well
10,2,122,F,99,13,1,157,35,Well
8,7,103,F,103,13,6,162,59,Well
7,3,87,F,80,11,3,135,48,Well
13,11,167,F,7,5,6,66,-101,Severe
16,0,192,F,47,8,0,96,-96,Severe
9,6,114,F,105,13,9,165,51,Well
13,0,156,F,99,13,1,157,1,Good
6,10,82,F,25,6,5,77,-5,Mild
12,10,154,M,103,13,6,162,8,Well
6,8,80,M,62,9,4,112,32,Well
16,1,193,M,19,6,1,73,-120,Severe
10,4,124,M,19,6,1,73,-51,Severe
6,8,80,M,107,13,11,167,87,Well
8,5,101,M,94,12,7,151,50,Well
14,2,170,F,92,12,5,149,-21,Severe
7,3,87,M,98,13,0,156,69,Well
17,10,214,F,91,12,4,148,-66,Severe
6,1,73,M,14,5,10,70,-3,Mild
6,3,75,F,64,9,7,115,40,Well
10,1,121,M,9,5,7,67,-54,Severe
7,8,92,M,93,12,6,150,58,Well
10,1,121,F,65,9,8,116,-5,Mild
11,11,143,F,108,14,0,168,25,Well
13,10,166,M,62,9,4,112,-54,Severe
11,11,143,M,60,9,2,110,-33,Severe
18,4,220,F,105,13,9,165,-55,Severe
9,8,116,M,19,6,1,73,-43,Severe
12,0,144,F,4,5,4,64,-80,Severe
18,2,218,M,83,11,6,138,-80,Severe
7,9,93,M,26,6,6,78,-15,Severe
10,9,129,M,29,6,8,80,-49,Severe
6,10,82,F,45,7,10,94,12,Well
13,6,162,F,91,12,4,148,-14,Severe
18,10,226,M,79,11,1,133,-93,Severe
11,9,141,F,33,6,11,83,-58,Severe
8,7,103,M,16,5,11,71,-32,Severe
12,2,146,M,19,6,1,73,-73,Severe
9,3,111,F,104,13,7,163,52,Well
7,3,87,F,24,6,5,77,-10,Severe
6,4,76,F,27,6,7,79,3,Good
15,6,186,F,21,6,2,74,-112,Severe
13,1,157,M,26,6,6,78,-79,Severe
7,3,87,M,68,10,0,120,33,Well
13,8,164,M,108,14,0,168,4,Good
6,8,80,F,9,5,7,67,-13,Severe
9,2,110,F,11,5,8,68,-42,Severe
18,11,227,M,103,13,6,162,-65,Severe
13,1,157,M,28,6,8,80,-77,Severe
9,7,115,M,55,8,8,104,-11,Severe
10,1,121,F,102,13,6,162,41,Well
14,3,171,M,109,14,1,169,-2,Mild
12,7,151,M,66,9,9,117,-34,Severe
11,0,132,F,77,10,11,131,-1,Mild
16,1,193,M,20,6,2,74,-119,Severe
7,8,92,M,53,8,6,102,10,Well
16,0,192,M,95,12,9,153,-39,Severe
14,11,179,F,49,8,2,98,-81,Severe
15,3,183,M,79,11,1,133,-50,Severe
13,7,163,F,30,6,9,81,-82,Severe
14,3,171,M,24,6,5,77,-94,Severe
11,6,138,M,46,7,11,95,-43,Severe
7,1,85,F,103,13,6,162,77,Well
16,0,192,M,43,7,8,92,-100,Severe
7,6,90,F,3,5,3,63,-27,Severe
8,5,101,M,82,11,5,137,36,Well
14,9,177,M,53,8,6,102,-75,Severe
13,4,160,F,82,11,5,137,-23,Severe
13,1,157,F,103,13,6,162,5,Good
16,3,195,F,71,10,3,123,-72,Severe
8,9,105,F,52,8,5,101,-4,Mild
18,4,220,M,74,10,7,127,-93,Severe
18,8,224,M,71,10,3,123,-101,Severe
16,10,202,M,67,9,10,118,-84,Severe
9,2,110,M,72,10,4,124,14,Well
14,2,170,M,80,11,3,135,-35,Severe
5,1,61,F,87,11,11,143,82,Well
12,4,148,M,92,12,5,149,1,Good
14,7,175,F,33,6,11,83,-92,Severe
11,4,136,M,80,11,3,135,-1,Mild
7,7,91,M,6,5,5,65,-26,Severe
14,3,171,F,75,10,9,129,-42,Severe
12,0,144,M,88,12,0,144,0,Neutral
5,8,68,F,29,6,8,80,12,Well
7,4,88,F,22,6,3,75,-13,Severe
13,1,157,M,83,11,6,138,-19,Severe
15,11,191,M,5,5,5,65,-126,Severe
6,3,75,F,13,5,9,69,-6,Severe
7,2,86,F,10,5,7,67,-19,Severe
16,3,195,M,67,9,10,118,-77,Severe
17,6,210,F,7,5,6,66,-144,Severe
7,5,89,M,83,11,6,138,49,Well
8,3,99,F,99,13,1,157,58,Well
10,11,131,M,4,5,4,64,-67,Severe
17,10,214,F,64,9,7,115,-99,Severe
8,1,97,M,104,13,7,163,66,Well
7,3,87,M,100,13,3,159,72,Well
16,7,199,F,57,8,10,106,-93,Severe
7,9,93,F,30,6,9,81,-12,Severe
13,0,156,F,57,8,10,106,-50,Severe
11,3,135,M,8,5,6,66,-69,Severe
14,1,169,M,110,14,3,171,2,Good
17,8,212,F,78,11,0,132,-80,Severe
18,2,218,F,59,9,1,109,-109,Severe
16,8,200,F,79,11,1,133,-67,Severe
8,7,103,M,49,8,2,98,-5,Mild
8,3,99,M,90,12,3,147,48,Well
16,5,197,F,15,5,11,71,-126,Severe
13,8,164,F,46,7,11,95,-69,Severe
10,9,129,F,27,6,7,79,-50,Severe
10,10,130,M,3,5,3,63,-67,Severe
18,3,219,M,17,6,0,72,-147,Severe
15,5,185,F,58,9,0,108,-77,Severe
5,0,60,F,50,8,3,99,39,Well
11,0,132,F,68,10,0,120,-12,Severe
16,2,194,M,4,5,4,64,-130,Severe
9,0,108,M,28,6,8,80,-28,Severe
17,5,209,F,12,5,9,69,-140,Severe
7,3,87,M,56,8,9,105,18,Well
11,2,134,F,13,5,9,69,-65,Severe
15,6,186,F,68,10,0,120,-66,Severe
14,3,171,F,59,9,1,109,-62,Severe
9,0,108,F,104,13,7,163,55,Well
18,3,219,M,8,5,6,66,-153,Severe
15,11,191,M,85,11,9,141,-50,Severe
10,4,124,M,82,11,5,137,13,Well
16,1,193,F,40,7,5,89,-104,Severe
9,4,112,F,8,5,6,66,-46,Severe
14,0,168,F,49,8,2,98,-70,Severe
9,2,110,M,81,11,4,136,26,Well
12,9,153,F,101,13,4,160,7,Well
17,9,213,M,46,7,11,95,-118,Severe
9,2,110,F,49,8,2,98,-12,Severe
14,3,171,F,54,8,7,103,-68,Severe
7,6,90,M,90,12,3,147,57,Well
12,5,149,M,35,7,1,85,-64,Severe
14,4,172,F,56,8,9,105,-67,Severe
5,0,60,F,97,12,11,155,95,Well
10,10,130,M,24,6,5,77,-53,Severe
15,3,183,F,58,9,0,108,-75,Severe
9,4,112,M,92,12,5,149,37,Well
17,3,207,M,31,6,9,81,-126,Severe
18,0,216,M,70,10,2,122,-94,Severe
10,9,129,M,68,10,0,120,-9,Severe
17,11,215,M,9,5,7,67,-148,Severe
14,8,176,F,99,13,1,157,-19,Severe
18,10,226,M,52,8,5,101,-125,Severe
5,9,69,F,110,14,3,171,102,Well
9,2,110,F,84,11,7,139,29,Well
10,7,127,M,102,13,6,162,35,Well
6,3,75,F,61,9,3,111,36,Well
12,7,151,M,19,6,1,73,-78,Severe
8,7,103,F,91,12,4,148,45,Well
14,3,171,M,7,5,6,66,-105,Severe
6,10,82,M,68,10,0,120,38,Well
7,3,87,F,48,8,1,97,10,Well
15,5,185,M,103,13,6,162,-23,Severe
6,2,74,M,18,6,1,73,-1,Mild
17,8,212,F,43,7,8,92,-120,Severe
13,10,166,M,8,5,6,66,-100,Severe
11,4,136,F,14,5,10,70,-66,Severe
9,7,115,M,15,5,11,71,-44,Severe
18,7,223,F,3,5,3,63,-160,Severe
14,4,172,M,54,8,7,103,-69,Severe
18,0,216,M,102,13,6,162,-54,Severe
6,3,75,F,14,5,10,70,-5,Mild
8,6,102,F,88,12,0,144,42,Well
16,2,194,F,107,13,11,167,-27,Severe
16,9,201,M,93,12,6,150,-51,Severe
5,4,64,M,95,12,9,153,89,Well
11,3,135,M,9,5,7,67,-68,Severe
15,11,191,F,18,6,1,73,-118,Severe
16,7,199,M,5,5,5,65,-134,Severe
13,7,163,M,4,5,4,64,-99,Severe
13,8,164,M,64,9,7,115,-49,Severe
13,10,166,F,2,5,3,63,-103,Severe
14,7,175,M,82,11,5,137,-38,Severe
6,7,79,M,3,5,3,63,-16,Severe
15,1,181,M,88,12,0,144,-37,Severe
8,9,105,F,31,6,9,81,-24,Severe
7,2,86,M,71,10,3,123,37,Well
12,1,145,F,51,8,4,100,-45,Severe
13,2,158,F,71,10,3,123,-35,Severe
9,3,111,F,16,5,11,71,-40,Severe
11,1,133,M,93,12,6,150,17,Well
14,9,177,F,95,12,9,153,-24,Severe
18,2,218,F,40,7,5,89,-129,Severe
18,10,226,F,104,13,7,163,-63,Severe
14,1,169,F,95,12,9,153,-16,Severe
7,0,84,F,60,9,2,110,26,Well
13,3,159,M,73,10,6,126,-33,Severe
14,2,170,M,11,5,8,68,-102,Severe
13,10,166,M,13,5,9,69,-97,Severe
11,3,135,M,47,8,0,96,-39,Severe
10,3,123,F,91,12,4,148,25,Well
17,3,207,M,97,12,11,155,-52,Severe
9,1,109,F,30,6,9,81,-28,Severe
15,8,188,F,54,8,7,103,-85,Severe
5,6,66,F,28,6,8,80,14,Well
13,7,163,F,40,7,5,89,-74,Severe
12,11,155,M,72,10,4,124,-31,Severe
18,3,219,F,2,5,3,63,-156,Severe
11,9,141,F,7,5,6,66,-75,Severe
9,6,114,F,56,8,9,105,-9,Severe
13,3,159,M,88,12,0,144,-15,Severe
14,1,169,F,30,6,9,81,-88,Severe
11,9,141,M,64,9,7,115,-26,Severe
17,9,213,M,17,6,0,72,-141,Severe
7,8,92,M,7,5,6,66,-26,Severe
12,2,146,M,105,13,9,165,19,Well
6,8,80,M,70,10,2,122,42,Well
6,3,75,F,97,12,11,155,80,Well
17,5,209,F,44,7,9,93,-116,Severe
7,7,91,F,32,6,10,82,-9,Severe
17,6,210,F,74,10,7,127,-83,Severe
12,2,146,F,100,13,3,159,13,Well
16,3,195,M,47,8,0,96,-99,Severe
18,9,225,M,53,8,6,102,-123,Severe
17,7,211,M,49,8,2,98,-113,Severe
10,6,126,F,46,7,11,95,-31,Severe
12,11,155,F,75,10,9,129,-26,Severe
11,6,138,F,10,5,7,67,-71,Severe
11,2,134,F,87,11,11,143,9,Well
6,5,77,M,73,10,6,126,49,Well
8,1,97,F,91,12,4,148,51,Well
7,3,87,F,17,6,0,72,-15,Severe
14,10,178,F,17,6,0,72,-106,Severe
12,2,146,F,29,6,8,80,-66,Severe
12,3,147,M,102,13,6,162,15,Well
5,2,62,M,99,13,1,157,95,Well
5,9,69,M,21,6,2,74,5,Good
13,5,161,M,40,7,5,89,-72,Severe
10,1,121,F,79,11,1,133,12,Well
11,9,141,F,78,11,0,132,-9,Severe
14,8,176,M,27,6,7,79,-97,Severe
16,2,194,M,6,5,5,65,-129,Severe
11,3,135,M,46,7,11,95,-40,Severe
7,11,95,M,100,13,3,159,64,Well
17,9,213,M,48,8,1,97,-116,Severe
8,3,99,F,49,8,2,98,-1,Mild
11,3,135,M,103,13,6,162,27,Well
10,8,128,M,54,8,7,103,-25,Severe
10,6,126,F,41,7,6,90,-36,Severe
12,11,155,F,102,13,6,162,7,Well
15,5,185,F,50,8,3,99,-86,Severe
18,10,226,M,99,13,1,157,-69,Severe
15,2,182,F,35,7,1,85,-97,Severe
12,7,151,F,99,13,1,157,6,Well
7,9,93,M,42,7,7,91,-2,Mild
8,7,103,M,63,9,6,114,11,Well
5,7,67,F,102,13,6,162,95,Well
8,1,97,F,72,10,4,124,27,Well
15,4,184,M,43,7,8,92,-92,Severe
15,10,190,M,48,8,1,97,-93,Severe
16,1,193,M,96,12,10,154,-39,Severe
7,6,90,M,43,7,8,92,2,Good
7,8,92,F,50,8,3,99,7,Well
18,5,221,F,80,11,3,135,-86,Severe
7,0,84,M,109,14,1,169,85,Well
16,9,201,F,95,12,9,153,-48,Severe
5,4,64,F,16,5,11,71,7,Well
8,1,97,M,20,6,2,74,-23,Severe
6,9,81,F,39,7,5,89,8,Well
9,11,119,F,11,5,8,68,-51,Severe
16,8,200,M,84,11,7,139,-61,Severe
18,9,225,F,11,5,8,68,-157,Severe
6,7,79,M,67,9,10,118,39,Well
10,9,129,M,46,7,11,95,-34,Severe
9,6,114,F,28,6,8,80,-34,Severe
12,2,146,F,52,8,5,101,-45,Severe
17,2,206,F,12,5,9,69,-137,Severe
12,3,147,F,50,8,3,99,-48,Severe
15,0,180,F,101,13,4,160,-20,Severe
16,4,196,M,96,12,10,154,-42,Severe
10,5,125,F,76,10,10,130,5,Good
13,10,166,F,7,5,6,66,-100,Severe
5,5,65,M,9,5,7,67,2,Good
7,5,89,M,67,9,10,118,29,Well
13,6,162,M,67,9,10,118,-44,Severe
13,10,166,F,94,12,7,151,-15,Severe
10,5,125,F,63,9,6,114,-11,Severe
12,8,152,F,30,6,9,81,-71,Severe
8,5,101,F,86,11,10,142,41,Well
11,3,135,F,45,7,10,94,-41,Severe
16,0,192,M,85,11,9,141,-51,Severe
11,4,136,F,83,11,6,138,2,Good
17,6,210,M,100,13,3,159,-51,Severe
15,1,181,M,20,6,2,74,-107,Severe
9,5,113,F,51,8,4,100,-13,Severe
14,7,175,M,109,14,1,169,-6,Severe
7,3,87,F,32,6,10,82,-5,Mild
7,3,87,M,42,7,7,91,4,Good
14,10,178,F,78,11,0,132,-46,Severe
17,7,211,F,52,8,5,101,-110,Severe
16,3,195,M,12,5,9,69,-126,Severe
5,9,69,F,17,6,0,72,3,Good
17,4,208,F,94,12,7,151,-57,Severe
13,4,160,F,66,9,9,117,-43,Severe
16,7,199,F,98,13,0,156,-43,Severe
8,1,97,M,30,6,9,81,-16,Severe
11,11,143,M,103,13,6,162,19,Well
9,10,118,F,49,8,2,98,-20,Severe
13,7,163,F,91,12,4,148,-15,Severe
5,2,62,M,36,7,2,86,24,Well
14,1,169,F,102,13,6,162,-7,Severe
5,7,67,M,77,10,11,131,64,Well
10,6,126,M,101,13,4,160,34,Well
14,10,178,F,93,12,6,150,-28,Severe
5,9,69,F,101,13,4,160,91,Well
13,11,167,F,91,12,4,148,-19,Severe
12,11,155,M,2,5,3,63,-92,Severe
12,10,154,M,21,6,2,74,-80,Severe
15,10,190,M,14,5,10,70,-120,Severe
14,3,171,F,71,10,3,123,-48,Severe
7,5,89,M,68,10,0,120,31,Well
16,3,195,M,93,12,6,150,-45,Severe
11,4,136,F,73,10,6,126,-10,Severe
14,9,177,M,81,11,4,136,-41,Severe
16,0,192,F,82,11,5,137,-55,Severe
10,11,131,F,99,13,1,157,26,Well
9,3,111,M,100,13,3,159,48,Well
6,0,72,M,20,6,2,74,2,Good
5,9,69,M,32,6,10,82,13,Well
14,0,168,F,59,9,1,109,-59,Severe
17,10,214,M,51,8,4,100,-114,Severe
9,10,118,M,31,6,9,81,-37,Severe
8,7,103,M,78,11,0,132,29,Well
14,2,170,F,97,12,11,155,-15,Severe
18,3,219,F,90,12,3,147,-72,Severe
17,0,204,M,39,7,5,89,-115,Severe
9,11,119,F,92,12,5,149,30,Well
14,10,178,F,110,14,3,171,-7,Severe
14,9,177,M,6,5,5,65,-112,Severe
16,0,192,F,104,13,7,163,-29,Severe
5,3,63,F,94,12,7,151,88,Well
13,3,159,F,66,9,9,117,-42,Severe
6,5,77,F,22,6,3,75,-2,Mild
5,5,65,M,94,12,7,151,86,Well
9,7,115,M,87,11,11,143,28,Well
8,6,102,M,87,11,11,143,41,Well
10,2,122,M,16,5,11,71,-51,Severe
16,9,201,F,65,9,8,116,-85,Severe
18,3,219,M,92,12,5,149,-70,Severe
18,3,219,F,71,10,3,123,-96,Severe
14,3,171,F,67,9,10,118,-53,Severe
11,5,137,M,97,12,11,155,18,Well
17,10,214,M,57,8,10,106,-108,Severe
12,4,148,M,107,13,11,167,19,Well
14,8,176,M,31,6,9,81,-95,Severe
17,7,211,M,71,10,3,123,-88,Severe
6,3,75,F,5,5,5,65,-10,Severe
5,0,60,F,10,5,7,67,7,Well
15,3,183,M,80,11,3,135,-48,Severe
18,3,219,F,36,7,2,86,-133,Severe
5,3,63,M,54,8,7,103,40,Well
17,7,211,F,76,10,10,130,-81,Severe
14,2,170,M,31,6,9,81,-89,Severe
15,1,181,M,35,7,1,85,-96,Severe
13,0,156,M,97,12,11,155,-1,Mild
10,3,123,F,104,13,7,163,40,Well
6,11,83,M,13,5,9,69,-14,Severe
12,2,146,M,90,12,3,147,1,Good
16,4,196,F,85,11,9,141,-55,Severe
7,1,85,M,32,6,10,82,-3,Mild
18,1,217,M,69,10,1,121,-96,Severe
16,5,197,M,39,7,5,89,-108,Severe
7,10,94,F,82,11,5,137,43,Well
6,5,77,F,73,10,6,126,49,Well
7,10,94,M,84,11,7,139,45,Well
18,4,220,M,99,13,1,157,-63,Severe
7,8,92,M,25,6,5,77,-15,Severe
15,10,190,F,74,10,7,127,-63,Severe
10,1,121,M,60,9,2,110,-11,Severe
6,3,75,M,34,7,0,84,9,Well
5,5,65,M,78,11,0,132,67,Well
6,8,80,M,61,9,3,111,31,Well
9,2,110,M,6,5,5,65,-45,Severe
5,6,66,M,9,5,7,67,1,Good
15,7,187,F,47,8,0,96,-91,Severe
8,8,104,F,81,11,4,136,32,Well
18,3,219,F,80,11,3,135,-84,Severe
14,10,178,M,84,11,7,139,-39,Severe
18,9,225,F,2,5,3,63,-162,Severe
7,1,85,M,13,5,9,69,-16,Severe
16,7,199,M,75,10,9,129,-70,Severe
12,9,153,F,68,10,0,120,-33,Severe
5,2,62,M,33,6,11,83,21,Well
18,4,220,M,27,6,7,79,-141,Severe
10,6,126,M,88,12,0,144,18,Well
7,9,93,M,5,5,5,65,-28,Severe
5,3,63,M,2,5,3,63,0,Neutral
17,4,208,M,37,7,3,87,-121,Severe
17,11,215,M,4,5,4,64,-151,Severe
18,5,221,F,46,7,11,95,-126,Severe
16,10,202,M,68,10,0,120,-82,Severe
8,5,101,F,104,13,7,163,62,Well
11,4,136,F,15,5,11,71,-65,Severe
6,2,74,F,23,6,4,76,2,Good
11,9,141,M,11,5,8,68,-73,Severe
15,0,180,M,54,8,7,103,-77,Severe
8,4,100,M,107,13,11,167,67,Well
9,10,118,F,104,13,7,163,45,Well
11,3,135,M,102,13,6,162,27,Well
18,3,219,M,78,11,0,132,-87,Severe
12,3,147,F,74,10,7,127,-20,Severe
9,2,110,F,51,8,4,100,-10,Severe
5,8,68,F,74,10,7,127,59,Well
12,1,145,F,107,13,11,167,22,Well
14,7,175,M,55,8,8,104,-71,Severe
13,2,158,M,22,6,3,75,-83,Severe
18,7,223,F,92,12,5,149,-74,Severe
16,11,203,F,33,6,11,83,-120,Severe
5,5,65,M,92,12,5,149,84,Well
8,2,98,F,37,7,3,87,-11,Severe
14,4,172,M,7,5,6,66,-106,Severe
8,7,103,M,105,13,9,165,62,Well
12,11,155,F,58,9,0,108,-47,Severe
17,6,210,M,26,6,6,78,-132,Severe
18,10,226,M,100,13,3,159,-67,Severe
7,4,88,M,38,7,4,88,0,Neutral
10,3,123,F,17,6,0,72,-51,Severe
9,4,112,M,30,6,9,81,-31,Severe
16,4,196,F,100,13,3,159,-37,Severe
11,3,135,M,16,5,11,71,-64,Severe
9,5,113,M,73,10,6,126,13,Well
5,5,65,F,13,5,9,69,4,Good
9,0,108,F,109,14,1,169,61,Well
10,1,121,M,3,5,3,63,-58,Severe
8,1,97,F,108,14,0,168,71,Well
12,2,146,M,6,5,5,65,-81,Severe
17,1,205,M,18,6,1,73,-132,Severe
7,6,90,M,5,5,5,65,-25,Severe
6,3,75,M,59,9,1,109,34,Well
8,9,105,M,5,5,5,65,-40,Severe
11,11,143,M,33,6,11,83,-60,Severe
9,4,112,F,60,9,2,110,-2,Mild
6,3,75,M,96,12,10,154,79,Well
17,9,213,M,37,7,3,87,-126,Severe
18,9,225,M,42,7,7,91,-134,Severe
5,11,71,M,92,12,5,149,78,Well
12,6,150,M,14,5,10,70,-80,Severe
17,3,207,M,106,13,10,166,-41,Severe
10,11,131,F,96,12,10,154,23,Well
12,5,149,F,12,5,9,69,-80,Severe
10,1,121,F,96,12,10,154,33,Well
13,2,158,F,7,5,6,66,-92,Severe
6,3,75,M,86,11,10,142,67,Well
13,7,163,M,110,14,3,171,8,Well
10,6,126,F,45,7,10,94,-32,Severe
15,2,182,F,36,7,2,86,-96,Severe
13,10,166,M,110,14,3,171,5,Good
16,1,193,F,89,12,1,145,-48,Severe
16,10,202,M,62,9,4,112,-90,Severe
5,10,70,M,41,7,6,90,20,Well
11,0,132,F,25,6,5,77,-55,Severe
5,0,60,F,8,5,6,66,6,Well
13,2,158,F,58,9,0,108,-50,Severe
9,4,112,M,93,12,6,150,38,Well
11,7,139,M,78,11,0,132,-7,Severe
12,10,154,M,74,10,7,127,-27,Severe
10,9,129,F,11,5,8,68,-61,Severe
7,11,95,M,29,6,8,80,-15,Severe
9,0,108,F,75,10,9,129,21,Well
13,3,159,F,74,10,7,127,-32,Severe
5,11,71,F,3,5,3,63,-8,Severe
18,10,226,F,110,14,3,171,-55,Severe
15,10,190,F,2,5,3,63,-127,Severe
8,2,98,M,16,5,11,71,-27,Severe
11,10,142,F,51,8,4,100,-42,Severe
13,6,162,M,14,5,10,70,-92,Severe
11,11,143,F,90,12,3,147,4,Good
18,6,222,F,82,11,5,137,-85,Severe
12,4,148,F,11,5,8,68,-80,Severe
18,0,216,F,85,11,9,141,-75,Severe
14,4,172,M,33,6,11,83,-89,Severe
14,7,175,F,29,6,8,80,-95,Severe
17,11,215,F,44,7,9,93,-122,Severe
12,1,145,M,6,5,5,65,-80,Severe
18,0,216,M,99,13,1,157,-59,Severe
13,8,164,M,81,11,4,136,-28,Severe
12,0,144,M,102,13,6,162,18,Well
16,0,192,M,22,6,3,75,-117,Severe
18,5,221,F,99,13,1,157,-64,Severe
14,4,172,F,107,13,11,167,-5,Mild
10,9,129,F,79,11,1,133,4,Good
13,4,160,M,29,6,8,80,-80,Severe
16,8,200,M,62,9,4,112,-88,Severe
15,10,190,M,28,6,8,80,-110,Severe
5,7,67,M,66,9,9,117,50,Well
9,3,111,M,80,11,3,135,24,Well
15,11,191,F,33,6,11,83,-108,Severe
8,2,98,F,57,8,10,106,8,Well
16,2,194,M,14,5,10,70,-124,Severe
15,8,188,F,27,6,7,79,-109,Severe
14,0,168,M,26,6,6,78,-90,Severe
12,3,147,M,28,6,8,80,-67,Severe
18,7,223,M,103,13,6,162,-61,Severe
11,1,133,F,77,10,11,131,-2,Mild
18,1,217,M,35,7,1,85,-132,Severe
9,2,110,F,54,8,7,103,-7,Severe
17,0,204,F,98,13,0,156,-48,Severe
12,2,146,F,10,5,7,67,-79,Severe
18,6,222,F,14,5,10,70,-152,Severe
11,5,137,F,74,10,7,127,-10,Severe
7,4,88,F,46,7,11,95,7,Well
12,4,148,M,7,5,6,66,-82,Severe
8,7,103,F,74,10,7,127,24,Well
11,1,133,M,90,12,3,147,14,Well
5,1,61,M,44,7,9,93,32,Well
15,9,189,F,83,11,6,138,-51,Severe
11,2,134,M,57,8,10,106,-28,Severe
9,7,115,F,73,10,6,126,11,Well
10,5,125,F,84,11,7,139,14,Well
8,4,100,F,23,6,4,76,-24,Severe
11,4,136,F,66,9,9,117,-19,Severe
5,9,69,F,5,5,5,65,-4,Mild
6,0,72,F,66,9,9,117,45,Well
13,7,163,M,70,10,2,122,-41,Severe
13,10,166,M,71,10,3,123,-43,Severe
12,8,152,M,33,6,11,83,-69,Severe
15,4,184,F,16,5,11,71,-113,Severe
10,0,120,M,78,11,0,132,12,Well
10,0,120,M,28,6,8,80,-40,Severe
17,6,210,F,84,11,7,139,-71,Severe
10,5,125,M,37,7,3,87,-38,Severe
10,11,131,F,9,5,7,67,-64,Severe
13,3,159,M,44,7,9,93,-66,Severe
5,3,63,F,5,5,5,65,2,Good
10,0,120,F,31,6,9,81,-39,Severe
13,9,165,M,32,6,10,82,-83,Severe
5,1,61,F,22,6,3,75,14,Well
5,5,65,F,60,9,2,110,45,Well
17,4,208,M,7,5,6,66,-142,Severe
11,1,133,F,94,12,7,151,18,Well
7,1,85,M,75,10,9,129,44,Well
17,5,209,F,96,12,10,154,-55,Severe
8,1,97,M,12,5,9,69,-28,Severe
7,11,95,F,88,12,0,144,49,Well
15,9,189,F,110,14,3,171,-18,Severe
16,1,193,M,14,5,10,70,-123,Severe
5,0,60,F,85,11,9,141,81,Well
6,2,74,M,88,12,0,144,70,Well
10,10,130,F,98,13,0,156,26,Well
14,8,176,F,52,8,5,101,-75,Severe
15,3,183,M,13,5,9,69,-114,Severe
8,4,100,F,29,6,8,80,-20,Severe
11,3,135,M,99,13,1,157,22,Well
16,4,196,M,60,9,2,110,-86,Severe
6,10,82,M,36,7,2,86,4,Good
7,9,93,M,7,5,6,66,-27,Severe
11,8,140,F,29,6,8,80,-60,Severe
15,5,185,M,98,13,0,156,-29,Severe
9,5,113,M,80,11,3,135,22,Well
18,5,221,F,108,14,0,168,-53,Severe
6,3,75,F,100,13,3,159,84,Well
18,9,225,M,46,7,11,95,-130,Severe
17,3,207,M,73,10,6,126,-81,Severe
8,3,99,F,25,6,5,77,-22,Severe
18,8,224,F,8,5,6,66,-158,Severe
10,3,123,M,25,6,5,77,-46,Severe
8,9,105,F,20,6,2,74,-31,Severe
10,7,127,F,34,7,0,84,-43,Severe
5,7,67,F,20,6,2,74,7,Well
13,9,165,M,55,8,8,104,-61,Severe
13,3,159,F,77,10,11,131,-28,Severe
10,7,127,M,9,5,7,67,-60,Severe
8,3,99,M,71,10,3,123,24,Well
7,4,88,M,24,6,5,77,-11,Severe
18,7,223,M,33,6,11,83,-140,Severe
17,5,209,M,42,7,7,91,-118,Severe
17,10,214,F,48,8,1,97,-117,Severe
9,3,111,M,7,5,6,66,-45,Severe
18,10,226,M,86,11,10,142,-84,Severe
5,6,66,F,68,10,0,120,54,Well
16,2,194,F,75,10,9,129,-65,Severe
5,7,67,F,47,8,0,96,29,Well
18,0,216,F,79,11,1,133,-83,Severe
14,3,171,F,62,9,4,112,-59,Severe
16,0,192,F,58,9,0,108,-84,Severe
12,6,150,M,45,7,10,94,-56,Severe
12,7,151,F,65,9,8,116,-35,Severe
17,5,209,M,24,6,5,77,-132,Severe
6,6,78,M,57,8,10,106,28,Well
7,10,94,M,90,12,3,147,53,Well
12,5,149,F,30,6,9,81,-68,Severe
9,10,118,M,67,9,10,118,0,Neutral
14,3,171,F,76,10,10,130,-41,Severe
12,9,153,M,19,6,1,73,-80,Severe
9,8,116,M,74,10,7,127,11,Well
15,3,183,F,4,5,4,64,-119,Severe
15,6,186,F,34,7,0,84,-102,Severe
9,10,118,M,28,6,8,80,-38,Severe
9,3,111,F,57,8,10,106,-5,Mild
14,0,168,F,101,13,4,160,-8,Severe
14,9,177,M,63,9,6,114,-63,Severe
10,9,129,M,2,5,3,63,-66,Severe
13,8,164,M,25,6,5,77,-87,Severe
17,10,214,F,106,13,10,166,-48,Severe
6,11,83,M,16,5,11,71,-12,Severe
17,7,211,F,51,8,4,100,-111,Severe
18,5,221,M,94,12,7,151,-70,Severe
12,3,147,F,8,5,6,66,-81,Severe
5,4,64,M,24,6,5,77,13,Well
16,3,195,F,48,8,1,97,-98,Severe
16,9,201,M,104,13,7,163,-38,Severe
10,7,127,F,60,9,2,110,-17,Severe
14,0,168,M,80,11,3,135,-33,Severe
13,3,159,F,12,5,9,69,-90,Severe
7,0,84,F,17,6,0,72,-12,Severe
14,5,173,F,11,5,8,68,-105,Severe
6,2,74,F,58,9,0,108,34,Well
7,8,92,F,75,10,9,129,37,Well
15,7,187,M,90,12,3,147,-40,Severe
6,0,72,F,87,11,11,143,71,Well
10,2,122,F,66,9,9,117,-5,Mild
7,1,85,M,73,10,6,126,41,Well
12,3,147,M,33,6,11,83,-64,Severe
12,11,155,F,64,9,7,115,-40,Severe
10,7,127,M,109,14,1,169,42,Well
16,3,195,M,6,5,5,65,-130,Severe
14,9,177,F,102,13,6,162,-15,Severe
11,7,139,F,76,10,10,130,-9,Severe
15,0,180,F,45,7,10,94,-86,Severe
18,1,217,F,12,5,9,69,-148,Severe
12,1,145,M,40,7,5,89,-56,Severe
12,3,147,F,25,6,5,77,-70,Severe
12,3,147,F,103,13,6,162,15,Well
11,3,135,M,64,9,7,115,-20,Severe
6,6,78,M,40,7,5,89,11,Well
13,1,157,M,76,10,10,130,-27,Severe
17,1,205,M,80,11,3,135,-70,Severe
17,2,206,F,14,5,10,70,-136,Severe
11,0,132,F,50,8,3,99,-33,Severe
17,8,212,M,99,13,1,157,-55,Severe
5,11,71,F,105,13,9,165,94,Well
12,6,150,M,41,7,6,90,-60,Severe
11,3,135,F,74,10,7,127,-8,Severe
18,7,223,M,31,6,9,81,-142,Severe
6,11,83,M,94,12,7,151,68,Well
5,7,67,F,94,12,7,151,84,Well
18,2,218,F,42,7,7,91,-127,Severe
6,3,75,F,101,13,4,160,85,Well
14,10,178,M,75,10,9,129,-49,Severe
16,0,192,F,96,12,10,154,-38,Severe
17,6,210,F,101,13,4,160,-50,Severe
14,3,171,F,87,11,11,143,-28,Severe
8,11,107,M,95,12,9,153,46,Well
13,3,159,F,82,11,5,137,-22,Severe
7,7,91,M,53,8,6,102,11,Well
12,6,150,M,58,9,0,108,-42,Severe
7,2,86,M,34,7,0,84,-2,Mild
5,7,67,M,40,7,5,89,22,Well
7,4,88,F,8,5,6,66,-22,Severe
10,2,122,M,33,6,11,83,-39,Severe
5,9,69,M,40,7,5,89,20,Well
18,2,218,M,60,9,2,110,-108,Severe
12,1,145,M,21,6,2,74,-71,Severe
12,7,151,F,27,6,7,79,-72,Severe
15,2,182,F,99,13,1,157,-25,Severe
12,2,146,M,45,7,10,94,-52,Severe
7,1,85,M,6,5,5,65,-20,Severe
8,3,99,M,89,12,1,145,46,Well
16,9,201,F,19,6,1,73,-128,Severe
15,9,189,F,7,5,6,66,-123,Severe
15,7,187,M,72,10,4,124,-63,Severe
8,9,105,F,67,9,10,118,13,Well
15,3,183,M,93,12,6,150,-33,Severe
13,6,162,F,110,14,3,171,9,Well
14,9,177,F,25,6,5,77,-100,Severe
12,3,147,F,6,5,5,65,-82,Severe
11,7,139,F,59,9,1,109,-30,Severe
10,2,122,F,26,6,6,78,-44,Severe
5,0,60,M,14,5,10,70,10,Well
6,3,75,F,90,12,3,147,72,Well
13,3,159,F,18,6,1,73,-86,Severe
18,3,219,F,84,11,7,139,-80,Severe
9,0,108,M,29,6,8,80,-28,Severe
12,8,152,F,100,13,3,159,7,Well
12,5,149,F,40,7,5,89,-60,Severe
11,3,135,M,32,6,10,82,-53,Severe
6,8,80,M,105,13,9,165,85,Well
7,4,88,M,81,11,4,136,48,Well
11,0,132,M,101,13,4,160,28,Well
17,2,206,F,88,12,0,144,-62,Severe
16,1,193,F,80,11,3,135,-58,Severe
17,4,208,F,70,10,2,122,-86,Severe
6,2,74,F,62,9,4,112,38,Well
16,11,203,M,45,7,10,94,-109,Severe
13,9,165,F,27,6,7,79,-86,Severe
10,4,124,M,29,6,8,80,-44,Severe
17,9,213,F,98,13,0,156,-57,Severe
11,3,135,M,7,5,6,66,-69,Severe
9,3,111,F,70,10,2,122,11,Well
5,10,70,M,45,7,10,94,24,Well
9,1,109,M,68,10,0,120,11,Well
8,6,102,M,47,8,0,96,-6,Severe
8,10,106,M,64,9,7,115,9,Well
12,7,151,F,38,7,4,88,-63,Severe
15,4,184,M,47,8,0,96,-88,Severe
5,9,69,F,49,8,2,98,29,Well
5,2,62,F,39,7,5,89,27,Well
6,7,79,F,29,6,8,80,1,Good
14,8,176,F,98,13,0,156,-20,Severe
13,0,156,M,66,9,9,117,-39,Severe
18,1,217,F,66,9,9,117,-100,Severe
10,9,129,M,85,11,9,141,12,Well
13,3,159,M,60,9,2,110,-49,Severe
7,3,87,M,92,12,5,149,62,Well
12,4,148,M,42,7,7,91,-57,Severe
7,3,87,M,26,6,6,78,-9,Severe
10,11,131,F,20,6,2,74,-57,Severe
6,11,83,M,82,11,5,137,54,Well
12,9,153,M,6,5,5,65,-88,Severe
11,10,142,M,36,7,2,86,-56,Severe
15,11,191,F,21,6,2,74,-117,Severe
8,4,100,M,32,6,10,82,-18,Severe
8,11,107,M,38,7,4,88,-19,Severe
12,10,154,F,82,11,5,137,-17,Severe
18,8,224,M,3,5,3,63,-161,Severe
13,2,158,F,10,5,7,67,-91,Severe
16,10,202,M,107,13,11,167,-35,Severe
16,6,198,F,7,5,6,66,-132,Severe
6,2,74,F,5,5,5,65,-9,Severe
9,3,111,F,78,11,0,132,21,Well
11,10,142,F,92,12,5,149,7,Well
7,6,90,F,24,6,5,77,-13,Severe
18,9,225,F,67,9,10,118,-107,Severe
8,5,101,F,93,12,6,150,49,Well
9,6,114,F,108,14,0,168,54,Well
16,1,193,F,88,12,0,144,-49,Severe
16,10,202,F,92,12,5,149,-53,Severe
5,6,66,F,80,11,3,135,69,Well
16,0,192,F,76,10,10,130,-62,Severe
12,9,153,M,37,7,3,87,-66,Severe
6,1,73,F,74,10,7,127,54,Well
8,1,97,F,68,10,0,120,23,Well
10,8,128,F,94,12,7,151,23,Well
13,11,167,M,59,9,1,109,-58,Severe
8,1,97,F,61,9,3,111,14,Well
14,5,173,F,52,8,5,101,-72,Severe
12,5,149,M,59,9,1,109,-40,Severe
11,0,132,M,11,5,8,68,-64,Severe
5,0,60,F,42,7,7,91,31,Well
18,4,220,M,91,12,4,148,-72,Severe
15,0,180,M,42,7,7,91,-89,Severe
7,10,94,F,106,13,10,166,72,Well
13,10,166,M,7,5,6,66,-100,Severe
17,4,208,M,29,6,8,80,-128,Severe
12,6,150,F,16,5,11,71,-79,Severe
18,9,225,M,85,11,9,141,-84,Severe
14,4,172,M,81,11,4,136,-36,Severe
7,0,84,M,57,8,10,106,22,Well
9,0,108,F,97,12,11,155,47,Well
10,6,126,M,87,11,11,143,17,Well
8,1,97,M,32,6,10,82,-15,Severe
9,11,119,F,15,5,11,71,-48,Severe
13,11,167,F,5,5,5,65,-102,Severe
18,3,219,F,109,14,1,169,-50,Severe
12,8,152,F,57,8,10,106,-46,Severe
9,10,118,M,4,5,4,64,-54,Severe
5,2,62,F,88,12,0,144,82,Well
15,6,186,M,60,9,2,110,-76,Severe
8,0,96,M,84,11,7,139,43,Well
12,3,147,M,24,6,5,77,-70,Severe
7,1,85,M,49,8,2,98,13,Well
16,6,198,M,77,10,11,131,-67,Severe
8,1,97,M,96,12,10,154,57,Well
8,10,106,M,102,13,6,162,56,Well
9,4,112,F,76,10,10,130,18,Well
18,5,221,F,77,10,11,131,-90,Severe
7,6,90,M,45,7,10,94,4,Good
13,5,161,M,22,6,3,75,-86,Severe
17,4,208,F,110,14,3,171,-37,Severe
13,2,158,M,21,6,2,74,-84,Severe
6,11,83,F,93,12,6,150,67,Well
12,10,154,F,53,8,6,102,-52,Severe
18,11,227,M,16,5,11,71,-156,Severe
8,8,104,M,85,11,9,141,37,Well
9,1,109,F,17,6,0,72,-37,Severe
18,8,224,M,100,13,3,159,-65,Severe
14,3,171,M,88,12,0,144,-27,Severe
12,3,147,M,93,12,6,150,3,Good
12,9,153,M,41,7,6,90,-63,Severe
12,5,149,F,51,8,4,100,-49,Severe
14,11,179,M,96,12,10,154,-25,Severe
13,7,163,F,20,6,2,74,-89,Severe
14,3,171,M,102,13,6,162,-9,Severe
18,5,221,M,46,7,11,95,-126,Severe
12,9,153,M,86,11,10,142,-11,Severe
12,3,147,M,99,13,1,157,10,Well
13,7,163,F,54,8,7,103,-60,Severe
14,11,179,M,99,13,1,157,-22,Severe
7,3,87,F,50,8,3,99,12,Well
11,5,137,M,58,9,0,108,-29,Severe
12,3,147,M,89,12,1,145,-2,Mild
8,5,101,M,102,13,6,162,61,Well
17,5,209,F,36,7,2,86,-123,Severe
6,7,79,F,89,12,1,145,66,Well
7,6,90,F,42,7,7,91,1,Good
14,10,178,M,30,6,9,81,-97,Severe
17,6,210,M,37,7,3,87,-123,Severe
16,9,201,F,89,12,1,145,-56,Severe
11,7,139,M,43,7,8,92,-47,Severe
6,2,74,F,28,6,8,80,6,Well
6,10,82,F,37,7,3,87,5,Good
10,6,126,F,98,13,0,156,30,Well
9,2,110,F,42,7,7,91,-19,Severe
13,10,166,F,62,9,4,112,-54,Severe
16,1,193,F,49,8,2,98,-95,Severe
9,11,119,F,6,5,5,65,-54,Severe
8,9,105,M,89,12,1,145,40,Well
8,1,97,M,76,10,10,130,33,Well
15,6,186,M,7,5,6,66,-120,Severe
14,6,174,F,30,6,9,81,-93,Severe
8,6,102,M,110,14,3,171,69,Well
14,2,170,F,66,9,9,117,-53,Severe
18,5,221,F,11,5,8,68,-153,Severe
7,8,92,F,21,6,2,74,-18,Severe
16,6,198,F,101,13,4,160,-38,Severe
13,10,166,F,61,9,3,111,-55,Severe
14,4,172,M,93,12,6,150,-22,Severe
7,9,93,F,29,6,8,80,-13,Severe
6,10,82,F,78,11,0,132,50,Well
14,3,171,F,78,11,0,132,-39,Severe
7,1,85,M,43,7,8,92,7,Well
10,1,121,F,68,10,0,120,-1,Mild
9,8,116,M,25,6,5,77,-39,Severe
14,2,170,F,93,12,6,150,-20,Severe
11,10,142,F,34,7,0,84,-58,Severe
6,11,83,M,87,11,11,143,60,Well
18,0,216,F,83,11,6,138,-78,Severe
12,3,147,M,49,8,2,98,-49,Severe
9,3,111,M,16,5,11,71,-40,Severe
16,7,199,F,77,10,11,131,-68,Severe
14,3,171,M,51,8,4,100,-71,Severe
17,0,204,M,85,11,9,141,-63,Severe
6,6,78,M,17,6,0,72,-6,Severe
11,7,139,F,56,8,9,105,-34,Severe
17,2,206,M,8,5,6,66,-140,Severe
6,5,77,F,96,12,10,154,77,Well
13,10,166,F,83,11,6,138,-28,Severe
6,5,77,F,18,6,1,73,-4,Mild
13,1,157,F,101,13,4,160,3,Good
6,7,79,F,12,5,9,69,-10,Severe
18,3,219,M,53,8,6,102,-117,Severe
15,3,183,M,109,14,1,169,-14,Severe
8,8,104,M,35,7,1,85,-19,Severe
18,0,216,M,4,5,4,64,-152,Severe
5,11,71,M,91,12,4,148,77,Well
10,4,124,M,58,9,0,108,-16,Severe
13,6,162,M,87,11,11,143,-19,Severe
11,4,136,M,98,13,0,156,20,Well
6,11,83,M,14,5,10,70,-13,Severe
8,11,107,F,46,7,11,95,-12,Severe
7,1,85,F,63,9,6,114,29,Well
6,9,81,M,106,13,10,166,85,Well
13,3,159,F,26,6,6,78,-81,Severe
15,3,183,F,67,9,10,118,-65,Severe
9,6,114,F,51,8,4,100,-14,Severe
6,4,76,F,36,7,2,86,10,Well
11,4,136,M,103,13,6,162,26,Well
9,5,113,M,93,12,6,150,37,Well
6,5,77,F,78,11,0,132,55,Well
12,6,150,M,103,13,6,162,12,Well
7,5,89,M,70,10,2,122,33,Well
15,6,186,M,19,6,1,73,-113,Severe
18,1,217,F,57,8,10,106,-111,Severe
16,10,202,M,96,12,10,154,-48,Severe
15,11,191,F,36,7,2,86,-105,Severe
13,5,161,F,45,7,10,94,-67,Severe
11,0,132,M,16,5,11,71,-61,Severe
12,7,151,F,76,10,10,130,-21,Severe
11,4,136,F,28,6,8,80,-56,Severe
16,7,199,F,52,8,5,101,-98,Severe
13,7,163,M,15,5,11,71,-92,Severe
15,0,180,M,56,8,9,105,-75,Severe
7,2,86,F,49,8,2,98,12,Well
17,10,214,M,61,9,3,111,-103,Severe
13,5,161,M,13,5,9,69,-92,Severe
7,5,89,F,41,7,6,90,1,Good
13,7,163,F,9,5,7,67,-96,Severe
7,3,87,F,69,10,1,121,34,Well
7,1,85,M,72,10,4,124,39,Well
10,0,120,M,69,10,1,121,1,Good
6,2,74,M,79,11,1,133,59,Well
11,3,135,M,96,12,10,154,19,Well
17,2,206,F,100,13,3,159,-47,Severe
17,11,215,M,44,7,9,93,-122,Severe
18,0,216,M,56,8,9,105,-111,Severe
6,8,80,M,13,5,9,69,-11,Severe
11,3,135,M,12,5,9,69,-66,Severe
12,3,147,M,67,9,10,118,-29,Severe
8,0,96,M,90,12,3,147,51,Well
14,0,168,M,43,7,8,92,-76,Severe
14,0,168,F,2,5,3,63,-105,Severe
8,3,99,M,99,13,1,157,58,Well
11,9,141,F,45,7,10,94,-47,Severe
15,10,190,F,79,11,1,133,-57,Severe
15,10,190,F,44,7,9,93,-97,Severe
5,4,64,F,62,9,4,112,48,Well
9,7,115,M,110,14,3,171,56,Well
10,8,128,F,103,13,6,162,34,Well
12,11,155,M,78,11,0,132,-23,Severe
6,1,73,M,58,9,0,108,35,Well
17,4,208,F,9,5,7,67,-141,Severe
13,11,167,F,78,11,0,132,-35,Severe
8,6,102,F,3,5,3,63,-39,Severe
18,4,220,F,50,8,3,99,-121,Severe
13,8,164,M,30,6,9,81,-83,Severe
8,3,99,M,10,5,7,67,-32,Severe
15,3,183,M,105,13,9,165,-18,Severe
6,3,75,F,61,9,3,111,36,Well
8,2,98,F,19,6,1,73,-25,Severe
7,3,87,M,94,12,7,151,64,Well
11,3,135,M,89,12,1,145,10,Well
14,2,170,M,86,11,10,142,-28,Severe
17,4,208,F,46,7,11,95,-113,Severe
9,11,119,F,103,13,6,162,43,Well
5,0,60,M,93,12,6,150,90,Well
7,0,84,M,35,7,1,85,1,Good
17,8,212,M,28,6,8,80,-132,Severe
10,5,125,F,28,6,8,80,-45,Severe
11,7,139,M,46,7,11,95,-44,Severe
12,10,154,M,25,6,5,77,-77,Severe
13,1,157,M,105,13,9,165,8,Well
9,2,110,F,32,6,10,82,-28,Severe
18,6,222,M,78,11,0,132,-90,Severe
13,3,159,F,92,12,5,149,-10,Severe
6,11,83,F,56,8,9,105,22,Well
6,3,75,M,17,6,0,72,-3,Mild
5,11,71,F,38,7,4,88,17,Well
14,11,179,M,56,8,9,105,-74,Severe
14,3,171,M,18,6,1,73,-98,Severe
8,0,96,F,101,13,4,160,64,Well
16,3,195,M,20,6,2,74,-121,Severe
8,2,98,F,39,7,5,89,-9,Severe
15,3,183,M,74,10,7,127,-56,Severe
17,4,208,M,102,13,6,162,-46,Severe
16,10,202,M,110,14,3,171,-31,Severe
12,5,149,M,76,10,10,130,-19,Severe
14,8,176,M,87,11,11,143,-33,Severe
14,3,171,M,100,13,3,159,-12,Severe
7,8,92,F,17,6,0,72,-20,Severe
13,3,159,F,33,6,11,83,-76,Severe
17,3,207,F,63,9,6,114,-93,Severe
13,2,158,F,6,5,5,65,-93,Severe
7,10,94,M,68,10,0,120,26,Well
15,4,184,F,37,7,3,87,-97,Severe
16,9,201,F,102,13,6,162,-39,Severe
13,4,160,F,51,8,4,100,-60,Severe
10,2,122,F,10,5,7,67,-55,Severe
5,3,63,F,67,9,10,118,55,Well
14,0,168,F,65,9,8,116,-52,Severe
8,4,100,M,94,12,7,151,51,Well
11,0,132,M,55,8,8,104,-28,Severe
15,7,187,M,107,13,11,167,-20,Severe
13,4,160,F,86,11,10,142,-18,Severe
16,10,202,M,22,6,3,75,-127,Severe
16,5,197,M,99,13,1,157,-40,Severe
5,3,63,F,62,9,4,112,49,Well
13,7,163,M,29,6,8,80,-83,Severe
8,7,103,M,73,10,6,126,23,Well
11,6,138,F,38,7,4,88,-50,Severe
5,5,65,M,27,6,7,79,14,Well
5,2,62,M,29,6,8,80,18,Well
17,3,207,F,83,11,6,138,-69,Severe
10,6,126,M,7,5,6,66,-60,Severe
12,5,149,M,74,10,7,127,-22,Severe
17,9,213,M,82,11,5,137,-76,Severe
16,11,203,M,27,6,7,79,-124,Severe
8,0,96,F,64,9,7,115,19,Well
12,10,154,M,17,6,0,72,-82,Severe
9,1,109,M,58,9,0,108,-1,Mild
5,10,70,M,42,7,7,91,21,Well
8,10,106,M,32,6,10,82,-24,Severe
17,11,215,M,108,14,0,168,-47,Severe
17,3,207,M,13,5,9,69,-138,Severe
7,8,92,M,46,7,11,95,3,Good
17,3,207,F,71,10,3,123,-84,Severe
16,3,195,M,20,6,2,74,-121,Severe
9,2,110,M,12,5,9,69,-41,Severe
15,3,183,M,32,6,10,82,-101,Severe
13,9,165,M,42,7,7,91,-74,Severe
18,10,226,M,81,11,4,136,-90,Severe
7,0,84,M,79,11,1,133,49,Well
6,7,79,F,105,13,9,165,86,Well
7,1,85,F,7,5,6,66,-19,Severe
5,0,60,F,95,12,9,153,93,Well
12,3,147,M,48,8,1,97,-50,Severe
13,3,159,F,84,11,7,139,-20,Severe
16,0,192,M,11,5,8,68,-124,Severe
12,8,152,M,17,6,0,72,-80,Severe
9,1,109,F,81,11,4,136,27,Well
7,9,93,M,17,6,0,72,-21,Severe
8,6,102,F,103,13,6,162,60,Well
9,3,111,M,13,5,9,69,-42,Severe
10,3,123,M,67,9,10,118,-5,Mild
15,4,184,F,59,9,1,109,-75,Severe
6,9,81,F,63,9,6,114,33,Well
5,3,63,M,26,6,6,78,15,Well
16,1,193,F,76,10,10,130,-63,Severe
9,10,118,M,21,6,2,74,-44,Severe
8,4,100,F,57,8,10,106,6,Well
8,8,104,M,69,10,1,121,17,Well
11,0,132,F,11,5,8,68,-64,Severe
13,8,164,M,16,5,11,71,-93,Severe
6,4,76,F,18,6,1,73,-3,Mild
14,4,172,F,55,8,8,104,-68,Severe
18,3,219,F,59,9,1,109,-110,Severe
9,5,113,F,99,13,1,157,44,Well
5,0,60,F,26,6,6,78,18,Well
13,9,165,F,3,5,3,63,-102,Severe
10,5,125,M,59,9,1,109,-16,Severe
14,11,179,F,15,5,11,71,-108,Severe
13,6,162,F,28,6,8,80,-82,Severe
7,0,84,F,14,5,10,70,-14,Severe
16,11,203,M,95,12,9,153,-50,Severe
12,9,153,F,43,7,8,92,-61,Severe
10,1,121,F,50,8,3,99,-22,Severe
17,10,214,F,17,6,0,72,-142,Severe
13,3,159,M,81,11,4,136,-23,Severe
9,3,111,F,31,6,9,81,-30,Severe
7,6,90,M,33,6,11,83,-7,Severe
14,5,173,F,65,9,8,116,-57,Severe
8,11,107,M,103,13,6,162,55,Well
5,1,61,M,85,11,9,141,80,Well
8,10,106,M,35,7,1,85,-21,Severe
13,5,161,F,86,11,10,142,-19,Severe
14,6,174,F,36,7,2,86,-88,Severe
11,3,135,F,72,10,4,124,-11,Severe
18,11,227,F,13,5,9,69,-158,Severe
8,5,101,M,100,13,3,159,58,Well
10,4,124,F,96,12,10,154,30,Well
15,1,181,F,56,8,9,105,-76,Severe
7,8,92,F,68,10,0,120,28,Well
14,7,175,F,80,11,3,135,-40,Severe
16,3,195,F,38,7,4,88,-107,Severe
16,9,201,F,30,6,9,81,-120,Severe
14,9,177,F,70,10,2,122,-55,Severe
6,8,80,F,60,9,2,110,30,Well
17,1,205,M,61,9,3,111,-94,Severe
15,1,181,F,78,11,0,132,-49,Severe
7,4,88,F,81,11,4,136,48,Well
15,7,187,M,8,5,6,66,-121,Severe
5,9,69,M,41,7,6,90,21,Well
9,2,110,M,53,8,6,102,-8,Severe
17,1,205,M,26,6,6,78,-127,Severe
6,3,75,F,85,11,9,141,66,Well
5,3,63,M,5,5,5,65,2,Good
5,6,66,F,95,12,9,153,87,Well
9,5,113,F,102,13,6,162,49,Well
14,6,174,M,83,11,6,138,-36,Severe
11,2,134,F,5,5,5,65,-69,Severe
15,2,182,M,71,10,3,123,-59,Severe
9,3,111,F,51,8,4,100,-11,Severe
12,3,147,F,21,6,2,74,-73,Severe
7,4,88,M,41,7,6,90,2,Good
8,5,101,F,101,13,4,160,59,Well
6,1,73,F,62,9,4,112,39,Well
5,4,64,F,99,13,1,157,93,Well
14,3,171,M,19,6,1,73,-98,Severe
17,2,206,M,79,11,1,133,-73,Severe
15,11,191,F,10,5,7,67,-124,Severe
14,1,169,F,16,5,11,71,-98,Severe
9,5,113,F,37,7,3,87,-26,Severe
5,4,64,F,50,8,3,99,35,Well
12,11,155,M,80,11,3,135,-20,Severe
6,11,83,F,7,5,6,66,-17,Severe
16,3,195,F,17,6,0,72,-123,Severe
15,9,189,M,72,10,4,124,-65,Severe
13,10,166,F,98,13,0,156,-10,Severe
6,6,78,M,28,6,8,80,2,Good
11,2,134,M,13,5,9,69,-65,Severe
17,5,209,M,69,10,1,121,-88,Severe
16,7,199,M,47,8,0,96,-103,Severe
6,4,76,F,94,12,7,151,75,Well
9,4,112,F,40,7,5,89,-23,Severe
6,9,81,M,45,7,10,94,13,Well
10,7,127,M,44,7,9,93,-34,Severe
14,9,177,M,36,7,2,86,-91,Severe
13,6,162,M,49,8,2,98,-64,Severe
9,4,112,F,107,13,11,167,55,Well
6,4,76,M,22,6,3,75,-1,Mild
9,11,119,M,105,13,9,165,46,Well
16,3,195,F,63,9,6,114,-81,Severe
6,0,72,M,89,12,1,145,73,Well
13,5,161,F,9,5,7,67,-94,Severe
10,5,125,M,65,9,8,116,-9,Severe
7,5,89,M,41,7,6,90,1,Good
17,2,206,M,86,11,10,142,-64,Severe
10,3,123,M,28,6,8,80,-43,Severe
14,3,171,F,45,7,10,94,-77,Severe
9,10,118,M,110,14,3,171,53,Well
17,11,215,M,36,7,2,86,-129,Severe
16,3,195,F,107,13,11,167,-28,Severe
8,8,104,F,24,6,5,77,-27,Severe
11,9,141,M,63,9,6,114,-27,Severe
7,1,85,F,47,8,0,96,11,Well
14,4,172,M,18,6,1,73,-99,Severe
15,7,187,M,99,13,1,157,-30,Severe
7,0,84,F,82,11,5,137,53,Well
12,9,153,F,36,7,2,86,-67,Severe
18,10,226,F,85,11,9,141,-85,Severe
16,7,199,M,48,8,1,97,-102,Severe
15,2,182,F,49,8,2,98,-84,Severe
12,3,147,F,104,13,7,163,16,Well
18,11,227,M,95,12,9,153,-74,Severe
6,6,78,F,86,11,10,142,64,Well
5,4,64,F,91,12,4,148,84,Well
9,3,111,M,44,7,9,93,-18,Severe
13,10,166,F,30,6,9,81,-85,Severe
9,3,111,M,12,5,9,69,-42,Severe
8,8,104,M,22,6,3,75,-29,Severe
8,8,104,M,41,7,6,90,-14,Severe
11,10,142,F,78,11,0,132,-10,Severe
12,10,154,F,60,9,2,110,-44,Severe
14,0,168,F,66,9,9,117,-51,Severe
6,1,73,M,5,5,5,65,-8,Severe
17,8,212,F,93,12,6,150,-62,Severe
8,7,103,M,23,6,4,76,-27,Severe
10,0,120,M,83,11,6,138,18,Well
5,4,64,F,4,5,4,64,0,Neutral
8,7,103,M,64,9,7,115,12,Well
10,2,122,F,49,8,2,98,-24,Severe
16,11,203,M,54,8,7,103,-100,Severe
5,3,63,F,66,9,9,117,54,Well
8,0,96,M,30,6,9,81,-15,Severe
5,6,66,M,97,12,11,155,89,Well
10,9,129,M,19,6,1,73,-56,Severe
10,9,129,F,46,7,11,95,-34,Severe
16,8,200,F,26,6,6,78,-122,Severe
5,5,65,M,6,5,5,65,0,Neutral
18,2,218,F,23,6,4,76,-142,Severe
6,0,72,F,40,7,5,89,17,Well
10,8,128,M,96,12,10,154,26,Well
18,0,216,M,10,5,7,67,-149,Severe
13,5,161,F,107,13,11,167,6,Well
6,5,77,M,56,8,9,105,28,Well
13,6,162,M,98,13,0,156,-6,Severe
18,2,218,F,29,6,8,80,-138,Severe
12,4,148,F,13,5,9,69,-79,Severe
6,9,81,M,41,7,6,90,9,Well
10,6,126,M,106,13,10,166,40,Well
17,11,215,F,110,14,3,171,-44,Severe
13,7,163,M,58,9,0,108,-55,Severe
9,7,115,F,55,8,8,104,-11,Severe
16,2,194,F,13,5,9,69,-125,Severe
18,7,223,M,98,13,0,156,-67,Severe
7,3,87,F,43,7,8,92,5,Good
13,9,165,M,15,5,11,71,-94,Severe
11,4,136,F,84,11,7,139,3,Good
11,0,132,M,106,13,10,166,34,Well
14,3,171,M,2,5,3,63,-108,Severe
8,4,100,M,2,5,3,63,-37,Severe
12,5,149,M,54,8,7,103,-46,Severe
12,3,147,M,7,5,6,66,-81,Severe
12,7,151,M,97,12,11,155,4,Good
14,10,178,F,26,6,6,78,-100,Severe
11,5,137,F,29,6,8,80,-57,Severe
18,4,220,F,6,5,5,65,-155,Severe
12,2,146,F,14,5,10,70,-76,Severe
17,11,215,F,71,10,3,123,-92,Severe
13,8,164,M,86,11,10,142,-22,Severe
7,10,94,F,87,11,11,143,49,Well
17,3,207,M,105,13,9,165,-42,Severe
17,4,208,F,54,8,7,103,-105,Severe
16,3,195,M,5,5,5,65,-130,Severe
15,8,188,M,110,14,3,171,-17,Severe
7,5,89,F,40,7,5,89,0,Neutral
6,4,76,M,18,6,1,73,-3,Mild
9,9,117,M,17,6,0,72,-45,Severe
16,0,192,F,60,9,2,110,-82,Severe
5,11,71,F,96,12,10,154,83,Well
10,0,120,F,46,7,11,95,-25,Severe
15,1,181,M,70,10,2,122,-59,Severe
16,8,200,M,83,11,6,138,-62,Severe
16,7,199,M,40,7,5,89,-110,Severe
15,8,188,F,51,8,4,100,-88,Severe
16,0,192,F,26,6,6,78,-114,Severe
10,10,130,F,35,7,1,85,-45,Severe
13,3,159,M,28,6,8,80,-79,Severe
11,1,133,M,46,7,11,95,-38,Severe
12,4,148,M,9,5,7,67,-81,Severe
9,5,113,F,4,5,4,64,-49,Severe
14,2,170,M,63,9,6,114,-56,Severe
17,9,213,F,22,6,3,75,-138,Severe
5,9,69,M,92,12,5,149,80,Well
16,1,193,F,7,5,6,66,-127,Severe
8,6,102,F,30,6,9,81,-21,Severe
17,5,209,F,51,8,4,100,-109,Severe
12,3,147,F,53,8,6,102,-45,Severe
17,8,212,F,24,6,5,77,-135,Severe
16,5,197,M,89,12,1,145,-52,Severe
7,4,88,F,19,6,1,73,-15,Severe
13,8,164,M,51,8,4,100,-64,Severe
15,3,183,F,16,5,11,71,-112,Severe
9,0,108,M,79,11,1,133,25,Well
10,7,127,F,62,9,4,112,-15,Severe
5,8,68,F,65,9,8,116,48,Well
13,7,163,F,13,5,9,69,-94,Severe
13,7,163,M,65,9,8,116,-47,Severe
8,4,100,M,25,6,5,77,-23,Severe
10,3,123,F,61,9,3,111,-12,Severe
11,11,143,F,98,13,0,156,13,Well
8,4,100,M,21,6,2,74,-26,Severe
8,2,98,F,94,12,7,151,53,Well
8,11,107,F,81,11,4,136,29,Well
6,7,79,M,53,8,6,102,23,Well
15,9,189,M,25,6,5,77,-112,Severe
8,10,106,F,64,9,7,115,9,Well
17,9,213,F,69,10,1,121,-92,Severe
9,9,117,M,3,5,3,63,-54,Severe
5,10,70,F,109,14,1,169,99,Well
5,6,66,F,43,7,8,92,26,Well
17,3,207,M,81,11,4,136,-71,Severe
7,3,87,F,4,5,4,64,-23,Severe
12,2,146,F,40,7,5,89,-57,Severe
7,1,85,F,66,9,9,117,32,Well
8,10,106,F,100,13,3,159,53,Well
5,10,70,M,18,6,1,73,3,Good
6,4,76,M,91,12,4,148,72,Well
12,10,154,M,86,11,10,142,-12,Severe
15,4,184,M,109,14,1,169,-15,Severe
7,3,87,F,39,7,5,89,2,Good
7,10,94,M,33,6,11,83,-11,Severe
15,2,182,F,81,11,4,136,-46,Severe
5,3,63,F,9,5,7,67,4,Good
9,3,111,M,102,13,6,162,51,Well
10,0,120,M,5,5,5,65,-55,Severe
15,1,181,M,93,12,6,150,-31,Severe
10,2,122,F,80,11,3,135,13,Well
12,5,149,M,19,6,1,73,-76,Severe
5,8,68,F,104,13,7,163,95,Well
11,5,137,M,9,5,7,67,-70,Severe
12,1,145,M,88,12,0,144,-1,Mild
5,10,70,M,48,8,1,97,27,Well
6,3,75,F,8,5,6,66,-9,Severe
15,9,189,M,105,13,9,165,-24,Severe
10,6,126,F,38,7,4,88,-38,Severe
11,1,133,M,107,13,11,167,34,Well
5,0,60,M,53,8,6,102,42,Well
7,11,95,F,2,5,3,63,-32,Severe
16,0,192,M,35,7,1,85,-107,Severe
7,11,95,F,25,6,5,77,-18,Severe
14,6,174,F,91,12,4,148,-26,Severe
9,8,116,M,13,5,9,69,-47,Severe
18,6,222,F,33,6,11,83,-139,Severe
6,0,72,F,16,5,11,71,-1,Mild
7,9,93,F,62,9,4,112,19,Well
18,3,219,F,41,7,6,90,-129,Severe
7,2,86,M,69,10,1,121,35,Well
13,4,160,F,89,12,1,145,-15,Severe
6,11,83,F,95,12,9,153,70,Well
12,3,147,M,94,12,7,151,4,Good
14,3,171,F,18,6,1,73,-98,Severe
17,11,215,M,16,5,11,71,-144,Severe
7,6,90,F,78,11,0,132,42,Well
7,9,93,M,53,8,6,102,9,Well
15,8,188,M,83,11,6,138,-50,Severe
10,9,129,M,25,6,5,77,-52,Severe
18,7,223,M,81,11,4,136,-87,Severe
8,3,99,M,24,6,5,77,-22,Severe
13,8,164,M,53,8,6,102,-62,Severe
11,11,143,M,61,9,3,111,-32,Severe
5,3,63,F,23,6,4,76,13,Well
14,9,177,M,105,13,9,165,-12,Severe
9,8,116,F,2,5,3,63,-53,Severe
16,11,203,M,72,10,4,124,-79,Severe
10,7,127,M,46,7,11,95,-32,Severe
8,2,98,F,6,5,5,65,-33,Severe
11,10,142,F,38,7,4,88,-54,Severe
17,1,205,F,59,9,1,109,-96,Severe
9,3,111,F,82,11,5,137,26,Well
9,6,114,F,72,10,4,124,10,Well
5,10,70,M,39,7,5,89,19,Well
18,2,218,M,109,14,1,169,-49,Severe
11,2,134,M,110,14,3,171,37,Well
17,6,210,M,58,9,0,108,-102,Severe
13,3,159,F,29,6,8,80,-79,Severe
7,3,87,F,65,9,8,116,29,Well
5,10,70,F,21,6,2,74,4,Good
6,5,77,M,46,7,11,95,18,Well
10,11,131,M,70,10,2,122,-9,Severe
13,5,161,M,86,11,10,142,-19,Severe
12,10,154,M,7,5,6,66,-88,Severe
7,8,92,M,31,6,9,81,-11,Severe
12,4,148,M,4,5,4,64,-84,Severe
18,7,223,F,89,12,1,145,-78,Severe
13,3,159,F,103,13,6,162,3,Good
14,11,179,F,42,7,7,91,-88,Severe
9,10,118,F,50,8,3,99,-19,Severe
16,4,196,M,103,13,6,162,-34,Severe
10,6,126,M,27,6,7,79,-47,Severe
12,6,150,M,78,11,0,132,-18,Severe
11,9,141,M,100,13,3,159,18,Well
13,10,166,F,15,5,11,71,-95,Severe
17,3,207,M,102,13,6,162,-45,Severe
6,11,83,F,75,10,9,129,46,Well
10,1,121,M,17,6,0,72,-49,Severe
14,8,176,M,93,12,6,150,-26,Severe
18,3,219,F,103,13,6,162,-57,Severe
13,10,166,M,36,7,2,86,-80,Severe
5,0,60,F,103,13,6,162,102,Well
17,1,205,F,99,13,1,157,-48,Severe
7,9,93,M,98,13,0,156,63,Well
6,10,82,F,50,8,3,99,17,Well
8,2,98,F,96,12,10,154,56,Well
7,9,93,M,95,12,9,153,60,Well
13,6,162,F,13,5,9,69,-93,Severe
10,1,121,M,28,6,8,80,-41,Severe
6,5,77,M,80,11,3,135,58,Well
11,10,142,M,61,9,3,111,-31,Severe
10,8,128,F,107,13,11,167,39,Well
8,1,97,M,56,8,9,105,8,Well
13,2,158,M,77,10,11,131,-27,Severe
8,2,98,M,32,6,10,82,-16,Severe
17,3,207,M,78,11,0,132,-75,Severe
14,8,176,M,86,11,10,142,-34,Severe
11,6,138,F,90,12,3,147,9,Well
7,3,87,F,77,10,11,131,44,Well
13,6,162,M,96,12,10,154,-8,Severe
18,4,220,M,22,6,3,75,-145,Severe
5,4,64,M,23,6,4,76,12,Well
6,2,74,F,6,5,5,65,-9,Severe
17,7,211,M,88,12,0,144,-67,Severe
9,9,117,M,59,9,1,109,-8,Severe
16,4,196,F,105,13,9,165,-31,Severe
16,10,202,F,2,5,3,63,-139,Severe
11,11,143,F,97,12,11,155,12,Well
13,8,164,F,27,6,7,79,-85,Severe
7,5,89,M,29,6,8,80,-9,Severe
14,9,177,M,30,6,9,81,-96,Severe
15,4,184,F,35,7,1,85,-99,Severe
13,4,160,F,28,6,8,80,-80,Severe
11,9,141,M,92,12,5,149,8,Well
17,0,204,M,55,8,8,104,-100,Severe
12,6,150,M,74,10,7,127,-23,Severe
15,11,191,M,87,11,11,143,-48,Severe
12,2,146,M,46,7,11,95,-51,Severe
7,8,92,F,77,10,11,131,39,Well
17,10,214,M,98,13,0,156,-58,Severe
5,1,61,F,12,5,9,69,8,Well
15,9,189,F,97,12,11,155,-34,Severe
16,5,197,F,11,5,8,68,-129,Severe
13,10,166,M,100,13,3,159,-7,Severe
18,6,222,F,8,5,6,66,-156,Severe
10,4,124,F,81,11,4,136,12,Well
10,1,121,F,83,11,6,138,17,Well
5,10,70,F,22,6,3,75,5,Good
6,11,83,M,71,10,3,123,40,Well
10,0,120,M,51,8,4,100,-20,Severe
8,7,103,F,43,7,8,92,-11,Severe
6,3,75,M,104,13,7,163,88,Well
18,0,216,M,35,7,1,85,-131,Severe
12,4,148,F,92,12,5,149,1,Good
12,3,147,F,28,6,8,80,-67,Severe
16,10,202,F,17,6,0,72,-130,Severe
8,4,100,M,75,10,9,129,29,Well
8,8,104,F,50,8,3,99,-5,Mild
15,3,183,M,77,10,11,131,-52,Severe
17,7,211,M,63,9,6,114,-97,Severe
9,6,114,F,102,13,6,162,48,Well
13,7,163,M,103,13,6,162,-1,Mild
9,2,110,F,33,6,11,83,-27,Severe
6,9,81,F,29,6,8,80,-1,Mild
18,9,225,M,106,13,10,166,-59,Severe
18,4,220,F,10,5,7,67,-153,Severe
12,7,151,M,77,10,11,131,-20,Severe
6,7,79,M,11,5,8,68,-11,Severe
12,10,154,F,49,8,2,98,-56,Severe
18,0,216,F,74,10,7,127,-89,Severe
9,6,114,M,100,13,3,159,45,Well
17,3,207,M,20,6,2,74,-133,Severe
16,3,195,M,69,10,1,121,-74,Severe
16,5,197,M,49,8,2,98,-99,Severe
8,3,99,F,32,6,10,82,-17,Severe
18,4,220,F,96,12,10,154,-66,Severe
10,5,125,M,10,5,7,67,-58,Severe
5,0,60,F,80,11,3,135,75,Well
15,1,181,F,107,13,11,167,-14,Severe
6,0,72,F,7,5,6,66,-6,Severe
5,3,63,M,67,9,10,118,55,Well
10,4,124,F,59,9,1,109,-15,Severe
9,10,118,M,7,5,6,66,-52,Severe
6,5,77,F,48,8,1,97,20,Well
9,3,111,F,89,12,1,145,34,Well
8,8,104,F,54,8,7,103,-1,Mild
6,6,78,F,36,7,2,86,8,Well
16,3,195,F,32,6,10,82,-113,Severe
12,3,147,F,14,5,10,70,-77,Severe
13,3,159,M,22,6,3,75,-84,Severe
5,3,63,M,16,5,11,71,8,Well
18,11,227,F,26,6,6,78,-149,Severe
18,6,222,F,108,14,0,168,-54,Severe
7,7,91,F,2,5,3,63,-28,Severe
10,6,126,M,59,9,1,109,-17,Severe
15,9,189,F,40,7,5,89,-100,Severe
10,5,125,M,99,13,1,157,32,Well
15,3,183,F,97,12,11,155,-28,Severe
17,1,205,F,43,7,8,92,-113,Severe
11,4,136,M,37,7,3,87,-49,Severe
17,0,204,M,43,7,8,92,-112,Severe
11,7,139,M,69,10,1,121,-18,Severe
7,9,93,M,56,8,9,105,12,Well
12,3,147,F,100,13,3,159,12,Well
16,2,194,M,24,6,5,77,-117,Severe
16,6,198,F,73,10,6,126,-72,Severe
15,6,186,F,63,9,6,114,-72,Severe
18,6,222,F,25,6,5,77,-145,Severe
6,9,81,M,93,12,6,150,69,Well
14,7,175,F,58,9,0,108,-67,Severe
6,9,81,M,91,12,4,148,67,Well
8,0,96,M,75,10,9,129,33,Well
16,2,194,F,94,12,7,151,-43,Severe
16,0,192,M,73,10,6,126,-66,Severe
9,3,111,M,85,11,9,141,30,Well
16,0,192,M,93,12,6,150,-42,Severe
13,2,158,M,80,11,3,135,-23,Severe
18,5,221,M,97,12,11,155,-66,Severe
5,3,63,F,69,10,1,121,58,Well
16,0,192,M,61,9,3,111,-81,Severe
11,0,132,F,94,12,7,151,19,Well
17,1,205,F,25,6,5,77,-128,Severe
17,3,207,F,89,12,1,145,-62,Severe
15,4,184,M,18,6,1,73,-111,Severe
5,3,63,F,76,10,10,130,67,Well
8,3,99,F,46,7,11,95,-4,Mild
9,11,119,F,2,5,3,63,-56,Severe
9,6,114,F,40,7,5,89,-25,Severe
14,5,173,F,96,12,10,154,-19,Severe
14,5,173,M,83,11,6,138,-35,Severe
5,3,63,M,24,6,5,77,14,Well
15,2,182,M,92,12,5,149,-33,Severe
13,10,166,M,86,11,10,142,-24,Severe
13,7,163,M,12,5,9,69,-94,Severe
17,6,210,M,38,7,4,88,-122,Severe
14,0,168,M,87,11,11,143,-25,Severe
5,2,62,M,58,9,0,108,46,Well
6,2,74,F,16,5,11,71,-3,Mild
10,0,120,F,48,8,1,97,-23,Severe
15,4,184,M,80,11,3,135,-49,Severe
17,1,205,M,39,7,5,89,-116,Severe
9,6,114,M,75,10,9,129,15,Well
8,10,106,F,27,6,7,79,-27,Severe
9,7,115,F,47,8,0,96,-19,Severe
17,10,214,M,24,6,5,77,-137,Severe
12,0,144,M,69,10,1,121,-23,Severe
14,0,168,M,19,6,1,73,-95,Severe
6,10,82,M,8,5,6,66,-16,Severe
18,2,218,F,87,11,11,143,-75,Severe
18,3,219,M,29,6,8,80,-139,Severe
16,2,194,F,32,6,10,82,-112,Severe
14,10,178,F,64,9,7,115,-63,Severe
16,4,196,F,13,5,9,69,-127,Severe
14,2,170,F,87,11,11,143,-27,Severe
13,5,161,M,41,7,6,90,-71,Severe
6,0,72,M,35,7,1,85,13,Well
10,4,124,F,104,13,7,163,39,Well
7,4,88,M,9,5,7,67,-21,Severe
6,0,72,M,34,7,0,84,12,Well
5,3,63,F,82,11,5,137,74,Well
8,4,100,M,102,13,6,162,62,Well
6,0,72,F,24,6,5,77,5,Good
9,11,119,F,81,11,4,136,17,Well
16,5,197,F,60,9,2,110,-87,Severe
12,0,144,M,89,12,1,145,1,Good
6,0,72,M,25,6,5,77,5,Good
8,11,107,F,109,14,1,169,62,Well
7,10,94,F,20,6,2,74,-20,Severe
8,6,102,M,55,8,8,104,2,Good
13,10,166,F,74,10,7,127,-39,Severe
8,2,98,M,80,11,3,135,37,Well
9,7,115,M,33,6,11,83,-32,Severe
9,3,111,M,71,10,3,123,12,Well
9,0,108,M,83,11,6,138,30,Well
15,0,180,F,84,11,7,139,-41,Severe
5,2,62,M,95,12,9,153,91,Well
13,1,157,F,110,14,3,171,14,Well
13,7,163,M,55,8,8,104,-59,Severe
6,8,80,F,47,8,0,96,16,Well
17,5,209,F,103,13,6,162,-47,Severe
12,3,147,F,72,10,4,124,-23,Severe
12,9,153,F,54,8,7,103,-50,Severe
5,4,64,M,54,8,7,103,39,Well
6,1,73,F,94,12,7,151,78,Well
10,1,121,F,90,12,3,147,26,Well
14,4,172,M,97,12,11,155,-17,Severe
9,10,118,M,20,6,2,74,-44,Severe
8,3,99,M,86,11,10,142,43,Well
7,3,87,F,42,7,7,91,4,Good
10,5,125,M,86,11,10,142,17,Well
16,5,197,M,101,13,4,160,-37,Severe
5,1,61,F,3,5,3,63,2,Good
8,9,105,F,63,9,6,114,9,Well
9,2,110,M,61,9,3,111,1,Good
10,1,121,M,15,5,11,71,-50,Severe
11,4,136,F,9,5,7,67,-69,Severe
14,3,171,M,15,5,11,71,-100,Severe
18,0,216,M,8,5,6,66,-150,Severe
14,9,177,M,15,5,11,71,-106,Severe
18,4,220,M,104,13,7,163,-57,Severe
11,4,136,M,75,10,9,129,-7,Severe
18,11,227,F,17,6,0,72,-155,Severe
18,2,218,M,53,8,6,102,-116,Severe
9,3,111,F,71,10,3,123,12,Well
8,1,97,F,37,7,3,87,-10,Severe
8,5,101,F,50,8,3,99,-2,Mild
18,9,225,M,16,5,11,71,-154,Severe
9,1,109,M,51,8,4,100,-9,Severe
13,0,156,M,58,9,0,108,-48,Severe
8,7,103,F,24,6,5,77,-26,Severe
7,4,88,F,97,12,11,155,67,Well
5,5,65,M,49,8,2,98,33,Well
8,8,104,F,39,7,5,89,-15,Severe
5,2,62,F,47,8,0,96,34,Well
11,4,136,M,81,11,4,136,0,Neutral
11,4,136,F,58,9,0,108,-28,Severe
6,8,80,F,89,12,1,145,65,Well
17,6,210,F,9,5,7,67,-143,Severe
6,6,78,M,5,5,5,65,-13,Severe
18,9,225,F,50,8,3,99,-126,Severe
16,0,192,M,63,9,6,114,-78,Severe
18,6,222,M,33,6,11,83,-139,Severe
5,8,68,F,60,9,2,110,42,Well
16,5,197,F,10,5,7,67,-130,Severe
10,5,125,M,74,10,7,127,2,Good
5,7,67,M,83,11,6,138,71,Well
6,1,73,F,100,13,3,159,86,Well
14,9,177,F,59,9,1,109,-68,Severe
10,2,122,M,104,13,7,163,41,Well
8,6,102,F,85,11,9,141,39,Well
18,4,220,M,64,9,7,115,-105,Severe
13,8,164,M,19,6,1,73,-91,Severe
10,5,125,F,81,11,4,136,11,Well
13,10,166,M,75,10,9,129,-37,Severe
18,3,219,M,4,5,4,64,-155,Severe
7,7,91,F,83,11,6,138,47,Well
10,3,123,M,43,7,8,92,-31,Severe
5,8,68,F,99,13,1,157,89,Well
15,1,181,M,103,13,6,162,-19,Severe
18,10,226,F,5,5,5,65,-161,Severe
15,7,187,F,8,5,6,66,-121,Severe
11,10,142,M,47,8,0,96,-46,Severe
15,3,183,F,2,5,3,63,-120,Severe
13,5,161,F,40,7,5,89,-72,Severe
5,0,60,M,20,6,2,74,14,Well
13,7,163,F,52,8,5,101,-62,Severe
6,10,82,F,15,5,11,71,-11,Severe
7,9,93,F,26,6,6,78,-15,Severe
12,11,155,M,60,9,2,110,-45,Severe
5,0,60,F,87,11,11,143,83,Well
15,4,184,F,40,7,5,89,-95,Severe
11,3,135,F,69,10,1,121,-14,Severe
8,4,100,M,77,10,11,131,31,Well
5,4,64,M,15,5,11,71,7,Well
8,6,102,F,110,14,3,171,69,Well
15,9,189,F,54,8,7,103,-86,Severe
11,7,139,F,45,7,10,94,-45,Severe
15,9,189,M,20,6,2,74,-115,Severe
9,10,118,M,34,7,0,84,-34,Severe
12,11,155,M,55,8,8,104,-51,Severe
8,4,100,F,64,9,7,115,15,Well
18,4,220,F,78,11,0,132,-88,Severe
18,4,220,F,41,7,6,90,-130,Severe
15,0,180,F,25,6,5,77,-103,Severe
11,9,141,F,50,8,3,99,-42,Severe
8,0,96,M,38,7,4,88,-8,Severe
16,4,196,M,9,5,7,67,-129,Severe
12,11,155,F,87,11,11,143,-12,Severe
18,8,224,F,20,6,2,74,-150,Severe
13,9,165,M,79,11,1,133,-32,Severe
10,6,126,F,110,14,3,171,45,Well
11,10,142,F,105,13,9,165,23,Well
11,10,142,F,81,11,4,136,-6,Severe
8,7,103,F,12,5,9,69,-34,Severe
13,4,160,M,60,9,2,110,-50,Severe
13,8,164,F,48,8,1,97,-67,Severe
18,4,220,M,82,11,5,137,-83,Severe
16,5,197,F,27,6,7,79,-118,Severe
9,10,118,F,62,9,4,112,-6,Severe
10,9,129,F,30,6,9,81,-48,Severe
11,3,135,M,39,7,5,89,-46,Severe
11,8,140,M,41,7,6,90,-50,Severe
13,3,159,M,11,5,8,68,-91,Severe
5,10,70,F,36,7,2,86,16,Well
5,4,64,F,9,5,7,67,3,Good
16,0,192,F,9,5,7,67,-125,Severe
7,6,90,F,52,8,5,101,11,Well
5,4,64,M,62,9,4,112,48,Well
10,6,126,F,36,7,2,86,-40,Severe
5,3,63,M,66,9,9,117,54,Well
17,1,205,M,108,14,0,168,-37,Severe
12,0,144,M,7,5,6,66,-78,Severe
9,4,112,F,63,9,6,114,2,Good
9,6,114,F,7,5,6,66,-48,Severe
14,3,171,F,83,11,6,138,-33,Severe
8,0,96,M,81,11,4,136,40,Well
5,7,67,F,44,7,9,93,26,Well
17,3,207,M,34,7,0,84,-123,Severe
5,3,63,F,66,9,9,117,54,Well
10,10,130,M,101,13,4,160,30,Well
16,1,193,F,45,7,10,94,-99,Severe
9,10,118,F,80,11,3,135,17,Well
8,7,103,M,62,9,4,112,9,Well
16,11,203,F,31,6,9,81,-122,Severe
7,8,92,M,23,6,4,76,-16,Severe
12,0,144,F,104,13,7,163,19,Well
9,4,112,M,31,6,9,81,-31,Severe
18,9,225,M,45,7,10,94,-131,Severe
13,2,158,F,36,7,2,86,-72,Severe
9,7,115,F,36,7,2,86,-29,Severe
13,4,160,F,49,8,2,98,-62,Severe
6,8,80,M,97,12,11,155,75,Well
6,2,74,M,22,6,3,75,1,Good
6,5,77,M,49,8,2,98,21,Well
10,5,125,F,45,7,10,94,-31,Severe
6,0,72,F,91,12,4,148,76,Well
17,5,209,M,29,6,8,80,-129,Severe
7,3,87,F,64,9,7,115,28,Well
9,6,114,M,79,11,1,133,19,Well
7,2,86,F,7,5,6,66,-20,Severe
8,0,96,M,37,7,3,87,-9,Severe
5,11,71,F,36,7,2,86,15,Well
16,6,198,F,39,7,5,89,-109,Severe
16,4,196,F,61,9,3,111,-85,Severe
10,7,127,M,24,6,5,77,-50,Severe
8,3,99,M,35,7,1,85,-14,Severe
9,0,108,M,72,10,4,124,16,Well
16,11,203,M,44,7,9,93,-110,Severe
14,1,169,F,52,8,5,101,-68,Severe
15,11,191,F,28,6,8,80,-111,Severe
17,6,210,M,91,12,4,148,-62,Severe
6,8,80,F,6,5,5,65,-15,Severe
17,10,214,F,79,11,1,133,-81,Severe
7,3,87,F,52,8,5,101,14,Well
8,3,99,F,41,7,6,90,-9,Severe
6,3,75,M,89,12,1,145,70,Well
5,5,65,M,90,12,3,147,82,Well
11,0,132,F,103,13,6,162,30,Well
8,6,102,F,18,6,1,73,-29,Severe
14,9,177,M,76,10,10,130,-47,Severe
15,0,180,F,83,11,6,138,-42,Severe
6,0,72,M,59,9,1,109,37,Well
14,7,175,F,103,13,6,162,-13,Severe
7,2,86,F,20,6,2,74,-12,Severe
17,1,205,F,34,7,0,84,-121,Severe
5,0,60,F,19,6,1,73,13,Well
15,6,186,M,48,8,1,97,-89,Severe
6,7,79,F,2,5,3,63,-16,Severe
5,4,64,M,61,9,3,111,47,Well
10,8,128,M,16,5,11,71,-57,Severe
10,6,126,F,19,6,1,73,-53,Severe
5,1,61,F,71,10,3,123,62,Well
6,0,72,M,96,12,10,154,82,Well
5,4,64,F,28,6,8,80,16,Well
16,5,197,M,90,12,3,147,-50,Severe
7,2,86,M,85,11,9,141,55,Well
5,0,60,M,62,9,4,112,52,Well
10,3,123,M,69,10,1,121,-2,Mild
7,11,95,M,107,13,11,167,72,Well
9,7,115,F,92,12,5,149,34,Well
6,6,78,M,102,13,6,162,84,Well
14,3,171,F,51,8,4,100,-71,Severe
10,8,128,M,81,11,4,136,8,Well
16,0,192,F,56,8,9,105,-87,Severe
11,10,142,M,3,5,3,63,-79,Severe
11,5,137,M,42,7,7,91,-46,Severe
10,0,120,F,45,7,10,94,-26,Severe
14,11,179,F,9,5,7,67,-112,Severe
18,7,223,M,24,6,5,77,-146,Severe
13,3,159,M,87,11,11,143,-16,Severe
17,2,206,M,63,9,6,114,-92,Severe
17,0,204,M,52,8,5,101,-103,Severe
13,5,161,F,102,13,6,162,1,Good
11,10,142,F,45,7,10,94,-48,Severe
6,6,78,F,9,5,7,67,-11,Severe
16,0,192,F,16,5,11,71,-121,Severe
5,2,62,F,79,11,1,133,71,Well
7,11,95,F,54,8,7,103,8,Well
13,7,163,F,78,11,0,132,-31,Severe
9,7,115,M,6,5,5,65,-50,Severe
9,1,109,M,98,13,0,156,47,Well
12,6,150,M,24,6,5,77,-73,Severe
9,4,112,F,92,12,5,149,37,Well
12,2,146,F,35,7,1,85,-61,Severe
13,8,164,M,103,13,6,162,-2,Mild
10,8,128,M,47,8,0,96,-32,Severe
5,3,63,M,96,12,10,154,91,Well
8,8,104,M,92,12,5,149,45,Well
14,0,168,M,39,7,5,89,-79,Severe
10,8,128,M,86,11,10,142,14,Well
13,4,160,M,45,7,10,94,-66,Severe
18,2,218,F,84,11,7,139,-79,Severe
17,11,215,M,89,12,1,145,-70,Severe
17,7,211,M,32,6,10,82,-129,Severe
7,5,89,F,23,6,4,76,-13,Severe
13,5,161,F,31,6,9,81,-80,Severe
7,3,87,F,97,12,11,155,68,Well
11,8,140,M,26,6,6,78,-62,Severe
17,6,210,M,48,8,1,97,-113,Severe
5,5,65,M,13,5,9,69,4,Good
11,7,139,F,7,5,6,66,-73,Severe
18,3,219,F,70,10,2,122,-97,Severe
11,7,139,M,38,7,4,88,-51,Severe
6,8,80,M,102,13,6,162,82,Well
15,2,182,M,13,5,9,69,-113,Severe
8,4,100,M,90,12,3,147,47,Well
13,6,162,F,58,9,0,108,-54,Severe
13,3,159,M,26,6,6,78,-81,Severe
10,6,126,F,68,10,0,120,-6,Severe
10,8,128,M,59,9,1,109,-19,Severe
18,11,227,M,97,12,11,155,-72,Severe
14,10,178,F,48,8,1,97,-81,Severe
9,5,113,F,55,8,8,104,-9,Severe
18,9,225,M,78,11,0,132,-93,Severe
16,3,195,M,39,7,5,89,-106,Severe
6,9,81,F,71,10,3,123,42,Well
16,11,203,F,70,10,2,122,-81,Severe
13,4,160,M,93,12,6,150,-10,Severe
6,3,75,M,5,5,5,65,-10,Severe
8,4,100,F,92,12,5,149,49,Well
17,11,215,F,49,8,2,98,-117,Severe
17,3,207,F,87,11,11,143,-64,Severe
13,4,160,F,5,5,5,65,-95,Severe
5,5,65,M,71,10,3,123,58,Well
14,9,177,F,54,8,7,103,-74,Severe
7,4,88,M,85,11,9,141,53,Well
9,8,116,M,73,10,6,126,10,Well
8,9,105,M,2,5,3,63,-42,Severe
13,11,167,F,108,14,0,168,1,Good
7,11,95,F,5,5,5,65,-30,Severe
16,7,199,M,30,6,9,81,-118,Severe
5,0,60,M,77,10,11,131,71,Well
14,7,175,M,93,12,6,150,-25,Severe
7,3,87,F,74,10,7,127,40,Well
16,9,201,F,59,9,1,109,-92,Severe
8,3,99,M,27,6,7,79,-20,Severe
11,10,142,F,42,7,7,91,-51,Severe
16,8,200,M,74,10,7,127,-73,Severe
7,4,88,F,27,6,7,79,-9,Severe
17,9,213,M,34,7,0,84,-129,Severe
8,5,101,M,106,13,10,166,65,Well
5,3,63,M,59,9,1,109,46,Well
7,7,91,M,18,6,1,73,-18,Severe
9,4,112,M,97,12,11,155,43,Well
14,11,179,F,51,8,4,100,-79,Severe
18,5,221,F,74,10,7,127,-94,Severe
14,8,176,M,25,6,5,77,-99,Severe
17,0,204,F,36,7,2,86,-118,Severe
17,11,215,M,37,7,3,87,-128,Severe
15,6,186,F,74,10,7,127,-59,Severe
8,0,96,M,26,6,6,78,-18,Severe
12,10,154,M,80,11,3,135,-19,Severe
17,3,207,F,12,5,9,69,-138,Severe
7,0,84,M,30,6,9,81,-3,Mild
8,9,105,F,64,9,7,115,10,Well
10,7,127,F,17,6,0,72,-55,Severe
16,10,202,M,2,5,3,63,-139,Severe
13,1,157,M,69,10,1,121,-36,Severe
8,6,102,M,98,13,0,156,54,Well
5,3,63,M,8,5,6,66,3,Good
15,2,182,F,82,11,5,137,-45,Severe
5,4,64,F,38,7,4,88,24,Well
17,6,210,F,67,9,10,118,-92,Severe
14,8,176,F,92,12,5,149,-27,Severe
16,7,199,F,68,10,0,120,-79,Severe
16,11,203,F,27,6,7,79,-124,Severe
12,9,153,F,27,6,7,79,-74,Severe
16,5,197,M,2,5,3,63,-134,Severe
10,11,131,M,49,8,2,98,-33,Severe
7,11,95,M,24,6,5,77,-18,Severe
18,0,216,F,48,8,1,97,-119,Severe
7,3,87,M,54,8,7,103,16,Well
9,8,116,M,45,7,10,94,-22,Severe
12,2,146,F,42,7,7,91,-55,Severe
12,9,153,F,31,6,9,81,-72,Severe
5,10,70,F,52,8,5,101,31,Well
6,7,79,F,25,6,5,77,-2,Mild
16,6,198,M,101,13,4,160,-38,Severe
14,4,172,M,58,9,0,108,-64,Severe
11,1,133,F,22,6,3,75,-58,Severe
5,2,62,M,30,6,9,81,19,Well
11,10,142,F,95,12,9,153,11,Well
17,11,215,F,86,11,10,142,-73,Severe
7,6,90,M,25,6,5,77,-13,Severe
10,9,129,M,13,5,9,69,-60,Severe
14,5,173,F,101,13,4,160,-13,Severe
6,9,81,F,91,12,4,148,67,Well
6,4,76,M,84,11,7,139,63,Well
15,8,188,F,88,12,0,144,-44,Severe
14,10,178,F,6,5,5,65,-113,Severe
17,5,209,F,74,10,7,127,-82,Severe
8,9,105,M,6,5,5,65,-40,Severe
5,4,64,M,18,6,1,73,9,Well
12,2,146,F,28,6,8,80,-66,Severe
5,3,63,F,110,14,3,171,108,Well
5,3,63,M,36,7,2,86,23,Well
18,1,217,M,18,6,1,73,-144,Severe
10,0,120,M,30,6,9,81,-39,Severe
10,8,128,F,75,10,9,129,1,Good
8,1,97,F,106,13,10,166,69,Well
17,7,211,M,6,5,5,65,-146,Severe
9,10,118,F,74,10,7,127,9,Well
6,7,79,M,58,9,0,108,29,Well
8,4,100,M,103,13,6,162,62,Well
8,7,103,F,42,7,7,91,-12,Severe
12,11,155,M,77,10,11,131,-24,Severe
9,4,112,M,61,9,3,111,-1,Mild
5,1,61,M,98,13,0,156,95,Well
15,9,189,F,4,5,4,64,-125,Severe
17,6,210,F,18,6,1,73,-137,Severe
9,5,113,M,31,6,9,81,-32,Severe
15,1,181,M,44,7,9,93,-88,Severe
12,0,144,M,35,7,1,85,-59,Severe
15,4,184,M,23,6,4,76,-108,Severe
16,5,197,M,21,6,2,74,-123,Severe
9,1,109,M,34,7,0,84,-25,Severe
9,10,118,F,73,10,6,126,8,Well
15,4,184,M,17,6,0,72,-112,Severe
16,5,197,M,60,9,2,110,-87,Severe
14,9,177,M,12,5,9,69,-108,Severe
13,11,167,F,51,8,4,100,-67,Severe
16,9,201,M,22,6,3,75,-126,Severe
9,4,112,M,17,6,0,72,-40,Severe
14,4,172,M,82,11,5,137,-35,Severe
7,0,84,F,51,8,4,100,16,Well
10,6,126,F,92,12,5,149,23,Well
12,10,154,F,103,13,6,162,8,Well
10,5,125,F,62,9,4,112,-13,Severe
16,4,196,M,89,12,1,145,-51,Severe
12,3,147,F,2,5,3,63,-84,Severe
14,8,176,F,40,7,5,89,-87,Severe
14,10,178,F,74,10,7,127,-51,Severe
15,9,189,F,78,11,0,132,-57,Severe
11,10,142,F,15,5,11,71,-71,Severe
18,10,226,F,37,7,3,87,-139,Severe
11,6,138,M,89,12,1,145,7,Well
15,3,183,M,107,13,11,167,-16,Severe
5,7,67,M,21,6,2,74,7,Well
5,1,61,M,90,12,3,147,86,Well
18,2,218,M,23,6,4,76,-142,Severe
13,2,158,F,108,14,0,168,10,Well
15,9,189,F,53,8,6,102,-87,Severe
8,10,106,F,50,8,3,99,-7,Severe
10,5,125,M,70,10,2,122,-3,Mild
7,8,92,M,109,14,1,169,77,Well
10,10,130,F,24,6,5,77,-53,Severe
5,3,63,M,73,10,6,126,63,Well
16,6,198,M,75,10,9,129,-69,Severe
9,3,111,F,51,8,4,100,-11,Severe
13,9,165,M,83,11,6,138,-27,Severe
12,2,146,F,5,5,5,65,-81,Severe
10,4,124,M,64,9,7,115,-9,Severe
13,10,166,M,54,8,7,103,-63,Severe
15,1,181,F,32,6,10,82,-99,Severe
16,6,198,M,98,13,0,156,-42,Severe
11,0,132,F,6,5,5,65,-67,Severe
18,2,218,F,63,9,6,114,-104,Severe
13,3,159,M,62,9,4,112,-47,Severe
16,0,192,F,92,12,5,149,-43,Severe
6,6,78,M,72,10,4,124,46,Well
9,3,111,F,12,5,9,69,-42,Severe
8,5,101,F,11,5,8,68,-33,Severe
7,5,89,F,6,5,5,65,-24,Severe
6,10,82,M,98,13,0,156,74,Well
16,10,202,F,53,8,6,102,-100,Severe
17,11,215,M,38,7,4,88,-127,Severe
14,11,179,M,45,7,10,94,-85,Severe
13,5,161,M,4,5,4,64,-97,Severe
18,7,223,M,88,12,0,144,-79,Severe
12,10,154,M,68,10,0,120,-34,Severe
13,5,161,M,87,11,11,143,-18,Severe
16,11,203,F,106,13,10,166,-37,Severe
15,1,181,M,40,7,5,89,-92,Severe
13,0,156,M,18,6,1,73,-83,Severe
9,11,119,M,74,10,7,127,8,Well
17,1,205,F,9,5,7,67,-138,Severe
9,1,109,F,87,11,11,143,34,Well
14,1,169,F,19,6,1,73,-96,Severe
8,2,98,F,91,12,4,148,50,Well
6,4,76,F,34,7,0,84,8,Well
16,4,196,F,9,5,7,67,-129,Severe
11,4,136,F,61,9,3,111,-25,Severe
15,9,189,M,24,6,5,77,-112,Severe
8,3,99,M,56,8,9,105,6,Well
5,5,65,M,45,7,10,94,29,Well
11,8,140,F,72,10,4,124,-16,Severe
17,8,212,F,37,7,3,87,-125,Severe
6,9,81,F,10,5,7,67,-14,Severe
14,4,172,M,109,14,1,169,-3,Mild
17,1,205,F,6,5,5,65,-140,Severe
15,0,180,M,68,10,0,120,-60,Severe
15,3,183,F,25,6,5,77,-106,Severe
10,1,121,F,93,12,6,150,29,Well
13,8,164,F,55,8,8,104,-60,Severe
14,8,176,M,56,8,9,105,-71,Severe
10,8,128,F,88,12,0,144,16,Well
10,10,130,M,103,13,6,162,32,Well
10,7,127,M,71,10,3,123,-4,Mild
12,5,149,F,98,13,0,156,7,Well
10,5,125,F,106,13,10,166,41,Well
7,0,84,M,33,6,11,83,-1,Mild
10,5,125,M,88,12,0,144,19,Well
11,0,132,M,105,13,9,165,33,Well
13,2,158,F,110,14,3,171,13,Well
15,2,182,M,30,6,9,81,-101,Severe
9,9,117,M,73,10,6,126,9,Well
9,3,111,F,3,5,3,63,-48,Severe
9,11,119,F,90,12,3,147,28,Well
17,4,208,M,89,12,1,145,-63,Severe
5,3,63,M,30,6,9,81,18,Well
8,9,105,M,64,9,7,115,10,Well
11,1,133,M,105,13,9,165,32,Well
15,6,186,M,90,12,3,147,-39,Severe
8,3,99,M,15,5,11,71,-28,Severe
18,0,216,M,83,11,6,138,-78,Severe
14,10,178,F,57,8,10,106,-72,Severe
17,3,207,M,77,10,11,131,-76,Severe
10,3,123,F,22,6,3,75,-48,Severe
16,2,194,M,100,13,3,159,-35,Severe
12,8,152,F,28,6,8,80,-72,Severe
18,3,219,F,35,7,1,85,-134,Severe
12,8,152,M,29,6,8,80,-72,Severe
17,1,205,F,20,6,2,74,-131,Severe
9,8,116,M,108,14,0,168,52,Well
11,10,142,F,83,11,6,138,-4,Mild
8,0,96,M,24,6,5,77,-19,Severe
15,5,185,F,91,12,4,148,-37,Severe
5,4,64,F,66,9,9,117,53,Well
12,4,148,M,48,8,1,97,-51,Severe
17,3,207,M,25,6,5,77,-130,Severe
15,3,183,M,106,13,10,166,-17,Severe
16,3,195,F,81,11,4,136,-59,Severe
7,0,84,M,43,7,8,92,8,Well
6,1,73,M,24,6,5,77,4,Good
18,1,217,M,22,6,3,75,-142,Severe
18,6,222,F,41,7,6,90,-132,Severe
11,7,139,M,84,11,7,139,0,Neutral
10,2,122,F,30,6,9,81,-41,Severe
12,3,147,M,91,12,4,148,1,Good
12,3,147,M,50,8,3,99,-48,Severe
17,1,205,M,25,6,5,77,-128,Severe
11,3,135,F,69,10,1,121,-14,Severe
15,1,181,M,81,11,4,136,-45,Severe
18,9,225,F,107,13,11,167,-58,Severe
17,6,210,F,51,8,4,100,-110,Severe
14,3,171,M,25,6,5,77,-94,Severe
6,1,73,F,79,11,1,133,60,Well
15,2,182,M,64,9,7,115,-67,Severe
7,3,87,M,28,6,8,80,-7,Severe
10,8,128,M,103,13,6,162,34,Well
12,3,147,M,34,7,0,84,-63,Severe
11,10,142,F,53,8,6,102,-40,Severe
8,10,106,M,87,11,11,143,37,Well
8,6,102,M,63,9,6,114,12,Well
9,7,115,M,69,10,1,121,6,Well
8,3,99,F,19,6,1,73,-26,Severe
7,8,92,M,98,13,0,156,64,Well
5,1,61,F,78,11,0,132,71,Well
11,6,138,M,74,10,7,127,-11,Severe
6,2,74,M,96,12,10,154,80,Well
8,8,104,M,80,11,3,135,31,Well
11,11,143,M,32,6,10,82,-61,Severe
15,11,191,M,90,12,3,147,-44,Severe
12,2,146,M,79,11,1,133,-13,Severe
13,8,164,F,45,7,10,94,-70,Severe
10,3,123,F,70,10,2,122,-1,Mild
17,5,209,F,33,6,11,83,-126,Severe
10,5,125,M,15,5,11,71,-54,Severe
11,0,132,M,6,5,5,65,-67,Severe
17,8,212,M,22,6,3,75,-137,Severe
8,0,96,M,21,6,2,74,-22,Severe
10,5,125,F,52,8,5,101,-24,Severe
17,1,205,M,85,11,9,141,-64,Severe
6,8,80,F,94,12,7,151,71,Well
15,3,183,M,33,6,11,83,-100,Severe
5,5,65,F,28,6,8,80,15,Well
15,10,190,F,49,8,2,98,-92,Severe
15,11,191,F,40,7,5,89,-102,Severe
10,6,126,F,72,10,4,124,-2,Mild
5,7,67,M,19,6,1,73,6,Well
11,8,140,M,28,6,8,80,-60,Severe
16,11,203,M,75,10,9,129,-74,Severe
10,7,127,M,32,6,10,82,-45,Severe
9,0,108,F,26,6,6,78,-30,Severe
13,10,166,M,69,10,1,121,-45,Severe
10,11,131,M,40,7,5,89,-42,Severe
7,6,90,F,51,8,4,100,10,Well
18,3,219,M,16,5,11,71,-148,Severe
15,10,190,F,109,14,1,169,-21,Severe
5,7,67,F,82,11,5,137,70,Well
8,7,103,M,50,8,3,99,-4,Mild
12,10,154,F,43,7,8,92,-62,Severe
12,5,149,F,39,7,5,89,-60,Severe
16,1,193,M,56,8,9,105,-88,Severe
11,7,139,M,18,6,1,73,-66,Severe
15,3,183,M,32,6,10,82,-101,Severe
13,3,159,M,103,13,6,162,3,Good
14,4,172,F,4,5,4,64,-108,Severe
9,7,115,F,78,11,0,132,17,Well
13,1,157,M,38,7,4,88,-69,Severe
9,11,119,M,26,6,6,78,-41,Severe
17,5,209,F,3,5,3,63,-146,Severe
10,4,124,F,109,14,1,169,45,Well
5,0,60,M,52,8,5,101,41,Well
16,3,195,M,54,8,7,103,-92,Severe
17,8,212,M,21,6,2,74,-138,Severe
10,8,128,M,12,5,9,69,-59,Severe
17,9,213,F,86,11,10,142,-71,Severe
14,10,178,F,7,5,6,66,-112,Severe
17,6,210,M,61,9,3,111,-99,Severe
15,6,186,F,71,10,3,123,-63,Severe
16,3,195,F,73,10,6,126,-69,Severe
13,3,159,F,42,7,7,91,-68,Severe
15,3,183,M,66,9,9,117,-66,Severe
17,2,206,M,20,6,2,74,-132,Severe
7,10,94,M,22,6,3,75,-19,Severe
13,3,159,M,9,5,7,67,-92,Severe
12,0,144,F,91,12,4,148,4,Good
8,4,100,M,79,11,1,133,33,Well
16,8,200,F,49,8,2,98,-102,Severe
12,7,151,M,62,9,4,112,-39,Severe
18,0,216,F,13,5,9,69,-147,Severe
15,4,184,F,58,9,0,108,-76,Severe
12,3,147,M,57,8,10,106,-41,Severe
9,7,115,F,38,7,4,88,-27,Severe
8,7,103,M,84,11,7,139,36,Well
18,1,217,M,81,11,4,136,-81,Severe
16,3,195,F,58,9,0,108,-87,Severe
7,8,92,F,3,5,3,63,-29,Severe
13,11,167,M,55,8,8,104,-63,Severe
18,4,220,M,75,10,9,129,-91,Severe
10,7,127,F,68,10,0,120,-7,Severe
5,9,69,F,77,10,11,131,62,Well
12,3,147,F,65,9,8,116,-31,Severe
8,7,103,M,55,8,8,104,1,Good
7,6,90,F,91,12,4,148,58,Well
17,0,204,M,6,5,5,65,-139,Severe
6,8,80,M,10,5,7,67,-13,Severe
6,5,77,M,71,10,3,123,46,Well
10,9,129,M,7,5,6,66,-63,Severe
11,6,138,M,44,7,9,93,-45,Severe
15,9,189,M,39,7,5,89,-100,Severe
11,3,135,F,63,9,6,114,-21,Severe
5,4,64,M,36,7,2,86,22,Well
17,4,208,F,6,5,5,65,-143,Severe
18,7,223,F,104,13,7,163,-60,Severe
5,3,63,F,103,13,6,162,99,Well
18,5,221,F,100,13,3,159,-62,Severe
15,3,183,M,3,5,3,63,-120,Severe
15,7,187,F,62,9,4,112,-75,Severe
16,10,202,M,64,9,7,115,-87,Severe
5,9,69,F,43,7,8,92,23,Well
14,3,171,M,82,11,5,137,-34,Severe
7,1,85,F,32,6,10,82,-3,Mild
9,1,109,M,50,8,3,99,-10,Severe
15,6,186,M,31,6,9,81,-105,Severe
16,1,193,F,38,7,4,88,-105,Severe
13,1,157,F,4,5,4,64,-93,Severe
9,8,116,M,105,13,9,165,49,Well
18,1,217,F,91,12,4,148,-69,Severe
5,7,67,M,11,5,8,68,1,Good
8,4,100,F,3,5,3,63,-37,Severe
15,5,185,M,84,11,7,139,-46,Severe
8,3,99,F,73,10,6,126,27,Well
6,0,72,F,68,10,0,120,48,Well
10,11,131,M,80,11,3,135,4,Good
16,11,203,F,84,11,7,139,-64,Severe
9,2,110,M,71,10,3,123,13,Well
10,0,120,M,110,14,3,171,51,Well
12,6,150,M,97,12,11,155,5,Good
18,5,221,M,98,13,0,156,-65,Severe
12,8,152,M,81,11,4,136,-16,Severe
6,3,75,M,62,9,4,112,37,Well
8,10,106,M,47,8,0,96,-10,Severe
8,7,103,M,86,11,10,142,39,Well
13,7,163,M,85,11,9,141,-22,Severe
10,3,123,F,29,6,8,80,-43,Severe
5,4,64,F,82,11,5,137,73,Well
6,9,81,M,54,8,7,103,22,Well
9,10,118,M,62,9,4,112,-6,Severe
14,3,171,F,75,10,9,129,-42,Severe
7,5,89,F,99,13,1,157,68,Well
13,2,158,M,8,5,6,66,-92,Severe
5,3,63,F,56,8,9,105,42,Well
7,10,94,M,101,13,4,160,66,Well
11,7,139,M,73,10,6,126,-13,Severe
7,7,91,F,78,11,0,132,41,Well
7,6,90,F,86,11,10,142,52,Well
16,3,195,F,88,12,0,144,-51,Severe
9,10,118,F,4,5,4,64,-54,Severe
11,7,139,M,34,7,0,84,-55,Severe
7,8,92,F,99,13,1,157,65,Well
6,4,76,M,13,5,9,69,-7,Severe
9,11,119,M,63,9,6,114,-5,Mild
16,11,203,F,18,6,1,73,-130,Severe
17,11,215,M,47,8,0,96,-119,Severe
11,6,138,M,40,7,5,89,-49,Severe
13,5,161,F,14,5,10,70,-91,Severe
6,11,83,F,104,13,7,163,80,Well
16,3,195,M,16,5,11,71,-124,Severe
12,2,146,M,12,5,9,69,-77,Severe
10,6,126,F,104,13,7,163,37,Well
8,8,104,F,76,10,10,130,26,Well
16,2,194,F,60,9,2,110,-84,Severe
14,3,171,M,37,7,3,87,-84,Severe
8,11,107,F,12,5,9,69,-38,Severe
16,7,199,F,51,8,4,100,-99,Severe
13,1,157,F,96,12,10,154,-3,Mild
8,11,107,F,7,5,6,66,-41,Severe
18,4,220,F,4,5,4,64,-156,Severe
10,1,121,F,32,6,10,82,-39,Severe
7,5,89,F,16,5,11,71,-18,Severe
10,10,130,F,51,8,4,100,-30,Severe
14,1,169,M,59,9,1,109,-60,Severe
13,5,161,M,46,7,11,95,-66,Severe
7,4,88,F,104,13,7,163,75,Well
14,2,170,M,42,7,7,91,-79,Severe
7,3,87,F,37,7,3,87,0,Neutral
18,7,223,F,54,8,7,103,-120,Severe
13,6,162,M,102,13,6,162,0,Neutral
18,8,224,F,31,6,9,81,-143,Severe
11,9,141,F,64,9,7,115,-26,Severe
17,1,205,M,92,12,5,149,-56,Severe
11,0,132,M,19,6,1,73,-59,Severe
11,3,135,F,60,9,2,110,-25,Severe
18,9,225,M,6,5,5,65,-160,Severe
12,11,155,F,34,7,0,84,-71,Severe
13,3,159,F,106,13,10,166,7,Well
5,7,67,M,107,13,11,167,100,Well
8,9,105,M,62,9,4,112,7,Well
13,1,157,F,39,7,5,89,-68,Severe
16,3,195,F,75,10,9,129,-66,Severe
8,0,96,F,78,11,0,132,36,Well
13,7,163,M,82,11,5,137,-26,Severe
8,2,98,M,8,5,6,66,-32,Severe
15,3,183,M,92,12,5,149,-34,Severe
8,4,100,F,39,7,5,89,-11,Severe
10,3,123,F,81,11,4,136,13,Well
11,6,138,F,7,5,6,66,-72,Severe
8,3,99,F,108,14,0,168,69,Well
11,2,134,F,83,11,6,138,4,Good
17,4,208,F,95,12,9,153,-55,Severe
9,4,112,M,74,10,7,127,15,Well
8,8,104,M,55,8,8,104,0,Neutral
9,4,112,F,87,11,11,143,31,Well
7,0,84,F,24,6,5,77,-7,Severe
5,9,69,M,69,10,1,121,52,Well
6,1,73,F,45,7,10,94,21,Well
15,8,188,M,21,6,2,74,-114,Severe
8,1,97,F,29,6,8,80,-17,Severe
5,11,71,F,73,10,6,126,55,Well
18,11,227,F,32,6,10,82,-145,Severe
11,5,137,M,39,7,5,89,-48,Severe
15,5,185,M,29,6,8,80,-105,Severe
6,3,75,M,106,13,10,166,91,Well
15,3,183,M,53,8,6,102,-81,Severe
15,1,181,F,31,6,9,81,-100,Severe
14,0,168,M,27,6,7,79,-89,Severe
7,3,87,M,41,7,6,90,3,Good
8,3,99,M,3,5,3,63,-36,Severe
9,3,111,M,5,5,5,65,-46,Severe
12,11,155,F,85,11,9,141,-14,Severe
17,7,211,M,74,10,7,127,-84,Severe
16,5,197,M,82,11,5,137,-60,Severe
7,3,87,M,16,5,11,71,-16,Severe
17,10,214,F,40,7,5,89,-125,Severe
6,3,75,F,68,10,0,120,45,Well
15,11,191,F,103,13,6,162,-29,Severe
10,10,130,F,106,13,10,166,36,Well
16,10,202,F,24,6,5,77,-125,Severe
5,4,64,M,75,10,9,129,65,Well
18,4,220,M,52,8,5,101,-119,Severe
18,3,219,M,52,8,5,101,-118,Severe
8,3,99,M,17,6,0,72,-27,Severe
13,11,167,F,67,9,10,118,-49,Severe
9,7,115,F,84,11,7,139,24,Well
6,7,79,M,29,6,8,80,1,Good
16,7,199,F,80,11,3,135,-64,Severe
12,0,144,F,67,9,10,118,-26,Severe
13,3,159,F,9,5,7,67,-92,Severe
10,10,130,M,51,8,4,100,-30,Severe
17,7,211,M,44,7,9,93,-118,Severe
17,11,215,F,43,7,8,92,-123,Severe
13,2,158,F,100,13,3,159,1,Good
11,10,142,F,62,9,4,112,-30,Severe
17,2,206,F,31,6,9,81,-125,Severe
12,1,145,F,5,5,5,65,-80,Severe
5,2,62,F,5,5,5,65,3,Good
12,7,151,F,40,7,5,89,-62,Severe
15,8,188,F,86,11,10,142,-46,Severe
16,8,200,F,36,7,2,86,-114,Severe
15,0,180,M,47,8,0,96,-84,Severe
7,10,94,M,82,11,5,137,43,Well
15,8,188,M,90,12,3,147,-41,Severe
5,8,68,F,34,7,0,84,16,Well
10,6,126,M,25,6,5,77,-49,Severe
7,1,85,M,78,11,0,132,47,Well
10,10,130,F,80,11,3,135,5,Good
8,7,103,F,71,10,3,123,20,Well
12,11,155,M,19,6,1,73,-82,Severe
9,0,108,M,21,6,2,74,-34,Severe
14,10,178,M,22,6,3,75,-103,Severe
13,11,167,M,71,10,3,123,-44,Severe
16,5,197,F,62,9,4,112,-85,Severe
8,2,98,F,95,12,9,153,55,Well
16,6,198,F,79,11,1,133,-65,Severe
7,4,88,M,58,9,0,108,20,Well
15,1,181,F,80,11,3,135,-46,Severe
7,3,87,M,67,9,10,118,31,Well
8,6,102,M,35,7,1,85,-17,Severe
6,6,78,F,29,6,8,80,2,Good
15,0,180,M,75,10,9,129,-51,Severe
9,8,116,M,44,7,9,93,-23,Severe
15,3,183,F,102,13,6,162,-21,Severe
8,2,98,F,22,6,3,75,-23,Severe
14,5,173,M,76,10,10,130,-43,Severe
14,9,177,M,99,13,1,157,-20,Severe
12,6,150,M,55,8,8,104,-46,Severe
9,4,112,M,78,11,0,132,20,Well
17,9,213,F,84,11,7,139,-74,Severe
8,1,97,M,3,5,3,63,-34,Severe
12,6,150,M,48,8,1,97,-53,Severe
13,10,166,F,58,9,0,108,-58,Severe
18,11,227,M,107,13,11,167,-60,Severe
7,3,87,M,70,10,2,122,35,Well
8,6,102,F,90,12,3,147,45,Well
7,6,90,F,104,13,7,163,73,Well
15,0,180,F,65,9,8,116,-64,Severe
11,2,134,M,24,6,5,77,-57,Severe
16,7,199,F,65,9,8,116,-83,Severe
5,8,68,F,14,5,10,70,2,Good
7,6,90,M,61,9,3,111,21,Well
15,4,184,F,53,8,6,102,-82,Severe
8,3,99,M,19,6,1,73,-26,Severe
6,5,77,F,104,13,7,163,86,Well
5,6,66,F,42,7,7,91,25,Well
15,5,185,M,11,5,8,68,-117,Severe
10,4,124,M,103,13,6,162,38,Well
15,3,183,F,52,8,5,101,-82,Severe
8,11,107,F,74,10,7,127,20,Well
18,9,225,F,81,11,4,136,-89,Severe
5,3,63,M,19,6,1,73,10,Well
8,0,96,F,16,5,11,71,-25,Severe
10,10,130,F,43,7,8,92,-38,Severe
5,5,65,F,74,10,7,127,62,Well
18,1,217,F,79,11,1,133,-84,Severe
7,10,94,M,92,12,5,149,55,Well
13,4,160,F,19,6,1,73,-87,Severe
16,3,195,F,42,7,7,91,-104,Severe
15,11,191,F,20,6,2,74,-117,Severe
12,0,144,M,50,8,3,99,-45,Severe
11,9,141,M,50,8,3,99,-42,Severe
17,0,204,F,107,13,11,167,-37,Severe
8,1,97,M,17,6,0,72,-25,Severe
8,3,99,F,9,5,7,67,-32,Severe
14,1,169,M,56,8,9,105,-64,Severe
16,6,198,F,59,9,1,109,-89,Severe
15,9,189,M,51,8,4,100,-89,Severe
12,11,155,M,36,7,2,86,-69,Severe
17,10,214,F,99,13,1,157,-57,Severe
7,6,90,F,43,7,8,92,2,Good
14,6,174,M,105,13,9,165,-9,Severe
15,3,183,M,22,6,3,75,-108,Severe
18,3,219,F,105,13,9,165,-54,Severe
13,9,165,M,105,13,9,165,0,Neutral
6,1,73,F,75,10,9,129,56,Well
10,5,125,F,92,12,5,149,24,Well
8,3,99,M,91,12,4,148,49,Well
12,1,145,F,67,9,10,118,-27,Severe
5,10,70,M,110,14,3,171,101,Well
15,11,191,M,62,9,4,112,-79,Severe
10,0,120,F,55,8,8,104,-16,Severe
6,6,78,M,4,5,4,64,-14,Severe
16,1,193,M,85,11,9,141,-52,Severe
8,10,106,M,92,12,5,149,43,Well
5,11,71,M,36,7,2,86,15,Well
16,5,197,M,109,14,1,169,-28,Severe
15,8,188,M,43,7,8,92,-96,Severe
15,4,184,M,5,5,5,65,-119,Severe
12,1,145,M,18,6,1,73,-72,Severe
8,8,104,M,101,13,4,160,56,Well
12,2,146,F,11,5,8,68,-78,Severe
5,11,71,M,43,7,8,92,21,Well
16,3,195,F,75,10,9,129,-66,Severe
12,10,154,M,88,12,0,144,-10,Severe
13,11,167,F,57,8,10,106,-61,Severe
11,4,136,F,88,12,0,144,8,Well
7,4,88,M,95,12,9,153,65,Well
18,3,219,F,77,10,11,131,-88,Severe
18,1,217,M,12,5,9,69,-148,Severe
7,11,95,M,9,5,7,67,-28,Severe
14,2,170,M,87,11,11,143,-27,Severe
6,4,76,M,52,8,5,101,25,Well
17,3,207,M,33,6,11,83,-124,Severe
13,7,163,M,74,10,7,127,-36,Severe
10,3,123,M,64,9,7,115,-8,Severe
16,2,194,F,43,7,8,92,-102,Severe
11,5,137,M,34,7,0,84,-53,Severe
7,0,84,M,75,10,9,129,45,Well
16,9,201,M,59,9,1,109,-92,Severe
13,1,157,F,40,7,5,89,-68,Severe
12,4,148,F,66,9,9,117,-31,Severe
10,8,128,M,90,12,3,147,19,Well
9,7,115,M,70,10,2,122,7,Well
18,3,219,F,62,9,4,112,-107,Severe
15,7,187,F,27,6,7,79,-108,Severe
6,10,82,M,66,9,9,117,35,Well
10,8,128,F,80,11,3,135,7,Well
15,9,189,M,86,11,10,142,-47,Severe
15,6,186,F,17,6,0,72,-114,Severe
12,8,152,M,105,13,9,165,13,Well
5,0,60,M,16,5,11,71,11,Well
16,11,203,M,56,8,9,105,-98,Severe
15,6,186,F,86,11,10,142,-44,Severe
18,5,221,F,48,8,1,97,-124,Severe
17,2,206,M,33,6,11,83,-123,Severe
14,8,176,F,45,7,10,94,-82,Severe
17,7,211,M,93,12,6,150,-61,Severe
17,11,215,F,7,5,6,66,-149,Severe
6,5,77,M,8,5,6,66,-11,Severe
16,3,195,M,78,11,0,132,-63,Severe
6,11,83,M,72,10,4,124,41,Well
17,8,212,M,69,10,1,121,-91,Severe
16,3,195,F,98,13,0,156,-39,Severe
18,5,221,F,4,5,4,64,-157,Severe
15,8,188,F,61,9,3,111,-77,Severe
13,8,164,M,27,6,7,79,-85,Severe
18,11,227,M,76,10,10,130,-97,Severe
9,9,117,M,9,5,7,67,-50,Severe
9,7,115,M,16,5,11,71,-44,Severe
10,10,130,M,108,14,0,168,38,Well
18,10,226,F,22,6,3,75,-151,Severe
16,10,202,M,48,8,1,97,-105,Severe
18,5,221,F,5,5,5,65,-156,Severe
13,7,163,F,47,8,0,96,-67,Severe
7,7,91,M,77,10,11,131,40,Well
16,4,196,M,29,6,8,80,-116,Severe
11,9,141,F,24,6,5,77,-64,Severe
14,1,169,F,27,6,7,79,-90,Severe
18,8,224,M,25,6,5,77,-147,Severe
18,10,226,F,86,11,10,142,-84,Severe
6,11,83,F,80,11,3,135,52,Well
5,6,66,F,100,13,3,159,93,Well
7,10,94,M,57,8,10,106,12,Well
5,6,66,F,110,14,3,171,105,Well
6,4,76,F,44,7,9,93,17,Well
17,8,212,M,90,12,3,147,-65,Severe
11,11,143,M,69,10,1,121,-22,Severe
8,7,103,M,52,8,5,101,-2,Mild
11,3,135,F,102,13,6,162,27,Well
7,3,87,F,13,5,9,69,-18,Severe
5,6,66,M,67,9,10,118,52,Well
16,7,199,F,81,11,4,136,-63,Severe
11,3,135,M,69,10,1,121,-14,Severe
11,9,141,F,19,6,1,73,-68,Severe
13,10,166,F,52,8,5,101,-65,Severe
11,8,140,F,99,13,1,157,17,Well
6,4,76,F,14,5,10,70,-6,Severe
5,6,66,M,103,13,6,162,96,Well
16,0,192,M,92,12,5,149,-43,Severe
18,3,219,F,21,6,2,74,-145,Severe
13,5,161,F,55,8,8,104,-57,Severe
6,11,83,M,56,8,9,105,22,Well
6,2,74,M,3,5,3,63,-11,Severe
13,10,166,M,44,7,9,93,-73,Severe
6,7,79,M,83,11,6,138,59,Well
15,2,182,F,83,11,6,138,-44,Severe
9,2,110,M,100,13,3,159,49,Well
18,8,224,F,79,11,1,133,-91,Severe
16,7,199,F,104,13,7,163,-36,Severe
5,6,66,F,55,8,8,104,38,Well
10,2,122,M,37,7,3,87,-35,Severe
8,8,104,F,72,10,4,124,20,Well
12,4,148,M,52,8,5,101,-47,Severe
16,3,195,M,87,11,11,143,-52,Severe
12,0,144,M,79,11,1,133,-11,Severe
10,3,123,M,81,11,4,136,13,Well
17,2,206,M,81,11,4,136,-70,Severe
13,10,166,M,4,5,4,64,-102,Severe
12,1,145,F,25,6,5,77,-68,Severe
18,0,216,M,92,12,5,149,-67,Severe
10,5,125,F,35,7,1,85,-40,Severe
9,10,118,M,61,9,3,111,-7,Severe
15,3,183,F,6,5,5,65,-118,Severe
14,8,176,F,65,9,8,116,-60,Severe
14,3,171,F,30,6,9,81,-90,Severe
5,11,71,M,77,10,11,131,60,Well
16,4,196,F,93,12,6,150,-46,Severe
13,0,156,F,106,13,10,166,10,Well
15,7,187,M,93,12,6,150,-37,Severe
6,9,81,M,2,5,3,63,-18,Severe
8,2,98,F,25,6,5,77,-21,Severe
5,0,60,F,96,12,10,154,94,Well
15,1,181,F,4,5,4,64,-117,Severe
14,8,176,M,48,8,1,97,-79,Severe
17,9,213,F,53,8,6,102,-111,Severe
12,6,150,M,34,7,0,84,-66,Severe
6,11,83,M,25,6,5,77,-6,Severe
16,9,201,F,51,8,4,100,-101,Severe
13,8,164,F,63,9,6,114,-50,Severe
15,6,186,F,93,12,6,150,-36,Severe
16,8,200,M,4,5,4,64,-136,Severe
9,8,116,M,83,11,6,138,22,Well
6,9,81,M,48,8,1,97,16,Well
17,7,211,M,80,11,3,135,-76,Severe
8,8,104,M,91,12,4,148,44,Well
17,4,208,M,66,9,9,117,-91,Severe
5,5,65,M,107,13,11,167,102,Well
12,7,151,M,69,10,1,121,-30,Severe
8,6,102,M,84,11,7,139,37,Well
5,8,68,F,3,5,3,63,-5,Mild
15,1,181,M,84,11,7,139,-42,Severe
16,4,196,M,39,7,5,89,-107,Severe
15,0,180,F,43,7,8,92,-88,Severe
12,7,151,M,42,7,7,91,-60,Severe
5,4,64,M,72,10,4,124,60,Well
18,3,219,M,27,6,7,79,-140,Severe
18,8,224,M,15,5,11,71,-153,Severe
14,10,178,F,12,5,9,69,-109,Severe
14,0,168,M,70,10,2,122,-46,Severe
14,10,178,M,88,12,0,144,-34,Severe
6,1,73,F,86,11,10,142,69,Well
8,2,98,M,45,7,10,94,-4,Mild
17,7,211,M,100,13,3,159,-52,Severe
7,2,86,M,7,5,6,66,-20,Severe
14,3,171,M,5,5,5,65,-106,Severe
18,5,221,F,91,12,4,148,-73,Severe
7,11,95,M,99,13,1,157,62,Well
9,4,112,M,54,8,7,103,-9,Severe
10,4,124,M,80,11,3,135,11,Well
10,7,127,M,31,6,9,81,-46,Severe
12,3,147,M,66,9,9,117,-30,Severe
14,1,169,M,37,7,3,87,-82,Severe
8,9,105,F,38,7,4,88,-17,Severe
9,3,111,F,71,10,3,123,12,Well
12,11,155,F,77,10,11,131,-24,Severe
5,6,66,F,76,10,10,130,64,Well
13,1,157,M,93,12,6,150,-7,Severe
13,2,158,M,47,8,0,96,-62,Severe
11,2,134,M,53,8,6,102,-32,Severe
14,3,171,M,70,10,2,122,-49,Severe
11,1,133,M,82,11,5,137,4,Good
9,3,111,F,34,7,0,84,-27,Severe
8,5,101,M,20,6,2,74,-27,Severe
11,5,137,M,55,8,8,104,-33,Severe
5,3,63,F,16,5,11,71,8,Well
7,5,89,F,81,11,4,136,47,Well
5,3,63,M,13,5,9,69,6,Well
15,10,190,M,103,13,6,162,-28,Severe
11,10,142,M,92,12,5,149,7,Well
12,3,147,M,88,12,0,144,-3,Mild
7,5,89,F,64,9,7,115,26,Well
10,0,120,F,90,12,3,147,27,Well
6,3,75,M,85,11,9,141,66,Well
17,10,214,F,10,5,7,67,-147,Severe
5,5,65,M,72,10,4,124,59,Well
7,4,88,F,71,10,3,123,35,Well
14,8,176,F,68,10,0,120,-56,Severe
16,10,202,M,71,10,3,123,-79,Severe
13,9,165,F,11,5,8,68,-97,Severe
18,9,225,M,13,5,9,69,-156,Severe
12,3,147,M,90,12,3,147,0,Neutral
18,5,221,M,13,5,9,69,-152,Severe
7,5,89,F,14,5,10,70,-19,Severe
17,0,204,F,59,9,1,109,-95,Severe
9,10,118,F,101,13,4,160,42,Well
11,2,134,M,71,10,3,123,-11,Severe
9,9,117,M,2,5,3,63,-54,Severe
7,5,89,F,69,10,1,121,32,Well
7,2,86,F,103,13,6,162,76,Well
18,8,224,F,81,11,4,136,-88,Severe
15,10,190,F,84,11,7,139,-51,Severe
8,11,107,M,86,11,10,142,35,Well
16,3,195,F,99,13,1,157,-38,Severe
5,3,63,M,101,13,4,160,97,Well
15,1,181,F,85,11,9,141,-40,Severe
13,4,160,M,104,13,7,163,3,Good
7,7,91,F,13,5,9,69,-22,Severe
14,5,173,M,50,8,3,99,-74,Severe
14,0,168,M,7,5,6,66,-102,Severe
14,3,171,F,105,13,9,165,-6,Severe
12,3,147,M,19,6,1,73,-74,Severe
6,3,75,M,103,13,6,162,87,Well
9,3,111,F,38,7,4,88,-23,Severe
16,8,200,F,14,5,10,70,-130,Severe
6,2,74,F,103,13,6,162,88,Well
6,4,76,F,109,14,1,169,93,Well
18,3,219,F,33,6,11,83,-136,Severe
11,9,141,F,67,9,10,118,-23,Severe
10,7,127,F,40,7,5,89,-38,Severe
18,0,216,F,25,6,5,77,-139,Severe
12,2,146,F,99,13,1,157,11,Well
17,1,205,F,105,13,9,165,-40,Severe
5,4,64,M,8,5,6,66,2,Good
11,9,141,M,102,13,6,162,21,Well
10,3,123,F,87,11,11,143,20,Well
16,3,195,F,46,7,11,95,-100,Severe
7,3,87,M,54,8,7,103,16,Well
12,4,148,M,109,14,1,169,21,Well
6,7,79,M,105,13,9,165,86,Well
18,11,227,F,7,5,6,66,-161,Severe
9,9,117,F,34,7,0,84,-33,Severe
14,6,174,M,99,13,1,157,-17,Severe
13,10,166,M,45,7,10,94,-72,Severe
15,3,183,F,64,9,7,115,-68,Severe
5,7,67,F,23,6,4,76,9,Well
5,11,71,M,67,9,10,118,47,Well
10,8,128,F,84,11,7,139,11,Well
5,8,68,M,58,9,0,108,40,Well
10,2,122,M,7,5,6,66,-56,Severe
17,10,214,F,67,9,10,118,-96,Severe
6,5,77,F,21,6,2,74,-3,Mild
14,11,179,F,69,10,1,121,-58,Severe
7,1,85,M,71,10,3,123,38,Well
15,7,187,F,7,5,6,66,-121,Severe
9,0,108,F,59,9,1,109,1,Good
5,11,71,M,98,13,0,156,85,Well
14,0,168,M,5,5,5,65,-103,Severe
18,9,225,F,72,10,4,124,-101,Severe
11,3,135,M,70,10,2,122,-13,Severe
15,5,185,F,36,7,2,86,-99,Severe
5,10,70,F,3,5,3,63,-7,Severe
13,3,159,M,63,9,6,114,-45,Severe
9,3,111,M,83,11,6,138,27,Well
15,0,180,M,79,11,1,133,-47,Severe
9,7,115,F,11,5,8,68,-47,Severe
9,3,111,F,42,7,7,91,-20,Severe
13,0,156,F,72,10,4,124,-32,Severe
16,1,193,M,94,12,7,151,-42,Severe
13,7,163,F,66,9,9,117,-46,Severe
13,10,166,M,51,8,4,100,-66,Severe
14,5,173,M,61,9,3,111,-62,Severe
11,4,136,F,99,13,1,157,21,Well
12,6,150,F,69,10,1,121,-29,Severe
13,10,166,M,58,9,0,108,-58,Severe
11,3,135,M,2,5,3,63,-72,Severe
14,3,171,M,36,7,2,86,-85,Severe
18,8,224,F,85,11,9,141,-83,Severe
14,0,168,F,63,9,6,114,-54,Severe
11,10,142,M,31,6,9,81,-61,Severe
8,5,101,F,29,6,8,80,-21,Severe
8,2,98,F,88,12,0,144,46,Well
8,7,103,M,5,5,5,65,-38,Severe
12,5,149,F,46,7,11,95,-54,Severe
8,3,99,F,21,6,2,74,-25,Severe
6,0,72,M,10,5,7,67,-5,Mild
11,11,143,F,61,9,3,111,-32,Severe
16,6,198,F,71,10,3,123,-75,Severe
6,8,80,F,109,14,1,169,89,Well
12,2,146,F,66,9,9,117,-29,Severe
8,3,99,M,17,6,0,72,-27,Severe
14,11,179,F,12,5,9,69,-110,Severe
13,5,161,M,102,13,6,162,1,Good
7,11,95,F,97,12,11,155,60,Well
7,3,87,F,98,13,0,156,69,Well
6,7,79,M,13,5,9,69,-10,Severe
11,2,134,F,8,5,6,66,-68,Severe
8,11,107,M,50,8,3,99,-8,Severe
12,11,155,F,108,14,0,168,13,Well
10,3,123,F,51,8,4,100,-23,Severe
18,1,217,M,83,11,6,138,-79,Severe
13,0,156,M,70,10,2,122,-34,Severe
11,3,135,F,28,6,8,80,-55,Severe
5,7,67,M,91,12,4,148,81,Well
7,9,93,M,103,13,6,162,69,Well
17,8,212,F,63,9,6,114,-98,Severe
5,10,70,M,74,10,7,127,57,Well
15,5,185,F,102,13,6,162,-23,Severe
13,11,167,F,35,7,1,85,-82,Severe
15,3,183,F,22,6,3,75,-108,Severe
15,5,185,F,29,6,8,80,-105,Severe
5,8,68,F,11,5,8,68,0,Neutral
6,8,80,M,103,13,6,162,82,Well
5,1,61,M,32,6,10,82,21,Well
18,6,222,M,14,5,10,70,-152,Severe
18,10,226,M,44,7,9,93,-133,Severe
8,3,99,F,13,5,9,69,-30,Severe
17,1,205,M,47,8,0,96,-109,Severe
6,3,75,F,95,12,9,153,78,Well
8,0,96,F,3,5,3,63,-33,Severe
8,7,103,F,23,6,4,76,-27,Severe
8,0,96,M,41,7,6,90,-6,Severe
5,0,60,F,12,5,9,69,9,Well
12,6,150,F,96,12,10,154,4,Good
14,7,175,M,97,12,11,155,-20,Severe
17,0,204,F,93,12,6,150,-54,Severe
12,5,149,F,38,7,4,88,-61,Severe
18,7,223,M,105,13,9,165,-58,Severe
12,8,152,M,15,5,11,71,-81,Severe
12,2,146,F,4,5,4,64,-82,Severe
13,8,164,F,61,9,3,111,-53,Severe
18,4,220,F,43,7,8,92,-128,Severe
11,4,136,M,7,5,6,66,-70,Severe
8,8,104,F,43,7,8,92,-12,Severe
5,7,67,F,59,9,1,109,42,Well
9,8,116,F,40,7,5,89,-27,Severe
17,10,214,F,24,6,5,77,-137,Severe
6,11,83,M,17,6,0,72,-11,Severe
18,4,220,M,88,12,0,144,-76,Severe
16,0,192,M,83,11,6,138,-54,Severe
13,3,159,M,62,9,4,112,-47,Severe
6,2,74,M,50,8,3,99,25,Well
16,0,192,M,82,11,5,137,-55,Severe
17,3,207,M,108,14,0,168,-39,Severe
15,8,188,F,41,7,6,90,-98,Severe
17,3,207,F,43,7,8,92,-115,Severe
8,1,97,M,46,7,11,95,-2,Mild
6,0,72,F,10,5,7,67,-5,Mild
16,11,203,M,93,12,6,150,-53,Severe
14,10,178,M,16,5,11,71,-107,Severe
15,9,189,F,24,6,5,77,-112,Severe
12,8,152,M,28,6,8,80,-72,Severe
17,1,205,F,35,7,1,85,-120,Severe
12,9,153,M,72,10,4,124,-29,Severe
18,1,217,M,76,10,10,130,-87,Severe
8,2,98,M,98,13,0,156,58,Well
13,0,156,F,80,11,3,135,-21,Severe
5,2,62,M,42,7,7,91,29,Well
7,0,84,F,10,5,7,67,-17,Severe
12,7,151,M,86,11,10,142,-9,Severe
7,6,90,M,23,6,4,76,-14,Severe
12,4,148,F,63,9,6,114,-34,Severe
16,9,201,M,106,13,10,166,-35,Severe
12,3,147,M,110,14,3,171,24,Well
9,8,116,F,17,6,0,72,-44,Severe
15,11,191,M,39,7,5,89,-102,Severe
6,0,72,M,109,14,1,169,97,Well
12,9,153,F,32,6,10,82,-71,Severe
10,2,122,F,34,7,0,84,-38,Severe
10,3,123,M,13,5,9,69,-54,Severe
6,3,75,F,62,9,4,112,37,Well
7,3,87,F,93,12,6,150,63,Well
14,2,170,F,39,7,5,89,-81,Severe
13,7,163,M,60,9,2,110,-53,Severe
10,0,120,F,106,13,10,166,46,Well
18,9,225,F,40,7,5,89,-136,Severe
11,1,133,F,12,5,9,69,-64,Severe
5,7,67,F,84,11,7,139,72,Well
17,6,210,F,13,5,9,69,-141,Severe
11,1,133,F,108,14,0,168,35,Well
5,5,65,M,102,13,6,162,97,Well
6,5,77,F,81,11,4,136,59,Well
10,3,123,M,96,12,10,154,31,Well
12,0,144,M,33,6,11,83,-61,Severe
10,3,123,M,48,8,1,97,-26,Severe
8,9,105,M,28,6,8,80,-25,Severe
9,5,113,F,50,8,3,99,-14,Severe
7,10,94,F,90,12,3,147,53,Well
14,3,171,M,27,6,7,79,-92,Severe
17,3,207,F,11,5,8,68,-139,Severe
12,2,146,F,65,9,8,116,-30,Severe
7,3,87,F,12,5,9,69,-18,Severe
16,2,194,F,71,10,3,123,-71,Severe
14,10,178,F,76,10,10,130,-48,Severe
7,6,90,F,54,8,7,103,13,Well
11,6,138,M,104,13,7,163,25,Well
17,3,207,M,22,6,3,75,-132,Severe
14,8,176,M,11,5,8,68,-108,Severe
13,0,156,F,83,11,6,138,-18,Severe
5,11,71,F,101,13,4,160,89,Well
15,4,184,F,100,13,3,159,-25,Severe
8,10,106,F,65,9,8,116,10,Well
17,6,210,F,55,8,8,104,-106,Severe
17,9,213,F,87,11,11,143,-70,Severe
10,2,122,M,68,10,0,120,-2,Mild
16,5,197,F,74,10,7,127,-70,Severe
6,8,80,F,69,10,1,121,41,Well
9,7,115,F,104,13,7,163,48,Well
10,3,123,F,7,5,6,66,-57,Severe
14,4,172,M,87,11,11,143,-29,Severe
5,8,68,F,76,10,10,130,62,Well
10,3,123,F,23,6,4,76,-47,Severe
8,9,105,F,87,11,11,143,38,Well
17,4,208,F,7,5,6,66,-142,Severe
13,9,165,F,34,7,0,84,-81,Severe
10,5,125,M,35,7,1,85,-40,Severe
5,2,62,F,60,9,2,110,48,Well
9,5,113,F,59,9,1,109,-4,Mild
10,7,127,F,93,12,6,150,23,Well
18,10,226,F,13,5,9,69,-157,Severe
18,9,225,M,104,13,7,163,-62,Severe
12,1,145,M,85,11,9,141,-4,Mild
11,10,142,F,20,6,2,74,-68,Severe
11,6,138,M,35,7,1,85,-53,Severe
8,8,104,F,48,8,1,97,-7,Severe
15,3,183,M,48,8,1,97,-86,Severe
11,8,140,M,14,5,10,70,-70,Severe
17,7,211,M,3,5,3,63,-148,Severe
17,4,208,F,24,6,5,77,-131,Severe
8,7,103,M,4,5,4,64,-39,Severe
7,5,89,M,74,10,7,127,38,Well
16,7,199,F,8,5,6,66,-133,Severe
11,9,141,M,76,10,10,130,-11,Severe
15,10,190,F,71,10,3,123,-67,Severe
9,6,114,M,104,13,7,163,49,Well
8,0,96,M,45,7,10,94,-2,Mild
11,3,135,F,6,5,5,65,-70,Severe
13,8,164,M,55,8,8,104,-60,Severe
12,9,153,F,57,8,10,106,-47,Severe
16,3,195,M,71,10,3,123,-72,Severe
9,1,109,M,65,9,8,116,7,Well
18,6,222,F,68,10,0,120,-102,Severe
13,5,161,F,64,9,7,115,-46,Severe
10,1,121,M,10,5,7,67,-54,Severe
18,1,217,M,33,6,11,83,-134,Severe
13,8,164,M,91,12,4,148,-16,Severe
7,7,91,M,23,6,4,76,-15,Severe
6,3,75,M,67,9,10,118,43,Well
18,2,218,F,10,5,7,67,-151,Severe
14,3,171,F,27,6,7,79,-92,Severe
12,4,148,M,68,10,0,120,-28,Severe
16,3,195,F,70,10,2,122,-73,Severe
9,2,110,M,34,7,0,84,-26,Severe
15,5,185,M,10,5,7,67,-118,Severe
5,7,67,F,36,7,2,86,19,Well
9,3,111,M,86,11,10,142,31,Well
6,3,75,F,47,8,0,96,21,Well
7,7,91,M,91,12,4,148,57,Well
18,6,222,F,54,8,7,103,-119,Severe
16,3,195,M,13,5,9,69,-126,Severe
15,3,183,F,34,7,0,84,-99,Severe
11,3,135,M,85,11,9,141,6,Well
10,7,127,M,35,7,1,85,-42,Severe
16,4,196,F,38,7,4,88,-108,Severe
14,9,177,M,49,8,2,98,-79,Severe
13,4,160,F,3,5,3,63,-97,Severe
17,4,208,F,14,5,10,70,-138,Severe
6,2,74,F,71,10,3,123,49,Well
7,2,86,M,15,5,11,71,-15,Severe
6,2,74,F,31,6,9,81,7,Well
12,6,150,M,81,11,4,136,-14,Severe
18,2,218,M,70,10,2,122,-96,Severe
17,8,212,M,87,11,11,143,-69,Severe
10,10,130,F,25,6,5,77,-53,Severe
11,2,134,M,6,5,5,65,-69,Severe
11,5,137,F,57,8,10,106,-31,Severe
14,6,174,M,104,13,7,163,-11,Severe
17,11,215,M,94,12,7,151,-64,Severe
10,7,127,F,47,8,0,96,-31,Severe
11,2,134,F,36,7,2,86,-48,Severe
17,4,208,M,96,12,10,154,-54,Severe
17,6,210,F,29,6,8,80,-130,Severe
17,9,213,M,76,10,10,130,-83,Severe
5,5,65,F,14,5,10,70,5,Good
10,6,126,M,60,9,2,110,-16,Severe
13,0,156,M,106,13,10,166,10,Well
16,3,195,F,107,13,11,167,-28,Severe
7,4,88,M,33,6,11,83,-5,Mild
9,5,113,M,14,5,10,70,-43,Severe
11,8,140,M,109,14,1,169,29,Well
17,0,204,M,108,14,0,168,-36,Severe
10,9,129,M,108,14,0,168,39,Well
7,0,84,M,29,6,8,80,-4,Mild
10,7,127,M,85,11,9,141,14,Well
11,3,135,M,31,6,9,81,-54,Severe
11,7,139,F,60,9,2,110,-29,Severe
7,1,85,M,90,12,3,147,62,Well
6,8,80,F,35,7,1,85,5,Good
7,11,95,F,36,7,2,86,-9,Severe
16,11,203,F,86,11,10,142,-61,Severe
5,0,60,F,107,13,11,167,107,Well
15,3,183,F,61,9,3,111,-72,Severe
14,3,171,M,50,8,3,99,-72,Severe
11,5,137,F,12,5,9,69,-68,Severe
9,9,117,F,107,13,11,167,50,Well
8,9,105,F,55,8,8,104,-1,Mild
5,11,71,M,75,10,9,129,58,Well
12,2,146,F,67,9,10,118,-28,Severe
5,6,66,M,8,5,6,66,0,Neutral
13,3,159,M,76,10,10,130,-29,Severe
5,3,63,F,34,7,0,84,21,Well
15,7,187,M,108,14,0,168,-19,Severe
12,3,147,F,110,14,3,171,24,Well
15,4,184,M,66,9,9,117,-67,Severe
9,6,114,M,32,6,10,82,-32,Severe
18,9,225,F,80,11,3,135,-90,Severe
17,3,207,M,48,8,1,97,-110,Severe
18,0,216,M,50,8,3,99,-117,Severe
11,2,134,M,40,7,5,89,-45,Severe
8,3,99,F,5,5,5,65,-34,Severe
8,4,100,F,61,9,3,111,11,Well
14,2,170,M,104,13,7,163,-7,Severe
8,6,102,F,95,12,9,153,51,Well
13,11,167,F,85,11,9,141,-26,Severe
12,2,146,F,54,8,7,103,-43,Severe
14,2,170,M,3,5,3,63,-107,Severe
5,6,66,F,93,12,6,150,84,Well
5,11,71,M,108,14,0,168,97,Well
7,5,89,F,15,5,11,71,-18,Severe
17,8,212,M,105,13,9,165,-47,Severe
14,8,176,M,43,7,8,92,-84,Severe
17,5,209,F,16,5,11,71,-138,Severe
9,5,113,M,109,14,1,169,56,Well
10,5,125,F,33,6,11,83,-42,Severe
11,2,134,M,32,6,10,82,-52,Severe
10,10,130,M,42,7,7,91,-39,Severe
7,0,84,M,70,10,2,122,38,Well
7,8,92,F,31,6,9,81,-11,Severe
12,11,155,F,69,10,1,121,-34,Severe
14,7,175,F,84,11,7,139,-36,Severe
12,4,148,M,39,7,5,89,-59,Severe
10,10,130,M,50,8,3,99,-31,Severe
7,9,93,F,83,11,6,138,45,Well
17,2,206,M,37,7,3,87,-119,Severe
14,7,175,M,40,7,5,89,-86,Severe
11,2,134,M,46,7,11,95,-39,Severe
8,10,106,M,95,12,9,153,47,Well
12,5,149,F,83,11,6,138,-11,Severe
16,6,198,F,88,12,0,144,-54,Severe
17,3,207,F,17,6,0,72,-135,Severe
7,5,89,F,71,10,3,123,34,Well
13,3,159,M,84,11,7,139,-20,Severe
10,4,124,F,82,11,5,137,13,Well
9,2,110,F,107,13,11,167,57,Well
17,2,206,F,96,12,10,154,-52,Severe
13,8,164,F,106,13,10,166,2,Good
9,3,111,F,68,10,0,120,9,Well
12,1,145,M,49,8,2,98,-47,Severe
5,4,64,M,51,8,4,100,36,Well
8,4,100,M,47,8,0,96,-4,Mild
6,4,76,F,97,12,11,155,79,Well
18,6,222,F,17,6,0,72,-150,Severe
15,4,184,M,71,10,3,123,-61,Severe
11,4,136,F,107,13,11,167,31,Well
10,3,123,M,103,13,6,162,39,Well
6,8,80,M,110,14,3,171,91,Well
15,0,180,F,6,5,5,65,-115,Severe
7,8,92,F,20,6,2,74,-18,Severe
15,5,185,F,66,9,9,117,-68,Severe
9,9,117,F,39,7,5,89,-28,Severe
5,4,64,F,25,6,5,77,13,Well
18,2,218,M,94,12,7,151,-67,Severe
13,8,164,F,69,10,1,121,-43,Severe
13,2,158,M,9,5,7,67,-91,Severe
11,5,137,F,56,8,9,105,-32,Severe
11,11,143,M,25,6,5,77,-66,Severe
9,0,108,M,101,13,4,160,52,Well
18,3,219,F,64,9,7,115,-104,Severe
18,3,219,F,12,5,9,69,-150,Severe
18,1,217,F,48,8,1,97,-120,Severe
18,1,217,F,63,9,6,114,-103,Severe
14,2,170,M,88,12,0,144,-26,Severe
18,9,225,F,84,11,7,139,-86,Severe
5,7,67,F,7,5,6,66,-1,Mild
18,11,227,F,60,9,2,110,-117,Severe
17,5,209,M,66,9,9,117,-92,Severe
10,11,131,F,85,11,9,141,10,Well
10,3,123,F,30,6,9,81,-42,Severe
6,9,81,F,58,9,0,108,27,Well
17,3,207,M,24,6,5,77,-130,Severe
8,8,104,F,22,6,3,75,-29,Severe
5,8,68,F,47,8,0,96,28,Well
7,3,87,F,30,6,9,81,-6,Severe
8,1,97,F,28,6,8,80,-17,Severe
13,3,159,M,6,5,5,65,-94,Severe
17,4,208,F,18,6,1,73,-135,Severe
8,3,99,F,96,12,10,154,55,Well
17,10,214,M,45,7,10,94,-120,Severe
10,5,125,M,105,13,9,165,40,Well
6,8,80,M,71,10,3,123,43,Well
18,4,220,M,25,6,5,77,-143,Severe
18,3,219,M,19,6,1,73,-146,Severe
8,0,96,M,27,6,7,79,-17,Severe
5,2,62,F,22,6,3,75,13,Well
13,0,156,F,45,7,10,94,-62,Severe
6,11,83,M,64,9,7,115,32,Well
17,7,211,F,8,5,6,66,-145,Severe
13,3,159,M,74,10,7,127,-32,Severe
8,10,106,M,39,7,5,89,-17,Severe
18,4,220,M,51,8,4,100,-120,Severe
15,11,191,F,32,6,10,82,-109,Severe
9,8,116,F,43,7,8,92,-24,Severe
6,11,83,F,89,12,1,145,62,Well
7,3,87,M,88,12,0,144,57,Well
8,2,98,F,4,5,4,64,-34,Severe
5,4,64,M,39,7,5,89,25,Well
5,3,63,F,56,8,9,105,42,Well
8,8,104,M,67,9,10,118,14,Well
11,2,134,F,94,12,7,151,17,Well
18,9,225,F,103,13,6,162,-63,Severe
17,10,214,M,67,9,10,118,-96,Severe
12,5,149,F,74,10,7,127,-22,Severe
16,1,193,F,72,10,4,124,-69,Severe
15,10,190,M,72,10,4,124,-66,Severe
18,11,227,F,65,9,8,116,-111,Severe
14,7,175,F,15,5,11,71,-104,Severe
5,11,71,F,64,9,7,115,44,Well
15,7,187,M,64,9,7,115,-72,Severe
17,4,208,F,80,11,3,135,-73,Severe
15,2,182,M,26,6,6,78,-104,Severe
10,8,128,M,30,6,9,81,-47,Severe
13,2,158,M,13,5,9,69,-89,Severe
14,11,179,M,57,8,10,106,-73,Severe
14,8,176,M,8,5,6,66,-110,Severe
6,1,73,F,77,10,11,131,58,Well
15,10,190,F,67,9,10,118,-72,Severe
14,4,172,M,51,8,4,100,-72,Severe
15,2,182,F,106,13,10,166,-16,Severe
9,8,116,F,84,11,7,139,23,Well
5,3,63,M,56,8,9,105,42,Well
12,4,148,F,78,11,0,132,-16,Severe
16,0,192,M,19,6,1,73,-119,Severe
11,6,138,M,25,6,5,77,-61,Severe
9,2,110,M,77,10,11,131,21,Well
8,4,100,F,40,7,5,89,-11,Severe
6,9,81,F,2,5,3,63,-18,Severe
10,5,125,F,68,10,0,120,-5,Mild
18,0,216,M,82,11,5,137,-79,Severe
6,1,73,F,65,9,8,116,43,Well
8,4,100,M,70,10,2,122,22,Well
7,5,89,F,44,7,9,93,4,Good
5,3,63,F,34,7,0,84,21,Well
12,5,149,F,42,7,7,91,-58,Severe
12,4,148,M,82,11,5,137,-11,Severe
11,7,139,M,54,8,7,103,-36,Severe
8,8,104,M,70,10,2,122,18,Well
14,10,178,M,66,9,9,117,-61,Severe
11,1,133,F,23,6,4,76,-57,Severe
8,3,99,F,7,5,6,66,-33,Severe
12,9,153,M,64,9,7,115,-38,Severe
12,8,152,M,79,11,1,133,-19,Severe
16,2,194,M,86,11,10,142,-52,Severe
15,0,180,F,90,12,3,147,-33,Severe
13,10,166,F,34,7,0,84,-82,Severe
9,1,109,F,64,9,7,115,6,Well
8,11,107,M,67,9,10,118,11,Well
7,3,87,F,19,6,1,73,-14,Severe
9,0,108,F,62,9,4,112,4,Good
10,4,124,M,110,14,3,171,47,Well
7,3,87,M,110,14,3,171,84,Well
14,2,170,M,64,9,7,115,-55,Severe
14,7,175,M,28,6,8,80,-95,Severe
11,3,135,M,78,11,0,132,-3,Mild
17,1,205,M,35,7,1,85,-120,Severe
18,9,225,F,52,8,5,101,-124,Severe
17,8,212,F,7,5,6,66,-146,Severe
18,1,217,M,40,7,5,89,-128,Severe
12,3,147,M,68,10,0,120,-27,Severe
10,3,123,F,95,12,9,153,30,Well
18,3,219,M,35,7,1,85,-134,Severe
9,1,109,M,33,6,11,83,-26,Severe
5,10,70,F,23,6,4,76,6,Well
8,7,103,M,58,9,0,108,5,Good
8,11,107,F,35,7,1,85,-22,Severe
13,11,167,M,10,5,7,67,-100,Severe
9,10,118,F,77,10,11,131,13,Well
17,11,215,F,21,6,2,74,-141,Severe
17,8,212,F,108,14,0,168,-44,Severe
12,11,155,F,38,7,4,88,-67,Severe
6,4,76,F,21,6,2,74,-2,Mild
8,6,102,M,58,9,0,108,6,Well
16,8,200,M,13,5,9,69,-131,Severe
6,5,77,M,60,9,2,110,33,Well
9,1,109,M,104,13,7,163,54,Well
16,4,196,F,32,6,10,82,-114,Severe
5,7,67,M,38,7,4,88,21,Well
18,3,219,F,54,8,7,103,-116,Severe
15,2,182,F,8,5,6,66,-116,Severe
7,11,95,F,13,5,9,69,-26,Severe
6,7,79,F,86,11,10,142,63,Well
18,3,219,M,87,11,11,143,-76,Severe
9,7,115,F,45,7,10,94,-21,Severe
11,3,135,M,11,5,8,68,-67,Severe
8,3,99,M,73,10,6,126,27,Well
15,3,183,M,99,13,1,157,-26,Severe
6,7,79,F,22,6,3,75,-4,Mild
16,7,199,F,42,7,7,91,-108,Severe
9,1,109,M,75,10,9,129,20,Well
18,3,219,M,89,12,1,145,-74,Severe
9,7,115,F,87,11,11,143,28,Well
15,0,180,M,30,6,9,81,-99,Severe
6,1,73,F,64,9,7,115,42,Well
11,3,135,F,7,5,6,66,-69,Severe
6,1,73,M,71,10,3,123,50,Well
13,9,165,F,37,7,3,87,-78,Severe
9,1,109,F,105,13,9,165,56,Well
8,4,100,F,51,8,4,100,0,Neutral
11,6,138,M,93,12,6,150,12,Well
11,7,139,F,55,8,8,104,-35,Severe
6,0,72,F,82,11,5,137,65,Well
14,2,170,F,64,9,7,115,-55,Severe
17,7,211,M,106,13,10,166,-45,Severe
18,5,221,M,50,8,3,99,-122,Severe
11,8,140,F,16,5,11,71,-69,Severe
14,5,173,F,2,5,3,63,-110,Severe
8,7,103,M,25,6,5,77,-26,Severe
6,3,75,F,75,10,9,129,54,Well
7,11,95,F,60,9,2,110,15,Well
6,9,81,M,9,5,7,67,-14,Severe
17,4,208,F,109,14,1,169,-39,Severe
5,5,65,M,19,6,1,73,8,Well
6,0,72,M,108,14,0,168,96,Well
5,2,62,M,53,8,6,102,40,Well
12,7,151,F,102,13,6,162,11,Well
12,3,147,M,27,6,7,79,-68,Severe
16,9,201,F,43,7,8,92,-109,Severe
16,1,193,F,83,11,6,138,-55,Severe
16,5,197,M,68,10,0,120,-77,Severe
14,4,172,F,2,5,3,63,-109,Severe
12,3,147,F,32,6,10,82,-65,Severe
12,10,154,F,29,6,8,80,-74,Severe
14,0,168,F,43,7,8,92,-76,Severe
10,9,129,M,14,5,10,70,-59,Severe
14,9,177,F,90,12,3,147,-30,Severe
5,9,69,M,33,6,11,83,14,Well
13,9,165,F,13,5,9,69,-96,Severe
16,3,195,M,83,11,6,138,-57,Severe
18,11,227,F,9,5,7,67,-160,Severe
7,8,92,M,37,7,3,87,-5,Mild
15,3,183,F,102,13,6,162,-21,Severe
8,2,98,F,109,14,1,169,71,Well
5,4,64,M,53,8,6,102,38,Well
14,4,172,F,47,8,0,96,-76,Severe
17,11,215,M,30,6,9,81,-134,Severe
7,3,87,M,71,10,3,123,36,Well
14,6,174,M,71,10,3,123,-51,Severe
15,4,184,M,14,5,10,70,-114,Severe
7,3,87,M,73,10,6,126,39,Well
5,11,71,F,46,7,11,95,24,Well
6,4,76,M,37,7,3,87,11,Well
12,0,144,F,66,9,9,117,-27,Severe
14,8,176,M,67,9,10,118,-58,Severe
13,2,158,F,13,5,9,69,-89,Severe
12,2,146,F,108,14,0,168,22,Well
10,0,120,F,99,13,1,157,37,Well
8,8,104,F,6,5,5,65,-39,Severe
5,7,67,F,40,7,5,89,22,Well
17,2,206,M,32,6,10,82,-124,Severe
11,9,141,F,84,11,7,139,-2,Mild
5,2,62,F,32,6,10,82,20,Well
12,8,152,F,47,8,0,96,-56,Severe
7,6,90,M,74,10,7,127,37,Well
10,0,120,M,82,11,5,137,17,Well
15,11,191,F,60,9,2,110,-81,Severe
13,6,162,F,67,9,10,118,-44,Severe
10,11,131,F,108,14,0,168,37,Well
10,10,130,F,19,6,1,73,-57,Severe
16,5,197,F,105,13,9,165,-32,Severe
13,8,164,F,14,5,10,70,-94,Severe
13,11,167,M,38,7,4,88,-79,Severe
13,2,158,M,35,7,1,85,-73,Severe
6,1,73,F,60,9,2,110,37,Well
9,5,113,M,7,5,6,66,-47,Severe
17,3,207,F,84,11,7,139,-68,Severe
9,10,118,M,73,10,6,126,8,Well
15,0,180,F,47,8,0,96,-84,Severe
16,2,194,F,55,8,8,104,-90,Severe
8,6,102,M,57,8,10,106,4,Good
17,0,204,F,57,8,10,106,-98,Severe
14,3,171,F,22,6,3,75,-96,Severe
13,0,156,F,46,7,11,95,-61,Severe
8,10,106,M,50,8,3,99,-7,Severe
10,9,129,M,27,6,7,79,-50,Severe
16,3,195,M,49,8,2,98,-97,Severe
17,5,209,M,64,9,7,115,-94,Severe
6,3,75,M,87,11,11,143,68,Well
11,3,135,F,97,12,11,155,20,Well
6,0,72,F,76,10,10,130,58,Well
16,6,198,M,5,5,5,65,-133,Severe
10,2,122,F,24,6,5,77,-45,Severe
14,10,178,F,94,12,7,151,-27,Severe
6,4,76,F,76,10,10,130,54,Well
18,11,227,M,4,5,4,64,-163,Severe
14,6,174,F,103,13,6,162,-12,Severe
14,7,175,M,69,10,1,121,-54,Severe
15,9,189,M,18,6,1,73,-116,Severe
17,3,207,F,102,13,6,162,-45,Severe
10,3,123,F,9,5,7,67,-56,Severe
6,7,79,M,103,13,6,162,83,Well
15,3,183,M,102,13,6,162,-21,Severe
6,7,79,M,66,9,9,117,38,Well
15,2,182,M,52,8,5,101,-81,Severe
11,0,132,M,88,12,0,144,12,Well
10,3,123,F,38,7,4,88,-35,Severe
13,3,159,F,42,7,7,91,-68,Severe
6,4,76,F,22,6,3,75,-1,Mild
16,1,193,F,54,8,7,103,-90,Severe
12,3,147,M,26,6,6,78,-69,Severe
10,3,123,M,60,9,2,110,-13,Severe
11,3,135,F,16,5,11,71,-64,Severe
5,2,62,F,105,13,9,165,103,Well
5,1,61,M,24,6,5,77,16,Well
16,10,202,F,45,7,10,94,-108,Severe
11,6,138,M,22,6,3,75,-63,Severe
5,10,70,F,95,12,9,153,83,Well
9,0,108,M,84,11,7,139,31,Well
6,10,82,M,75,10,9,129,47,Well
9,8,116,F,4,5,4,64,-52,Severe
15,11,191,M,27,6,7,79,-112,Severe
11,6,138,M,88,12,0,144,6,Well
13,7,163,F,101,13,4,160,-3,Mild
10,0,120,F,88,12,0,144,24,Well
9,5,113,M,64,9,7,115,2,Good
16,3,195,F,21,6,2,74,-121,Severe
7,6,90,M,68,10,0,120,30,Well
17,6,210,F,48,8,1,97,-113,Severe
17,8,212,F,18,6,1,73,-139,Severe
14,10,178,F,45,7,10,94,-84,Severe
14,10,178,M,107,13,11,167,-11,Severe
10,0,120,M,48,8,1,97,-23,Severe
14,2,170,M,98,13,0,156,-14,Severe
11,10,142,M,60,9,2,110,-32,Severe
16,10,202,M,102,13,6,162,-40,Severe
17,9,213,F,43,7,8,92,-121,Severe
14,6,174,F,39,7,5,89,-85,Severe
15,3,183,F,63,9,6,114,-69,Severe
6,10,82,M,87,11,11,143,61,Well
14,3,171,M,16,5,11,71,-100,Severe
18,10,226,M,62,9,4,112,-114,Severe
9,1,109,M,19,6,1,73,-36,Severe
7,1,85,M,29,6,8,80,-5,Mild
7,5,89,M,20,6,2,74,-15,Severe
10,4,124,M,107,13,11,167,43,Well
8,11,107,M,24,6,5,77,-30,Severe
7,11,95,M,33,6,11,83,-12,Severe
14,9,177,M,79,11,1,133,-44,Severe
10,10,130,M,70,10,2,122,-8,Severe
10,4,124,F,46,7,11,95,-29,Severe
15,0,180,F,52,8,5,101,-79,Severe
15,8,188,M,87,11,11,143,-45,Severe
7,2,86,F,79,11,1,133,47,Well
11,11,143,F,4,5,4,64,-79,Severe
5,9,69,F,64,9,7,115,46,Well
15,1,181,F,61,9,3,111,-70,Severe
11,4,136,F,32,6,10,82,-54,Severe
12,9,153,F,100,13,3,159,6,Well
7,3,87,F,54,8,7,103,16,Well
18,11,227,M,41,7,6,90,-137,Severe
8,11,107,M,73,10,6,126,19,Well
17,7,211,F,28,6,8,80,-131,Severe
17,11,215,F,31,6,9,81,-134,Severe
7,5,89,M,64,9,7,115,26,Well
16,11,203,M,42,7,7,91,-112,Severe
8,3,99,M,61,9,3,111,12,Well
8,3,99,M,66,9,9,117,18,Well
18,2,218,F,101,13,4,160,-58,Severe
6,6,78,F,27,6,7,79,1,Good
18,4,220,F,19,6,1,73,-147,Severe
6,11,83,M,88,12,0,144,61,Well
7,5,89,M,62,9,4,112,23,Well
8,9,105,F,80,11,3,135,30,Well
7,4,88,M,99,13,1,157,69,Well
15,6,186,M,86,11,10,142,-44,Severe
12,4,148,F,65,9,8,116,-32,Severe
8,6,102,F,99,13,1,157,55,Well
6,9,81,F,8,5,6,66,-15,Severe
8,3,99,M,101,13,4,160,61,Well
7,4,88,F,49,8,2,98,10,Well
13,4,160,F,91,12,4,148,-12,Severe
8,8,104,M,6,5,5,65,-39,Severe
12,3,147,F,95,12,9,153,6,Well
8,8,104,F,84,11,7,139,35,Well
16,5,197,F,40,7,5,89,-108,Severe
16,6,198,M,64,9,7,115,-83,Severe
10,9,129,F,2,5,3,63,-66,Severe
5,8,68,F,53,8,6,102,34,Well
12,0,144,F,74,10,7,127,-17,Severe
14,5,173,M,67,9,10,118,-55,Severe
7,2,86,M,3,5,3,63,-23,Severe
14,3,171,M,9,5,7,67,-104,Severe
15,5,185,F,37,7,3,87,-98,Severe
9,11,119,M,38,7,4,88,-31,Severe
6,11,83,M,102,13,6,162,79,Well
11,7,139,F,12,5,9,69,-70,Severe
14,3,171,M,20,6,2,74,-97,Severe
11,2,134,M,102,13,6,162,28,Well
14,1,169,M,77,10,11,131,-38,Severe
17,3,207,F,51,8,4,100,-107,Severe
17,6,210,M,73,10,6,126,-84,Severe
11,7,139,M,101,13,4,160,21,Well
12,6,150,M,25,6,5,77,-73,Severe
9,10,118,M,100,13,3,159,41,Well
7,6,90,F,35,7,1,85,-5,Mild
16,7,199,M,66,9,9,117,-82,Severe
5,6,66,F,39,7,5,89,23,Well
9,11,119,F,46,7,11,95,-24,Severe
14,0,168,F,28,6,8,80,-88,Severe
5,4,64,F,11,5,8,68,4,Good
11,6,138,M,31,6,9,81,-57,Severe
15,4,184,M,39,7,5,89,-95,Severe
14,4,172,M,76,10,10,130,-42,Severe
12,4,148,M,33,6,11,83,-65,Severe
6,2,74,M,38,7,4,88,14,Well
14,3,171,M,43,7,8,92,-79,Severe
15,1,181,F,33,6,11,83,-98,Severe
17,3,207,M,48,8,1,97,-110,Severe
5,3,63,M,72,10,4,124,61,Well
6,0,72,M,53,8,6,102,30,Well
13,3,159,M,43,7,8,92,-67,Severe
5,0,60,M,39,7,5,89,29,Well
18,6,222,M,41,7,6,90,-132,Severe
14,8,176,F,77,10,11,131,-45,Severe
9,6,114,F,14,5,10,70,-44,Severe
18,0,216,F,21,6,2,74,-142,Severe
12,6,150,M,18,6,1,73,-77,Severe
18,8,224,M,99,13,1,157,-67,Severe
6,9,81,M,71,10,3,123,42,Well
17,10,214,F,18,6,1,73,-141,Severe
17,0,204,F,12,5,9,69,-135,Severe
9,11,119,M,102,13,6,162,43,Well
17,4,208,F,28,6,8,80,-128,Severe
9,5,113,M,30,6,9,81,-32,Severe
11,11,143,F,16,5,11,71,-72,Severe
7,5,89,F,75,10,9,129,40,Well
8,4,100,F,65,9,8,116,16,Well
7,0,84,F,43,7,8,92,8,Well
11,2,134,M,96,12,10,154,20,Well
12,0,144,M,42,7,7,91,-53,Severe
7,3,87,M,38,7,4,88,1,Good
18,1,217,F,13,5,9,69,-148,Severe
10,2,122,M,76,10,10,130,8,Well
17,3,207,F,20,6,2,74,-133,Severe
8,3,99,M,48,8,1,97,-2,Mild
14,0,168,F,41,7,6,90,-78,Severe
14,10,178,M,28,6,8,80,-98,Severe
7,1,85,F,23,6,4,76,-9,Severe
12,5,149,M,104,13,7,163,14,Well
13,10,166,M,104,13,7,163,-3,Mild
11,11,143,M,102,13,6,162,19,Well
18,2,218,M,102,13,6,162,-56,Severe
14,3,171,F,71,10,3,123,-48,Severe
18,8,224,F,28,6,8,80,-144,Severe
16,4,196,F,97,12,11,155,-41,Severe
18,11,227,F,79,11,1,133,-94,Severe
14,3,171,F,10,5,7,67,-104,Severe
14,11,179,F,86,11,10,142,-37,Severe
8,4,100,M,78,11,0,132,32,Well
18,9,225,M,10,5,7,67,-158,Severe
14,3,171,M,7,5,6,66,-105,Severe
11,8,140,M,54,8,7,103,-37,Severe
15,3,183,F,26,6,6,78,-105,Severe
6,6,78,F,97,12,11,155,77,Well
10,9,129,M,52,8,5,101,-28,Severe
16,2,194,M,74,10,7,127,-67,Severe
18,7,223,M,77,10,11,131,-92,Severe
12,6,150,M,60,9,2,110,-40,Severe
14,5,173,F,14,5,10,70,-103,Severe
7,2,86,F,52,8,5,101,15,Well
15,0,180,F,51,8,4,100,-80,Severe
6,1,73,M,75,10,9,129,56,Well
10,5,125,F,37,7,3,87,-38,Severe
11,6,138,M,59,9,1,109,-29,Severe
9,2,110,F,73,10,6,126,16,Well
7,9,93,F,20,6,2,74,-19,Severe
12,6,150,M,64,9,7,115,-35,Severe
10,1,121,F,52,8,5,101,-20,Severe
16,2,194,M,12,5,9,69,-125,Severe
10,2,122,M,96,12,10,154,32,Well
14,4,172,F,85,11,9,141,-31,Severe
17,7,211,M,8,5,6,66,-145,Severe
13,1,157,F,83,11,6,138,-19,Severe
18,10,226,M,46,7,11,95,-131,Severe
6,8,80,M,57,8,10,106,26,Well
5,2,62,F,24,6,5,77,15,Well
5,4,64,M,57,8,10,106,42,Well
7,11,95,M,53,8,6,102,7,Well
7,9,93,F,79,11,1,133,40,Well
8,3,99,F,90,12,3,147,48,Well
11,1,133,M,22,6,3,75,-58,Severe
7,3,87,F,30,6,9,81,-6,Severe
15,11,191,F,25,6,5,77,-114,Severe
14,10,178,F,11,5,8,68,-110,Severe
7,10,94,F,74,10,7,127,33,Well
12,3,147,M,41,7,6,90,-57,Severe
12,6,150,M,29,6,8,80,-70,Severe
7,3,87,M,77,10,11,131,44,Well
13,8,164,F,73,10,6,126,-38,Severe
5,0,60,F,24,6,5,77,17,Well
12,2,146,F,41,7,6,90,-56,Severe
15,5,185,F,107,13,11,167,-18,Severe
11,9,141,M,10,5,7,67,-74,Severe
13,10,166,F,47,8,0,96,-70,Severe
10,6,126,F,61,9,3,111,-15,Severe
11,11,143,M,3,5,3,63,-80,Severe
8,11,107,F,8,5,6,66,-41,Severe
7,4,88,F,3,5,3,63,-25,Severe
16,3,195,F,50,8,3,99,-96,Severe
12,10,154,M,46,7,11,95,-59,Severe
8,5,101,F,15,5,11,71,-30,Severe
7,1,85,F,45,7,10,94,9,Well
7,10,94,F,16,5,11,71,-23,Severe
18,7,223,M,71,10,3,123,-100,Severe
14,5,173,F,33,6,11,83,-90,Severe
5,5,65,F,100,13,3,159,94,Well
10,9,129,M,41,7,6,90,-39,Severe
17,8,212,M,86,11,10,142,-70,Severe
8,3,99,F,8,5,6,66,-33,Severe
16,0,192,M,42,7,7,91,-101,Severe
6,3,75,M,52,8,5,101,26,Well
18,0,216,M,93,12,6,150,-66,Severe
9,0,108,F,22,6,3,75,-33,Severe
17,8,212,M,35,7,1,85,-127,Severe
16,7,199,F,7,5,6,66,-133,Severe
14,9,177,M,5,5,5,65,-112,Severe
13,3,159,M,97,12,11,155,-4,Mild
15,3,183,F,8,5,6,66,-117,Severe
16,11,203,M,84,11,7,139,-64,Severe
12,3,147,F,67,9,10,118,-29,Severe
6,3,75,F,103,13,6,162,87,Well
6,3,75,F,109,14,1,169,94,Well
12,5,149,M,89,12,1,145,-4,Mild
17,11,215,M,81,11,4,136,-79,Severe
18,3,219,F,88,12,0,144,-75,Severe
6,1,73,F,68,10,0,120,47,Well
9,7,115,M,32,6,10,82,-33,Severe
18,8,224,M,40,7,5,89,-135,Severe
12,1,145,F,103,13,6,162,17,Well
9,1,109,M,77,10,11,131,22,Well
18,11,227,F,91,12,4,148,-79,Severe
10,7,127,M,11,5,8,68,-59,Severe
8,1,97,M,41,7,6,90,-7,Severe
5,7,67,M,55,8,8,104,37,Well
12,8,152,F,54,8,7,103,-49,Severe
10,11,131,M,50,8,3,99,-32,Severe
18,11,227,F,78,11,0,132,-95,Severe
5,4,64,F,42,7,7,91,27,Well
13,3,159,M,75,10,9,129,-30,Severe
15,0,180,F,13,5,9,69,-111,Severe
14,4,172,F,26,6,6,78,-94,Severe
8,0,96,F,100,13,3,159,63,Well
8,3,99,M,21,6,2,74,-25,Severe
18,2,218,M,91,12,4,148,-70,Severe
15,7,187,F,38,7,4,88,-99,Severe
11,9,141,F,43,7,8,92,-49,Severe
8,8,104,F,21,6,2,74,-30,Severe
6,0,72,F,28,6,8,80,8,Well
6,3,75,M,105,13,9,165,90,Well
16,3,195,F,26,6,6,78,-117,Severe
5,6,66,F,23,6,4,76,10,Well
12,1,145,M,42,7,7,91,-54,Severe
18,4,220,M,59,9,1,109,-111,Severe
12,9,153,F,109,14,1,169,16,Well
15,10,190,M,39,7,5,89,-101,Severe
18,9,225,F,91,12,4,148,-77,Severe
7,0,84,M,65,9,8,116,32,Well
10,4,124,M,44,7,9,93,-31,Severe
8,3,99,M,63,9,6,114,15,Well
6,4,76,M,86,11,10,142,66,Well
6,9,81,M,55,8,8,104,23,Well
7,3,87,F,68,10,0,120,33,Well
16,3,195,F,44,7,9,93,-102,Severe
16,0,192,M,88,12,0,144,-48,Severe
17,6,210,F,63,9,6,114,-96,Severe
5,9,69,F,54,8,7,103,34,Well
7,4,88,M,84,11,7,139,51,Well
7,7,91,M,39,7,5,89,-2,Mild
15,11,191,F,85,11,9,141,-50,Severe
10,3,123,M,110,14,3,171,48,Well
10,3,123,M,36,7,2,86,-37,Severe
14,9,177,M,31,6,9,81,-96,Severe
6,8,80,F,8,5,6,66,-14,Severe
14,3,171,F,97,12,11,155,-16,Severe
13,9,165,M,16,5,11,71,-94,Severe
11,11,143,M,77,10,11,131,-12,Severe
17,8,212,M,20,6,2,74,-138,Severe
18,8,224,M,47,8,0,96,-128,Severe
15,6,186,M,41,7,6,90,-96,Severe
9,3,111,M,110,14,3,171,60,Well
18,3,219,F,11,5,8,68,-151,Severe
11,11,143,M,99,13,1,157,14,Well
8,3,99,M,63,9,6,114,15,Well
14,5,173,M,4,5,4,64,-109,Severe
6,3,75,M,67,9,10,118,43,Well
15,11,191,F,31,6,9,81,-110,Severe
6,9,81,F,103,13,6,162,81,Well
5,1,61,M,46,7,11,95,34,Well
17,10,214,M,106,13,10,166,-48,Severe
17,7,211,F,2,5,3,63,-148,Severe
14,2,170,F,57,8,10,106,-64,Severe
15,2,182,F,20,6,2,74,-108,Severe
14,8,176,M,72,10,4,124,-52,Severe
6,9,81,M,16,5,11,71,-10,Severe
15,7,187,M,88,12,0,144,-43,Severe
18,10,226,F,72,10,4,124,-102,Severe
8,4,100,M,56,8,9,105,5,Good
13,8,164,M,100,13,3,159,-5,Mild
9,9,117,M,61,9,3,111,-6,Severe
12,5,149,F,52,8,5,101,-48,Severe
5,11,71,M,62,9,4,112,41,Well
17,6,210,M,43,7,8,92,-118,Severe
15,3,183,M,54,8,7,103,-80,Severe
13,0,156,F,59,9,1,109,-47,Severe
7,3,87,M,83,11,6,138,51,Well
16,8,200,M,69,10,1,121,-79,Severe
6,4,76,F,37,7,3,87,11,Well
11,1,133,F,93,12,6,150,17,Well
13,10,166,M,17,6,0,72,-94,Severe
14,1,169,M,4,5,4,64,-105,Severe
11,6,138,F,97,12,11,155,17,Well
7,2,86,F,50,8,3,99,13,Well
6,10,82,F,40,7,5,89,7,Well
9,1,109,F,107,13,11,167,58,Well
6,5,77,F,103,13,6,162,85,Well
9,7,115,M,58,9,0,108,-7,Severe
18,9,225,M,88,12,0,144,-81,Severe
10,10,130,M,68,10,0,120,-10,Severe
13,0,156,M,91,12,4,148,-8,Severe
5,10,70,M,80,11,3,135,65,Well
14,8,176,M,16,5,11,71,-105,Severe
7,1,85,M,41,7,6,90,5,Good
13,8,164,F,19,6,1,73,-91,Severe
11,5,137,M,86,11,10,142,5,Good
11,0,132,F,4,5,4,64,-68,Severe
9,0,108,M,12,5,9,69,-39,Severe
7,4,88,M,57,8,10,106,18,Well
9,5,113,M,27,6,7,79,-34,Severe
15,1,181,M,97,12,11,155,-26,Severe
13,2,158,M,44,7,9,93,-65,Severe
9,10,118,M,42,7,7,91,-27,Severe
18,2,218,M,8,5,6,66,-152,Severe
12,5,149,F,37,7,3,87,-62,Severe
11,2,134,M,82,11,5,137,3,Good
15,6,186,F,72,10,4,124,-62,Severe
5,8,68,M,31,6,9,81,13,Well
17,1,205,F,107,13,11,167,-38,Severe
8,7,103,F,98,13,0,156,53,Well
18,5,221,M,7,5,6,66,-155,Severe
16,6,198,M,108,14,0,168,-30,Severe
18,2,218,F,94,12,7,151,-67,Severe
13,11,167,M,4,5,4,64,-103,Severe
15,1,181,F,102,13,6,162,-19,Severe
5,1,61,F,37,7,3,87,26,Well
9,8,116,F,98,13,0,156,40,Well
15,2,182,M,102,13,6,162,-20,Severe
12,7,151,M,2,5,3,63,-88,Severe
6,11,83,F,98,13,0,156,73,Well
8,6,102,M,27,6,7,79,-23,Severe
7,2,86,M,91,12,4,148,62,Well
5,0,60,F,70,10,2,122,62,Well
11,8,140,F,65,9,8,116,-24,Severe
15,9,189,M,45,7,10,94,-95,Severe
9,0,108,F,42,7,7,91,-17,Severe
12,10,154,M,13,5,9,69,-85,Severe
7,3,87,F,37,7,3,87,0,Neutral
10,0,120,M,57,8,10,106,-14,Severe
11,4,136,F,68,10,0,120,-16,Severe
5,11,71,F,104,13,7,163,92,Well
13,9,165,F,36,7,2,86,-79,Severe
10,8,128,F,91,12,4,148,20,Well
12,9,153,F,98,13,0,156,3,Good
7,10,94,M,50,8,3,99,5,Good
15,8,188,F,48,8,1,97,-91,Severe
14,5,173,F,87,11,11,143,-30,Severe
11,10,142,F,21,6,2,74,-68,Severe
16,9,201,M,7,5,6,66,-135,Severe
10,9,129,M,75,10,9,129,0,Neutral
18,8,224,F,103,13,6,162,-62,Severe
5,3,63,F,104,13,7,163,100,Well
18,6,222,M,40,7,5,89,-133,Severe
7,10,94,F,93,12,6,150,56,Well
17,4,208,F,49,8,2,98,-110,Severe
10,5,125,F,17,6,0,72,-53,Severe
16,1,193,F,10,5,7,67,-126,Severe
7,3,87,M,107,13,11,167,80,Well
18,2,218,F,98,13,0,156,-62,Severe
14,6,174,F,81,11,4,136,-38,Severe
17,11,215,M,83,11,6,138,-77,Severe
6,3,75,F,72,10,4,124,49,Well
16,3,195,F,24,6,5,77,-118,Severe
10,9,129,F,41,7,6,90,-39,Severe
6,5,77,F,57,8,10,106,29,Well
18,8,224,F,73,10,6,126,-98,Severe
6,4,76,M,36,7,2,86,10,Well
6,9,81,M,86,11,10,142,61,Well
9,9,117,M,18,6,1,73,-44,Severe
14,9,177,M,94,12,7,151,-26,Severe
10,10,130,F,54,8,7,103,-27,Severe
6,7,79,M,17,6,0,72,-7,Severe
9,7,115,F,110,14,3,171,56,Well
18,0,216,M,74,10,7,127,-89,Severe
14,7,175,F,14,5,10,70,-105,Severe
13,6,162,F,25,6,5,77,-85,Severe
12,11,155,F,50,8,3,99,-56,Severe
15,1,181,M,18,6,1,73,-108,Severe
6,6,78,F,32,6,10,82,4,Good
11,0,132,M,81,11,4,136,4,Good
6,9,81,F,72,10,4,124,43,Well
17,11,215,F,76,10,10,130,-85,Severe
18,3,219,M,51,8,4,100,-119,Severe
17,3,207,M,92,12,5,149,-58,Severe
10,6,126,F,106,13,10,166,40,Well
17,0,204,F,105,13,9,165,-39,Severe
11,4,136,F,101,13,4,160,24,Well
7,8,92,M,41,7,6,90,-2,Mild
5,2,62,M,63,9,6,114,52,Well
5,2,62,F,45,7,10,94,32,Well
9,6,114,F,63,9,6,114,0,Neutral
7,5,89,M,96,12,10,154,65,Well
6,0,72,F,81,11,4,136,64,Well
11,2,134,M,66,9,9,117,-17,Severe
11,11,143,F,63,9,6,114,-29,Severe
10,4,124,F,83,11,6,138,14,Well
12,9,153,M,78,11,0,132,-21,Severe
14,5,173,M,14,5,10,70,-103,Severe
8,10,106,M,77,10,11,131,25,Well
18,10,226,M,54,8,7,103,-123,Severe
10,6,126,M,79,11,1,133,7,Well
5,10,70,F,102,13,6,162,92,Well
7,1,85,M,70,10,2,122,37,Well
5,11,71,M,93,12,6,150,79,Well
9,3,111,F,23,6,4,76,-35,Severe
6,8,80,M,82,11,5,137,57,Well
7,0,84,M,89,12,1,145,61,Well
13,4,160,M,21,6,2,74,-86,Severe
5,4,64,M,91,12,4,148,84,Well
8,10,106,F,104,13,7,163,57,Well
8,1,97,M,110,14,3,171,74,Well
16,11,203,M,103,13,6,162,-41,Severe
17,10,214,M,58,9,0,108,-106,Severe
7,4,88,F,88,12,0,144,56,Well
5,11,71,M,41,7,6,90,19,Well
12,10,154,F,24,6,5,77,-77,Severe
6,9,81,M,5,5,5,65,-16,Severe
5,11,71,F,54,8,7,103,32,Well
7,5,89,F,65,9,8,116,27,Well
8,11,107,M,25,6,5,77,-30,Severe
18,3,219,F,56,8,9,105,-114,Severe
7,9,93,M,68,10,0,120,27,Well
10,3,123,F,97,12,11,155,32,Well
6,7,79,M,89,12,1,145,66,Well
10,8,128,M,28,6,8,80,-48,Severe
17,5,209,F,52,8,5,101,-108,Severe
10,3,123,F,32,6,10,82,-41,Severe
16,9,201,F,104,13,7,163,-38,Severe
16,4,196,F,43,7,8,92,-104,Severe
17,3,207,M,4,5,4,64,-143,Severe
18,3,219,M,43,7,8,92,-127,Severe
7,0,84,F,33,6,11,83,-1,Mild
15,4,184,F,50,8,3,99,-85,Severe
8,10,106,M,106,13,10,166,60,Well
17,3,207,M,103,13,6,162,-45,Severe
9,2,110,M,97,12,11,155,45,Well
9,3,111,F,82,11,5,137,26,Well
6,3,75,F,42,7,7,91,16,Well
15,10,190,F,7,5,6,66,-124,Severe
17,7,211,M,79,11,1,133,-78,Severe
14,0,168,F,80,11,3,135,-33,Severe
15,2,182,F,40,7,5,89,-93,Severe
9,10,118,M,17,6,0,72,-46,Severe
14,9,177,M,23,6,4,76,-101,Severe
9,3,111,F,26,6,6,78,-33,Severe
8,0,96,F,84,11,7,139,43,Well
12,9,153,F,58,9,0,108,-45,Severe
10,10,130,M,105,13,9,165,35,Well
17,4,208,M,74,10,7,127,-81,Severe
12,11,155,M,93,12,6,150,-5,Mild
5,2,62,M,88,12,0,144,82,Well
9,8,116,M,79,11,1,133,17,Well
16,1,193,M,13,5,9,69,-124,Severe
5,9,69,F,7,5,6,66,-3,Mild
9,3,111,F,55,8,8,104,-7,Severe
10,9,129,F,93,12,6,150,21,Well
5,8,68,M,78,11,0,132,64,Well
7,4,88,F,52,8,5,101,13,Well
15,6,186,F,50,8,3,99,-87,Severe
7,5,89,M,95,12,9,153,64,Well
7,1,85,F,16,5,11,71,-14,Severe
7,3,87,M,3,5,3,63,-24,Severe
14,7,175,F,99,13,1,157,-18,Severe
12,5,149,M,100,13,3,159,10,Well
8,8,104,F,33,6,11,83,-21,Severe
14,11,179,M,87,11,11,143,-36,Severe
8,8,104,M,65,9,8,116,12,Well
15,0,180,M,78,11,0,132,-48,Severe
15,3,183,M,54,8,7,103,-80,Severe
9,5,113,M,24,6,5,77,-36,Severe
12,10,154,F,13,5,9,69,-85,Severe
11,7,139,F,50,8,3,99,-40,Severe
8,4,100,F,105,13,9,165,65,Well
12,6,150,F,108,14,0,168,18,Well
13,4,160,F,6,5,5,65,-95,Severe
15,2,182,F,68,10,0,120,-62,Severe
10,1,121,F,63,9,6,114,-7,Severe
9,11,119,M,95,12,9,153,34,Well
13,3,159,F,35,7,1,85,-74,Severe
13,4,160,M,32,6,10,82,-78,Severe
5,1,61,F,42,7,7,91,30,Well
15,5,185,F,61,9,3,111,-74,Severe
6,4,76,F,104,13,7,163,87,Well
10,1,121,F,76,10,10,130,9,Well
14,4,172,F,60,9,2,110,-62,Severe
11,3,135,M,58,9,0,108,-27,Severe
12,4,148,M,76,10,10,130,-18,Severe
15,0,180,F,109,14,1,169,-11,Severe
7,2,86,M,38,7,4,88,2,Good
10,11,131,M,87,11,11,143,12,Well
8,3,99,M,76,10,10,130,31,Well
8,2,98,F,47,8,0,96,-2,Mild
10,9,129,M,17,6,0,72,-57,Severe
15,11,191,F,109,14,1,169,-22,Severe
10,3,123,M,13,5,9,69,-54,Severe
5,0,60,M,7,5,6,66,6,Well
11,2,134,M,64,9,7,115,-19,Severe
15,11,191,M,64,9,7,115,-76,Severe
6,7,79,F,10,5,7,67,-12,Severe
18,2,218,F,65,9,8,116,-102,Severe
17,9,213,M,91,12,4,148,-65,Severe
8,11,107,M,62,9,4,112,5,Good
17,8,212,F,10,5,7,67,-145,Severe
12,3,147,M,14,5,10,70,-77,Severe
13,9,165,M,17,6,0,72,-93,Severe
5,8,68,M,101,13,4,160,92,Well
16,3,195,F,60,9,2,110,-85,Severe
7,8,92,F,35,7,1,85,-7,Severe
15,1,181,M,102,13,6,162,-19,Severe
5,1,61,M,57,8,10,106,45,Well
16,0,192,M,45,7,10,94,-98,Severe
14,2,170,F,73,10,6,126,-44,Severe
14,9,177,M,90,12,3,147,-30,Severe
11,1,133,M,78,11,0,132,-1,Mild
15,1,181,M,90,12,3,147,-34,Severe
16,1,193,F,12,5,9,69,-124,Severe
15,3,183,M,42,7,7,91,-92,Severe
9,0,108,M,85,11,9,141,33,Well
12,8,152,F,26,6,6,78,-74,Severe
15,7,187,M,75,10,9,129,-58,Severe
14,8,176,M,89,12,1,145,-31,Severe
16,5,197,F,33,6,11,83,-114,Severe
12,7,151,F,85,11,9,141,-10,Severe
14,7,175,M,96,12,10,154,-21,Severe
7,6,90,M,42,7,7,91,1,Good
11,3,135,M,46,7,11,95,-40,Severe
8,9,105,F,69,10,1,121,16,Well
15,7,187,F,98,13,0,156,-31,Severe
6,8,80,F,80,11,3,135,55,Well
6,2,74,M,101,13,4,160,86,Well
10,10,130,F,95,12,9,153,23,Well
7,11,95,M,77,10,11,131,36,Well
16,10,202,F,101,13,4,160,-42,Severe
15,7,187,M,33,6,11,83,-104,Severe
14,3,171,F,81,11,4,136,-35,Severe
6,1,73,M,38,7,4,88,15,Well
11,9,141,F,44,7,9,93,-48,Severe
9,10,118,M,99,13,1,157,39,Well
10,9,129,F,34,7,0,84,-45,Severe
16,11,203,M,28,6,8,80,-123,Severe
17,10,214,F,16,5,11,71,-143,Severe
15,2,182,F,24,6,5,77,-105,Severe
5,10,70,F,72,10,4,124,54,Well
5,8,68,F,81,11,4,136,68,Well
7,4,88,F,13,5,9,69,-19,Severe
17,1,205,M,12,5,9,69,-136,Severe
15,5,185,F,103,13,6,162,-23,Severe
5,0,60,F,29,6,8,80,20,Well
18,5,221,M,62,9,4,112,-109,Severe
8,3,99,M,54,8,7,103,4,Good
12,5,149,M,56,8,9,105,-44,Severe
16,0,192,F,38,7,4,88,-104,Severe
11,9,141,M,31,6,9,81,-60,Severe
14,0,168,F,40,7,5,89,-79,Severe
18,5,221,M,23,6,4,76,-145,Severe
13,9,165,F,33,6,11,83,-82,Severe
17,1,205,F,103,13,6,162,-43,Severe
11,7,139,F,33,6,11,83,-56,Severe
14,3,171,F,86,11,10,142,-29,Severe
18,1,217,F,45,7,10,94,-123,Severe
18,10,226,F,73,10,6,126,-100,Severe
9,10,118,F,96,12,10,154,36,Well
8,4,100,M,96,12,10,154,54,Well
6,9,81,F,56,8,9,105,24,Well
17,4,208,M,15,5,11,71,-137,Severe
11,8,140,F,26,6,6,78,-62,Severe
10,6,126,F,62,9,4,112,-14,Severe
15,8,188,M,49,8,2,98,-90,Severe
14,10,178,F,2,5,3,63,-115,Severe
15,10,190,M,54,8,7,103,-87,Severe
9,6,114,M,82,11,5,137,23,Well
17,11,215,M,24,6,5,77,-138,Severe
12,8,152,M,35,7,1,85,-67,Severe
15,1,181,F,70,10,2,122,-59,Severe
12,7,151,F,24,6,5,77,-74,Severe
15,7,187,M,17,6,0,72,-115,Severe
18,5,221,F,82,11,5,137,-84,Severe
14,6,174,M,43,7,8,92,-82,Severe
15,5,185,F,34,7,0,84,-101,Severe
5,11,71,F,31,6,9,81,10,Well
15,10,190,F,58,9,0,108,-82,Severe
16,5,197,M,43,7,8,92,-105,Severe
9,5,113,M,108,14,0,168,55,Well
11,9,141,M,30,6,9,81,-60,Severe
14,0,168,M,48,8,1,97,-71,Severe
13,3,159,M,16,5,11,71,-88,Severe
18,5,221,M,24,6,5,77,-144,Severe
16,8,200,F,4,5,4,64,-136,Severe
5,8,68,M,79,11,1,133,65,Well
13,3,159,M,47,8,0,96,-63,Severe
10,3,123,F,16,5,11,71,-52,Severe
12,2,146,F,12,5,9,69,-77,Severe
16,4,196,F,71,10,3,123,-73,Severe
8,0,96,M,91,12,4,148,52,Well
14,10,178,M,8,5,6,66,-112,Severe
14,3,171,F,62,9,4,112,-59,Severe
11,3,135,M,13,5,9,69,-66,Severe
9,11,119,F,26,6,6,78,-41,Severe
6,10,82,M,28,6,8,80,-2,Mild
17,7,211,F,39,7,5,89,-122,Severe
13,9,165,F,57,8,10,106,-59,Severe
13,3,159,F,37,7,3,87,-72,Severe
15,5,185,F,70,10,2,122,-63,Severe
10,5,125,M,2,5,3,63,-62,Severe
6,10,82,M,53,8,6,102,20,Well
11,11,143,M,14,5,10,70,-73,Severe
7,6,90,F,40,7,5,89,-1,Mild
10,11,131,F,81,11,4,136,5,Good
7,10,94,M,62,9,4,112,18,Well
5,3,63,M,4,5,4,64,1,Good
6,0,72,F,2,5,3,63,-9,Severe
9,3,111,M,22,6,3,75,-36,Severe
16,3,195,F,97,12,11,155,-40,Severe
5,6,66,F,108,14,0,168,102,Well
10,1,121,F,99,13,1,157,36,Well
15,0,180,F,44,7,9,93,-87,Severe
9,0,108,F,70,10,2,122,14,Well
9,9,117,F,106,13,10,166,49,Well
10,7,127,F,71,10,3,123,-4,Mild
10,3,123,M,90,12,3,147,24,Well
14,4,172,F,44,7,9,93,-79,Severe
8,3,99,F,97,12,11,155,56,Well
17,0,204,M,14,5,10,70,-134,Severe
9,4,112,M,10,5,7,67,-45,Severe
10,11,131,F,51,8,4,100,-31,Severe
11,7,139,F,107,13,11,167,28,Well
6,6,78,F,2,5,3,63,-15,Severe
11,5,137,F,69,10,1,121,-16,Severe
10,4,124,M,99,13,1,157,33,Well
14,2,170,M,107,13,11,167,-3,Mild
18,11,227,M,51,8,4,100,-127,Severe
18,11,227,M,47,8,0,96,-131,Severe
16,2,194,F,103,13,6,162,-32,Severe
14,7,175,F,75,10,9,129,-46,Severe
14,7,175,M,54,8,7,103,-72,Severe
5,10,70,F,96,12,10,154,84,Well
17,2,206,M,15,5,11,71,-135,Severe
15,7,187,M,25,6,5,77,-110,Severe
15,3,183,F,68,10,0,120,-63,Severe
9,6,114,M,97,12,11,155,41,Well
18,9,225,F,25,6,5,77,-148,Severe
14,5,173,M,110,14,3,171,-2,Mild
6,0,72,M,73,10,6,126,54,Well
18,1,217,F,38,7,4,88,-129,Severe
7,10,94,F,8,5,6,66,-28,Severe
9,3,111,F,53,8,6,102,-9,Severe
13,4,160,F,83,11,6,138,-22,Severe
18,5,221,M,82,11,5,137,-84,Severe
11,0,132,F,24,6,5,77,-55,Severe
16,6,198,M,2,5,3,63,-135,Severe
13,3,159,M,89,12,1,145,-14,Severe
6,3,75,M,9,5,7,67,-8,Severe
13,1,157,F,109,14,1,169,12,Well
7,2,86,F,56,8,9,105,19,Well
15,9,189,M,19,6,1,73,-116,Severe
11,4,136,F,20,6,2,74,-62,Severe
9,9,117,F,21,6,2,74,-43,Severe
12,6,150,F,68,10,0,120,-30,Severe
15,11,191,F,73,10,6,126,-65,Severe
5,2,62,M,57,8,10,106,44,Well
11,2,134,F,66,9,9,117,-17,Severe
7,3,87,F,67,9,10,118,31,Well
8,11,107,F,97,12,11,155,48,Well
9,3,111,M,77,10,11,131,20,Well
5,7,67,M,50,8,3,99,32,Well
18,3,219,F,81,11,4,136,-83,Severe
5,3,63,M,17,6,0,72,9,Well
8,6,102,M,76,10,10,130,28,Well
12,7,151,M,29,6,8,80,-71,Severe
15,0,180,M,25,6,5,77,-103,Severe
10,3,123,M,84,11,7,139,16,Well
15,2,182,M,25,6,5,77,-105,Severe
12,6,150,M,57,8,10,106,-44,Severe
17,9,213,M,86,11,10,142,-71,Severe
13,7,163,F,27,6,7,79,-84,Severe
12,10,154,M,76,10,10,130,-24,Severe
11,2,134,F,37,7,3,87,-47,Severe
11,2,134,F,7,5,6,66,-68,Severe
15,4,184,M,25,6,5,77,-107,Severe
7,4,88,F,23,6,4,76,-12,Severe
9,3,111,M,105,13,9,165,54,Well
9,8,116,M,99,13,1,157,41,Well
6,4,76,M,59,9,1,109,33,Well
14,5,173,F,42,7,7,91,-82,Severe
8,0,96,M,49,8,2,98,2,Good
8,3,99,F,38,7,4,88,-11,Severe
18,2,218,M,65,9,8,116,-102,Severe
12,5,149,M,70,10,2,122,-27,Severe
15,1,181,M,89,12,1,145,-36,Severe
11,2,134,F,68,10,0,120,-14,Severe
11,8,140,F,30,6,9,81,-59,Severe
17,1,205,M,109,14,1,169,-36,Severe
8,11,107,M,106,13,10,166,59,Well
18,6,222,F,55,8,8,104,-118,Severe
9,3,111,M,27,6,7,79,-32,Severe
9,0,108,M,47,8,0,96,-12,Severe
16,3,195,F,64,9,7,115,-80,Severe
16,6,198,M,18,6,1,73,-125,Severe
17,10,214,F,65,9,8,116,-98,Severe
12,4,148,M,53,8,6,102,-46,Severe
5,4,64,M,71,10,3,123,59,Well
6,0,72,F,11,5,8,68,-4,Mild
8,5,101,M,37,7,3,87,-14,Severe
15,7,187,M,36,7,2,86,-101,Severe
18,7,223,M,72,10,4,124,-99,Severe
6,7,79,M,86,11,10,142,63,Well
11,8,140,F,52,8,5,101,-39,Severe
6,2,74,F,44,7,9,93,19,Well
5,3,63,F,61,9,3,111,48,Well
5,10,70,F,24,6,5,77,7,Well
7,10,94,M,51,8,4,100,6,Well
9,6,114,F,67,9,10,118,4,Good
17,0,204,M,88,12,0,144,-60,Severe
10,7,127,F,59,9,1,109,-18,Severe
10,3,123,F,67,9,10,118,-5,Mild
15,3,183,M,44,7,9,93,-90,Severe
11,10,142,M,34,7,0,84,-58,Severe
18,3,219,M,42,7,7,91,-128,Severe
14,5,173,M,70,10,2,122,-51,Severe
17,8,212,M,57,8,10,106,-106,Severe
8,11,107,M,87,11,11,143,36,Well
10,8,128,M,43,7,8,92,-36,Severe
15,5,185,M,81,11,4,136,-49,Severe
10,4,124,M,59,9,1,109,-15,Severe
14,10,178,F,75,10,9,129,-49,Severe
10,0,120,F,74,10,7,127,7,Well
13,9,165,F,69,10,1,121,-44,Severe
5,5,65,F,39,7,5,89,24,Well
12,10,154,M,102,13,6,162,8,Well
11,9,141,F,34,7,0,84,-57,Severe
18,1,217,F,89,12,1,145,-72,Severe
6,3,75,M,66,9,9,117,42,Well
15,0,180,M,53,8,6,102,-78,Severe
8,1,97,M,87,11,11,143,46,Well
7,4,88,F,5,5,5,65,-23,Severe
18,10,226,M,10,5,7,67,-159,Severe
7,0,84,F,62,9,4,112,28,Well
10,10,130,M,27,6,7,79,-51,Severe
7,11,95,F,65,9,8,116,21,Well
7,5,89,F,101,13,4,160,71,Well
14,8,176,M,55,8,8,104,-72,Severe
5,4,64,M,93,12,6,150,86,Well
14,1,169,F,25,6,5,77,-92,Severe
15,7,187,F,100,13,3,159,-28,Severe
15,9,189,M,62,9,4,112,-77,Severe
6,8,80,F,85,11,9,141,61,Well
9,9,117,F,55,8,8,104,-13,Severe
5,1,61,M,53,8,6,102,41,Well
10,10,130,F,108,14,0,168,38,Well
11,10,142,F,61,9,3,111,-31,Severe
9,8,116,M,97,12,11,155,39,Well
12,11,155,F,76,10,10,130,-25,Severe
9,2,110,F,108,14,0,168,58,Well
7,5,89,F,73,10,6,126,37,Well
17,11,215,F,2,5,3,63,-152,Severe
8,6,102,F,96,12,10,154,52,Well
7,9,93,F,35,7,1,85,-8,Severe
5,4,64,M,69,10,1,121,57,Well
12,11,155,M,61,9,3,111,-44,Severe
16,10,202,F,41,7,6,90,-112,Severe
12,10,154,M,81,11,4,136,-18,Severe
18,11,227,M,9,5,7,67,-160,Severe
8,6,102,F,74,10,7,127,25,Well
8,0,96,M,3,5,3,63,-33,Severe
17,7,211,F,4,5,4,64,-147,Severe
18,9,225,M,36,7,2,86,-139,Severe
9,4,112,F,86,11,10,142,30,Well
12,7,151,M,93,12,6,150,-1,Mild
5,6,66,F,58,9,0,108,42,Well
11,6,138,M,107,13,11,167,29,Well
16,11,203,F,67,9,10,118,-85,Severe
18,6,222,F,11,5,8,68,-154,Severe
8,1,97,M,7,5,6,66,-31,Severe
17,7,211,F,90,12,3,147,-64,Severe
13,10,166,M,96,12,10,154,-12,Severe
7,4,88,M,20,6,2,74,-14,Severe
16,0,192,M,25,6,5,77,-115,Severe
16,9,201,M,54,8,7,103,-98,Severe
11,3,135,F,95,12,9,153,18,Well
8,9,105,M,75,10,9,129,24,Well
8,7,103,M,57,8,10,106,3,Good
14,0,168,M,71,10,3,123,-45,Severe
13,7,163,M,109,14,1,169,6,Well
13,8,164,M,29,6,8,80,-84,Severe
5,7,67,M,72,10,4,124,57,Well
9,7,115,F,82,11,5,137,22,Well
10,5,125,M,108,14,0,168,43,Well
10,9,129,F,9,5,7,67,-62,Severe
11,3,135,F,5,5,5,65,-70,Severe
18,8,224,F,74,10,7,127,-97,Severe
12,11,155,M,21,6,2,74,-81,Severe
11,5,137,F,22,6,3,75,-62,Severe
18,11,227,M,78,11,0,132,-95,Severe
8,10,106,F,25,6,5,77,-29,Severe
17,10,214,M,88,12,0,144,-70,Severe
11,3,135,M,26,6,6,78,-57,Severe
6,8,80,F,65,9,8,116,36,Well
7,2,86,F,18,6,1,73,-13,Severe
16,5,197,F,4,5,4,64,-133,Severe
9,10,118,M,40,7,5,89,-29,Severe
12,3,147,M,87,11,11,143,-4,Mild
6,5,77,M,10,5,7,67,-10,Severe
15,2,182,F,107,13,11,167,-15,Severe
7,10,94,F,63,9,6,114,20,Well
7,3,87,M,87,11,11,143,56,Well
17,3,207,F,79,11,1,133,-74,Severe
6,11,83,M,24,6,5,77,-6,Severe
17,9,213,F,73,10,6,126,-87,Severe
12,3,147,F,95,12,9,153,6,Well
10,7,127,F,24,6,5,77,-50,Severe
11,0,132,M,107,13,11,167,35,Well
18,1,217,M,28,6,8,80,-137,Severe
6,11,83,F,73,10,6,126,43,Well
14,5,173,M,36,7,2,86,-87,Severe
14,8,176,F,46,7,11,95,-81,Severe
5,7,67,F,69,10,1,121,54,Well
5,8,68,M,50,8,3,99,31,Well
8,2,98,F,15,5,11,71,-27,Severe
5,9,69,F,11,5,8,68,-1,Mild
11,0,132,F,108,14,0,168,36,Well
7,10,94,F,14,5,10,70,-24,Severe
7,1,85,F,92,12,5,149,64,Well
7,2,86,M,70,10,2,122,36,Well
14,6,174,F,93,12,6,150,-24,Severe
11,0,132,M,30,6,9,81,-51,Severe
8,2,98,F,93,12,6,150,52,Well
18,2,218,M,15,5,11,71,-147,Severe
18,5,221,F,95,12,9,153,-68,Severe
18,3,219,F,58,9,0,108,-111,Severe
5,7,67,M,43,7,8,92,25,Well
13,2,158,M,12,5,9,69,-89,Severe
18,8,224,F,10,5,7,67,-157,Severe
6,9,81,M,109,14,1,169,88,Well
10,1,121,F,12,5,9,69,-52,Severe
13,5,161,F,20,6,2,74,-87,Severe
13,8,164,M,10,5,7,67,-97,Severe
17,8,212,F,86,11,10,142,-70,Severe
11,7,139,M,52,8,5,101,-38,Severe
15,1,181,M,65,9,8,116,-65,Severe
13,0,156,M,98,13,0,156,0,Neutral
16,3,195,M,35,7,1,85,-110,Severe
13,4,160,F,92,12,5,149,-11,Severe
6,5,77,F,91,12,4,148,71,Well
18,5,221,M,39,7,5,89,-132,Severe
7,5,89,F,47,8,0,96,7,Well
17,11,215,M,6,5,5,65,-150,Severe
7,6,90,F,20,6,2,74,-16,Severe
8,5,101,M,69,10,1,121,20,Well
8,11,107,M,15,5,11,71,-36,Severe
16,4,196,M,64,9,7,115,-81,Severe
12,11,155,F,81,11,4,136,-19,Severe
16,8,200,M,24,6,5,77,-123,Severe
16,1,193,F,101,13,4,160,-33,Severe
14,6,174,F,82,11,5,137,-37,Severe
15,8,188,F,98,13,0,156,-32,Severe
10,7,127,F,39,7,5,89,-38,Severe
9,3,111,M,91,12,4,148,37,Well
18,8,224,M,82,11,5,137,-87,Severe
11,2,134,M,94,12,7,151,17,Well
18,8,224,M,98,13,0,156,-68,Severe
9,5,113,F,73,10,6,126,13,Well
12,3,147,F,19,6,1,73,-74,Severe
15,6,186,M,81,11,4,136,-50,Severe
10,8,128,M,50,8,3,99,-29,Severe
18,11,227,F,3,5,3,63,-164,Severe
6,3,75,F,20,6,2,74,-1,Mild
11,2,134,M,8,5,6,66,-68,Severe
16,9,201,F,4,5,4,64,-137,Severe
13,7,163,F,93,12,6,150,-13,Severe
9,3,111,M,33,6,11,83,-28,Severe
10,8,128,F,38,7,4,88,-40,Severe
16,1,193,M,54,8,7,103,-90,Severe
5,9,69,M,98,13,0,156,87,Well
12,5,149,M,21,6,2,74,-75,Severe
7,9,93,F,28,6,8,80,-13,Severe
5,9,69,F,87,11,11,143,74,Well
13,9,165,M,82,11,5,137,-28,Severe
15,11,191,M,19,6,1,73,-118,Severe
13,10,166,F,110,14,3,171,5,Good
11,11,143,M,28,6,8,80,-63,Severe
8,5,101,F,39,7,5,89,-12,Severe
11,3,135,M,91,12,4,148,13,Well
7,6,90,M,26,6,6,78,-12,Severe
11,2,134,F,107,13,11,167,33,Well
6,8,80,M,19,6,1,73,-7,Severe
8,2,98,F,69,10,1,121,23,Well
9,6,114,M,56,8,9,105,-9,Severe
8,4,100,M,45,7,10,94,-6,Severe
10,1,121,F,72,10,4,124,3,Good
17,3,207,M,56,8,9,105,-102,Severe
16,0,192,M,107,13,11,167,-25,Severe
7,7,91,F,16,5,11,71,-20,Severe
13,8,164,M,93,12,6,150,-14,Severe
6,3,75,M,66,9,9,117,42,Well
6,0,72,M,69,10,1,121,49,Well
12,4,148,M,104,13,7,163,15,Well
16,8,200,M,34,7,0,84,-116,Severe
8,0,96,F,94,12,7,151,55,Well
9,1,109,M,17,6,0,72,-37,Severe
11,2,134,M,39,7,5,89,-45,Severe
7,0,84,M,53,8,6,102,18,Well
7,4,88,M,90,12,3,147,59,Well
15,11,191,M,72,10,4,124,-67,Severe
10,2,122,F,62,9,4,112,-10,Severe
5,6,66,F,107,13,11,167,101,Well
14,3,171,M,59,9,1,109,-62,Severe
5,10,70,M,38,7,4,88,18,Well
7,9,93,F,77,10,11,131,38,Well
8,6,102,M,15,5,11,71,-31,Severe
5,1,61,F,70,10,2,122,61,Well
11,6,138,F,95,12,9,153,15,Well
9,10,118,M,84,11,7,139,21,Well
18,1,217,M,67,9,10,118,-99,Severe
6,4,76,F,100,13,3,159,83,Well
7,11,95,M,54,8,7,103,8,Well
17,1,205,F,44,7,9,93,-112,Severe
8,3,99,M,60,9,2,110,11,Well
11,0,132,M,21,6,2,74,-58,Severe
9,0,108,F,81,11,4,136,28,Well
7,9,93,F,98,13,0,156,63,Well
13,9,165,F,54,8,7,103,-62,Severe
9,6,114,M,14,5,10,70,-44,Severe
5,3,63,F,81,11,4,136,73,Well
7,11,95,F,89,12,1,145,50,Well
8,7,103,F,73,10,6,126,23,Well
16,3,195,M,99,13,1,157,-38,Severe
10,3,123,M,78,11,0,132,9,Well
18,7,223,M,93,12,6,150,-73,Severe
9,10,118,M,60,9,2,110,-8,Severe
7,9,93,F,73,10,6,126,33,Well
5,8,68,F,35,7,1,85,17,Well
18,10,226,M,110,14,3,171,-55,Severe
16,10,202,M,3,5,3,63,-139,Severe
9,6,114,F,48,8,1,97,-17,Severe
9,0,108,F,78,11,0,132,24,Well
14,3,171,F,88,12,0,144,-27,Severe
12,11,155,F,65,9,8,116,-39,Severe
7,0,84,M,110,14,3,171,87,Well
12,8,152,M,22,6,3,75,-77,Severe
11,3,135,M,65,9,8,116,-19,Severe
13,2,158,M,74,10,7,127,-31,Severe
13,1,157,M,96,12,10,154,-3,Mild
15,7,187,M,103,13,6,162,-25,Severe
17,8,212,F,73,10,6,126,-86,Severe
11,9,141,F,39,7,5,89,-52,Severe
9,3,111,F,64,9,7,115,4,Good
15,11,191,F,5,5,5,65,-126,Severe
17,8,212,F,30,6,9,81,-131,Severe
6,3,75,F,36,7,2,86,11,Well
7,4,88,F,29,6,8,80,-8,Severe
5,10,70,M,60,9,2,110,40,Well
14,9,177,F,79,11,1,133,-44,Severe
12,9,153,M,69,10,1,121,-32,Severe
9,4,112,F,24,6,5,77,-35,Severe
15,10,190,F,87,11,11,143,-47,Severe
13,7,163,F,57,8,10,106,-57,Severe
6,11,83,F,106,13,10,166,83,Well
14,2,170,F,72,10,4,124,-46,Severe
17,4,208,F,50,8,3,99,-109,Severe
8,8,104,F,4,5,4,64,-40,Severe
9,5,113,M,55,8,8,104,-9,Severe
11,1,133,F,62,9,4,112,-21,Severe
18,0,216,F,29,6,8,80,-136,Severe
17,3,207,M,93,12,6,150,-57,Severe
16,11,203,M,8,5,6,66,-137,Severe
6,3,75,M,31,6,9,81,6,Well
13,3,159,M,76,10,10,130,-29,Severe
10,1,121,F,43,7,8,92,-29,Severe
18,9,225,M,69,10,1,121,-104,Severe
6,9,81,F,69,10,1,121,40,Well
11,2,134,F,52,8,5,101,-33,Severe
15,6,186,F,10,5,7,67,-119,Severe
9,4,112,F,83,11,6,138,26,Well
5,9,69,F,39,7,5,89,20,Well
6,6,78,M,98,13,0,156,78,Well
6,9,81,M,98,13,0,156,75,Well
15,1,181,M,91,12,4,148,-33,Severe
8,0,96,F,76,10,10,130,34,Well
18,11,227,F,49,8,2,98,-129,Severe
17,3,207,M,102,13,6,162,-45,Severe
18,2,218,F,32,6,10,82,-136,Severe
16,11,203,F,87,11,11,143,-60,Severe
16,3,195,M,107,13,11,167,-28,Severe
10,2,122,M,55,8,8,104,-18,Severe
6,10,82,F,39,7,5,89,7,Well
14,10,178,F,10,5,7,67,-111,Severe
12,4,148,F,81,11,4,136,-12,Severe
12,2,146,M,102,13,6,162,16,Well
11,3,135,F,24,6,5,77,-58,Severe
17,6,210,M,45,7,10,94,-116,Severe
18,3,219,M,88,12,0,144,-75,Severe
8,1,97,M,37,7,3,87,-10,Severe
13,7,163,M,44,7,9,93,-70,Severe
12,3,147,F,96,12,10,154,7,Well
16,8,200,F,110,14,3,171,-29,Severe
12,7,151,M,63,9,6,114,-37,Severe
6,5,77,M,30,6,9,81,4,Good
16,1,193,M,30,6,9,81,-112,Severe
12,2,146,M,15,5,11,71,-75,Severe
13,11,167,M,28,6,8,80,-87,Severe
6,2,74,F,47,8,0,96,22,Well
15,4,184,M,89,12,1,145,-39,Severe
5,10,70,F,53,8,6,102,32,Well
16,5,197,M,42,7,7,91,-106,Severe
15,3,183,M,63,9,6,114,-69,Severe
14,3,171,F,15,5,11,71,-100,Severe
6,11,83,M,30,6,9,81,-2,Mild
8,0,96,F,105,13,9,165,69,Well
7,0,84,M,74,10,7,127,43,Well
17,4,208,M,55,8,8,104,-104,Severe
10,5,125,F,34,7,0,84,-41,Severe
8,8,104,F,70,10,2,122,18,Well
14,4,172,F,52,8,5,101,-71,Severe
7,9,93,F,95,12,9,153,60,Well
18,8,224,F,105,13,9,165,-59,Severe
15,2,182,M,87,11,11,143,-39,Severe
18,2,218,M,27,6,7,79,-139,Severe
6,10,82,F,8,5,6,66,-16,Severe
9,1,109,M,41,7,6,90,-19,Severe
12,10,154,F,64,9,7,115,-39,Severe
12,6,150,F,86,11,10,142,-8,Severe
5,10,70,M,47,8,0,96,26,Well
15,3,183,M,17,6,0,72,-111,Severe
15,3,183,M,86,11,10,142,-41,Severe
14,7,175,F,110,14,3,171,-4,Mild
5,1,61,M,21,6,2,74,13,Well
18,4,220,F,73,10,6,126,-94,Severe
8,10,106,M,34,7,0,84,-22,Severe
16,0,192,F,72,10,4,124,-68,Severe
17,7,211,F,75,10,9,129,-82,Severe
17,3,207,M,8,5,6,66,-141,Severe
9,8,116,M,30,6,9,81,-35,Severe
18,3,219,F,13,5,9,69,-150,Severe
13,4,160,M,73,10,6,126,-34,Severe
16,7,199,F,36,7,2,86,-113,Severe
18,4,220,M,35,7,1,85,-135,Severe
14,5,173,M,49,8,2,98,-75,Severe
8,3,99,M,91,12,4,148,49,Well
18,10,226,F,65,9,8,116,-110,Severe
14,10,178,M,59,9,1,109,-69,Severe
12,10,154,F,98,13,0,156,2,Good
11,7,139,M,19,6,1,73,-66,Severe
14,3,171,M,30,6,9,81,-90,Severe
16,8,200,M,105,13,9,165,-35,Severe
18,11,227,M,35,7,1,85,-142,Severe
9,2,110,M,39,7,5,89,-21,Severe
8,1,97,M,82,11,5,137,40,Well
15,1,181,M,101,13,4,160,-21,Severe
16,10,202,F,32,6,10,82,-120,Severe
6,0,72,M,63,9,6,114,42,Well
9,2,110,F,48,8,1,97,-13,Severe
7,0,84,M,50,8,3,99,15,Well
10,2,122,M,8,5,6,66,-56,Severe
7,9,93,M,91,12,4,148,55,Well
16,7,199,M,107,13,11,167,-32,Severe
5,2,62,M,6,5,5,65,3,Good
6,0,72,F,38,7,4,88,16,Well
17,1,205,M,58,9,0,108,-97,Severe
16,3,195,M,2,5,3,63,-132,Severe
15,3,183,F,19,6,1,73,-110,Severe
14,5,173,F,54,8,7,103,-70,Severe
9,5,113,F,32,6,10,82,-31,Severe
11,3,135,F,43,7,8,92,-43,Severe
12,2,146,F,13,5,9,69,-77,Severe
11,4,136,M,56,8,9,105,-31,Severe
10,4,124,F,69,10,1,121,-3,Mild
10,6,126,F,39,7,5,89,-37,Severe
11,9,141,M,86,11,10,142,1,Good
11,1,133,F,67,9,10,118,-15,Severe
17,7,211,M,21,6,2,74,-137,Severe
11,3,135,M,30,6,9,81,-54,Severe
10,1,121,F,95,12,9,153,32,Well
18,2,218,F,55,8,8,104,-114,Severe
8,2,98,F,28,6,8,80,-18,Severe
6,6,78,F,59,9,1,109,31,Well
5,5,65,M,74,10,7,127,62,Well
16,7,199,M,82,11,5,137,-62,Severe
15,10,190,F,51,8,4,100,-90,Severe
12,6,150,M,27,6,7,79,-71,Severe
13,8,164,F,78,11,0,132,-32,Severe
9,10,118,F,15,5,11,71,-47,Severe
6,5,77,F,42,7,7,91,14,Well
13,3,159,M,89,12,1,145,-14,Severe
11,6,138,M,98,13,0,156,18,Well
10,4,124,F,4,5,4,64,-60,Severe
16,0,192,M,47,8,0,96,-96,Severe
13,9,165,F,103,13,6,162,-3,Mild
6,1,73,M,33,6,11,83,10,Well
5,10,70,F,20,6,2,74,4,Good
5,8,68,M,52,8,5,101,33,Well
6,4,76,F,93,12,6,150,74,Well
6,0,72,F,44,7,9,93,21,Well
9,0,108,F,50,8,3,99,-9,Severe
18,0,216,F,4,5,4,64,-152,Severe
9,9,117,F,86,11,10,142,25,Well
16,9,201,M,68,10,0,120,-81,Severe
16,1,193,F,107,13,11,167,-26,Severe
11,11,143,M,17,6,0,72,-71,Severe
7,0,84,F,42,7,7,91,7,Well
6,0,72,F,26,6,6,78,6,Well
5,7,67,F,62,9,4,112,45,Well
14,2,170,F,21,6,2,74,-96,Severe
7,7,91,M,25,6,5,77,-14,Severe
6,1,73,F,4,5,4,64,-9,Severe
17,9,213,F,64,9,7,115,-98,Severe
6,8,80,M,56,8,9,105,25,Well
17,0,204,F,66,9,9,117,-87,Severe
8,3,99,F,94,12,7,151,52,Well
5,4,64,F,35,7,1,85,21,Well
6,0,72,M,9,5,7,67,-5,Mild
12,6,150,M,93,12,6,150,0,Neutral
14,8,176,F,10,5,7,67,-109,Severe
13,4,160,M,23,6,4,76,-84,Severe
15,6,186,M,32,6,10,82,-104,Severe
10,6,126,F,16,5,11,71,-55,Severe
5,2,62,M,52,8,5,101,39,Well
15,11,191,F,63,9,6,114,-77,Severe
6,0,72,F,5,5,5,65,-7,Severe
14,10,178,M,57,8,10,106,-72,Severe
5,9,69,M,45,7,10,94,25,Well
10,4,124,F,26,6,6,78,-46,Severe
5,8,68,F,72,10,4,124,56,Well
16,3,195,M,82,11,5,137,-58,Severe
16,4,196,M,53,8,6,102,-94,Severe
9,3,111,F,14,5,10,70,-41,Severe
17,10,214,M,75,10,9,129,-85,Severe
11,3,135,M,12,5,9,69,-66,Severe
15,0,180,F,42,7,7,91,-89,Severe
7,5,89,F,62,9,4,112,23,Well
18,10,226,M,90,12,3,147,-79,Severe
12,3,147,M,79,11,1,133,-14,Severe
13,1,157,M,15,5,11,71,-86,Severe
5,3,63,M,16,5,11,71,8,Well
16,9,201,F,23,6,4,76,-125,Severe
7,3,87,F,75,10,9,129,42,Well
8,7,103,M,98,13,0,156,53,Well
14,4,172,F,54,8,7,103,-69,Severe
8,4,100,F,45,7,10,94,-6,Severe
6,0,72,M,67,9,10,118,46,Well
12,8,152,M,19,6,1,73,-79,Severe
10,4,124,F,48,8,1,97,-27,Severe
11,5,137,F,6,5,5,65,-72,Severe
15,5,185,F,17,6,0,72,-113,Severe
9,3,111,F,17,6,0,72,-39,Severe
12,3,147,F,30,6,9,81,-66,Severe
16,6,198,F,27,6,7,79,-119,Severe
7,0,84,F,6,5,5,65,-19,Severe
18,9,225,M,57,8,10,106,-119,Severe
16,2,194,M,36,7,2,86,-108,Severe
10,2,122,M,69,10,1,121,-1,Mild
7,7,91,M,34,7,0,84,-7,Severe
18,8,224,F,29,6,8,80,-144,Severe
6,7,79,F,72,10,4,124,45,Well
13,5,161,M,60,9,2,110,-51,Severe
14,3,171,M,86,11,10,142,-29,Severe
8,4,100,F,25,6,5,77,-23,Severe
5,4,64,F,7,5,6,66,2,Good
12,0,144,F,85,11,9,141,-3,Mild
11,1,133,F,104,13,7,163,30,Well
15,0,180,M,59,9,1,109,-71,Severe
15,5,185,F,44,7,9,93,-92,Severe
10,8,128,F,100,13,3,159,31,Well
13,4,160,F,63,9,6,114,-46,Severe
8,3,99,M,12,5,9,69,-30,Severe
12,4,148,M,32,6,10,82,-66,Severe
13,2,158,M,106,13,10,166,8,Well
10,4,124,M,3,5,3,63,-61,Severe
11,3,135,F,66,9,9,117,-18,Severe
9,10,118,F,64,9,7,115,-3,Mild
14,1,169,F,38,7,4,88,-81,Severe
11,1,133,M,56,8,9,105,-28,Severe
17,4,208,F,48,8,1,97,-111,Severe
13,3,159,F,43,7,8,92,-67,Severe
8,1,97,F,84,11,7,139,42,Well
15,5,185,M,14,5,10,70,-115,Severe
16,8,200,M,108,14,0,168,-32,Severe
15,2,182,F,31,6,9,81,-101,Severe
5,10,70,M,27,6,7,79,9,Well
16,11,203,F,85,11,9,141,-62,Severe
16,8,200,F,24,6,5,77,-123,Severe
18,11,227,M,50,8,3,99,-128,Severe
16,5,197,F,45,7,10,94,-103,Severe
12,11,155,M,8,5,6,66,-89,Severe
17,7,211,F,54,8,7,103,-108,Severe
10,1,121,M,82,11,5,137,16,Well
6,8,80,F,97,12,11,155,75,Well
5,4,64,M,11,5,8,68,4,Good
18,7,223,M,40,7,5,89,-134,Severe
17,10,214,M,77,10,11,131,-83,Severe
11,11,143,F,76,10,10,130,-13,Severe
7,6,90,M,62,9,4,112,22,Well
17,7,211,M,76,10,10,130,-81,Severe
6,7,79,M,35,7,1,85,6,Well
15,6,186,M,12,5,9,69,-117,Severe
10,5,125,M,11,5,8,68,-57,Severe
10,7,127,F,4,5,4,64,-63,Severe
8,5,101,F,80,11,3,135,34,Well
5,7,67,F,97,12,11,155,88,Well
12,3,147,M,54,8,7,103,-44,Severe
16,7,199,M,41,7,6,90,-109,Severe
16,9,201,M,73,10,6,126,-75,Severe
7,9,93,F,16,5,11,71,-22,Severe
14,0,168,M,58,9,0,108,-60,Severe
13,3,159,F,51,8,4,100,-59,Severe
18,6,222,M,57,8,10,106,-116,Severe
16,4,196,F,29,6,8,80,-116,Severe
16,2,194,F,16,5,11,71,-123,Severe
16,3,195,F,87,11,11,143,-52,Severe
6,5,77,M,82,11,5,137,60,Well
15,3,183,M,2,5,3,63,-120,Severe
16,3,195,F,35,7,1,85,-110,Severe
18,5,221,F,23,6,4,76,-145,Severe
16,11,203,M,38,7,4,88,-115,Severe
12,2,146,M,28,6,8,80,-66,Severe
6,9,81,M,49,8,2,98,17,Well
5,10,70,F,86,11,10,142,72,Well
16,4,196,M,76,10,10,130,-66,Severe
13,4,160,F,90,12,3,147,-13,Severe
7,2,86,F,41,7,6,90,4,Good
13,6,162,F,46,7,11,95,-67,Severe
7,1,85,F,62,9,4,112,27,Well
11,1,133,F,16,5,11,71,-62,Severe
14,8,176,F,51,8,4,100,-76,Severe
16,8,200,M,47,8,0,96,-104,Severe
8,10,106,F,76,10,10,130,24,Well
17,3,207,M,18,6,1,73,-134,Severe
7,11,95,F,57,8,10,106,11,Well
15,6,186,M,9,5,7,67,-119,Severe
6,5,77,M,93,12,6,150,73,Well
7,10,94,M,100,13,3,159,65,Well
5,2,62,M,76,10,10,130,68,Well
17,3,207,F,86,11,10,142,-65,Severe
10,6,126,F,58,9,0,108,-18,Severe
8,6,102,F,42,7,7,91,-11,Severe
9,5,113,M,52,8,5,101,-12,Severe
11,10,142,F,54,8,7,103,-39,Severe
16,4,196,F,89,12,1,145,-51,Severe
5,1,61,F,29,6,8,80,19,Well
10,2,122,F,74,10,7,127,5,Good
12,3,147,M,90,12,3,147,0,Neutral
17,3,207,F,52,8,5,101,-106,Severe
13,1,157,M,2,5,3,63,-94,Severe
8,6,102,M,2,5,3,63,-39,Severe
5,9,69,F,55,8,8,104,35,Well
15,6,186,M,82,11,5,137,-49,Severe
16,5,197,M,103,13,6,162,-35,Severe
18,6,222,F,34,7,0,84,-138,Severe
7,3,87,F,53,8,6,102,15,Well
13,5,161,F,91,12,4,148,-13,Severe
6,8,80,M,58,9,0,108,28,Well
12,4,148,M,24,6,5,77,-71,Severe
5,9,69,F,88,12,0,144,75,Well
17,2,206,M,78,11,0,132,-74,Severe
10,8,128,F,7,5,6,66,-62,Severe
13,0,156,M,63,9,6,114,-42,Severe
15,3,183,F,85,11,9,141,-42,Severe
17,7,211,F,35,7,1,85,-126,Severe
9,5,113,F,48,8,1,97,-16,Severe
13,11,167,F,13,5,9,69,-98,Severe
11,0,132,M,45,7,10,94,-38,Severe
13,7,163,F,88,12,0,144,-19,Severe
7,2,86,M,42,7,7,91,5,Good
9,5,113,F,58,9,0,108,-5,Mild
11,9,141,M,26,6,6,78,-63,Severe
12,1,145,M,107,13,11,167,22,Well
10,7,127,F,91,12,4,148,21,Well
5,7,67,F,80,11,3,135,68,Well
8,0,96,M,5,5,5,65,-31,Severe
11,0,132,F,89,12,1,145,13,Well
9,8,116,M,62,9,4,112,-4,Mild
11,8,140,M,10,5,7,67,-73,Severe
9,10,118,F,42,7,7,91,-27,Severe
7,9,93,M,29,6,8,80,-13,Severe
14,4,172,F,95,12,9,153,-19,Severe
10,4,124,M,79,11,1,133,9,Well
5,6,66,F,70,10,2,122,56,Well
15,2,182,M,39,7,5,89,-93,Severe
5,0,60,M,75,10,9,129,69,Well
12,9,153,F,42,7,7,91,-62,Severe
12,3,147,F,75,10,9,129,-18,Severe
9,1,109,F,67,9,10,118,9,Well
18,6,222,M,23,6,4,76,-146,Severe
18,2,218,M,37,7,3,87,-131,Severe
18,9,225,F,77,10,11,131,-94,Severe
10,3,123,M,104,13,7,163,40,Well
16,2,194,F,11,5,8,68,-126,Severe
15,1,181,F,60,9,2,110,-71,Severe
18,4,220,F,45,7,10,94,-126,Severe
16,3,195,M,38,7,4,88,-107,Severe
8,11,107,M,57,8,10,106,-1,Mild
14,3,171,M,44,7,9,93,-78,Severe
6,3,75,M,11,5,8,68,-7,Severe
5,3,63,F,58,9,0,108,45,Well
18,4,220,F,107,13,11,167,-53,Severe
8,6,102,M,44,7,9,93,-9,Severe
7,5,89,M,10,5,7,67,-22,Severe
15,2,182,F,11,5,8,68,-114,Severe
7,3,87,F,97,12,11,155,68,Well
11,5,137,M,102,13,6,162,25,Well
5,9,69,M,60,9,2,110,41,Well
13,11,167,M,50,8,3,99,-68,Severe
9,0,108,M,98,13,0,156,48,Well
8,3,99,F,48,8,1,97,-2,Mild
10,6,126,F,108,14,0,168,42,Well
11,1,133,M,13,5,9,69,-64,Severe
14,10,178,F,65,9,8,116,-62,Severe
6,8,80,F,16,5,11,71,-9,Severe
14,2,170,M,95,12,9,153,-17,Severe
14,4,172,F,104,13,7,163,-9,Severe
15,8,188,M,63,9,6,114,-74,Severe
16,8,200,F,41,7,6,90,-110,Severe
8,3,99,M,13,5,9,69,-30,Severe
11,0,132,M,64,9,7,115,-17,Severe
8,7,103,M,107,13,11,167,64,Well
14,6,174,F,44,7,9,93,-81,Severe
13,4,160,M,107,13,11,167,7,Well
12,9,153,F,16,5,11,71,-82,Severe
11,0,132,F,43,7,8,92,-40,Severe
12,6,150,F,47,8,0,96,-54,Severe
15,0,180,F,76,10,10,130,-50,Severe
8,3,99,M,58,9,0,108,9,Well
16,9,201,M,108,14,0,168,-33,Severe
6,10,82,F,51,8,4,100,18,Well
10,9,129,F,88,12,0,144,15,Well
11,0,132,F,62,9,4,112,-20,Severe
9,5,113,F,43,7,8,92,-21,Severe
7,7,91,F,67,9,10,118,27,Well
5,8,68,M,41,7,6,90,22,Well
16,4,196,F,23,6,4,76,-120,Severe
11,4,136,F,85,11,9,141,5,Good
11,6,138,F,68,10,0,120,-18,Severe
7,7,91,M,27,6,7,79,-12,Severe
10,3,123,M,94,12,7,151,28,Well
5,10,70,F,28,6,8,80,10,Well
14,8,176,M,78,11,0,132,-44,Severe
5,0,60,M,38,7,4,88,28,Well
8,3,99,M,49,8,2,98,-1,Mild
6,6,78,M,18,6,1,73,-5,Mild
17,6,210,M,55,8,8,104,-106,Severe
10,7,127,F,78,11,0,132,5,Good
10,8,128,M,20,6,2,74,-54,Severe
10,5,125,F,97,12,11,155,30,Well
7,3,87,F,16,5,11,71,-16,Severe
9,10,118,M,32,6,10,82,-36,Severe
10,9,129,F,43,7,8,92,-37,Severe
14,1,169,M,100,13,3,159,-10,Severe
12,4,148,F,37,7,3,87,-61,Severe
9,4,112,M,63,9,6,114,2,Good
18,4,220,F,62,9,4,112,-108,Severe
12,3,147,F,17,6,0,72,-75,Severe
10,2,122,M,98,13,0,156,34,Well
9,4,112,F,29,6,8,80,-32,Severe
12,6,150,F,40,7,5,89,-61,Severe
14,11,179,M,93,12,6,150,-29,Severe
14,5,173,F,43,7,8,92,-81,Severe
13,7,163,M,62,9,4,112,-51,Severe
16,10,202,F,26,6,6,78,-124,Severe
12,10,154,M,6,5,5,65,-89,Severe
6,5,77,F,66,9,9,117,40,Well
11,5,137,M,87,11,11,143,6,Well
6,7,79,F,17,6,0,72,-7,Severe
8,5,101,M,9,5,7,67,-34,Severe
10,4,124,F,43,7,8,92,-32,Severe
11,0,132,M,42,7,7,91,-41,Severe
10,10,130,M,61,9,3,111,-19,Severe
7,6,90,F,32,6,10,82,-8,Severe
11,11,143,F,83,11,6,138,-5,Mild
16,1,193,F,69,10,1,121,-72,Severe
18,8,224,M,66,9,9,117,-107,Severe
17,10,214,M,44,7,9,93,-121,Severe
12,11,155,M,22,6,3,75,-80,Severe
13,3,159,F,87,11,11,143,-16,Severe
16,3,195,M,53,8,6,102,-93,Severe
6,3,75,M,92,12,5,149,74,Well
8,3,99,M,64,9,7,115,16,Well
17,3,207,F,87,11,11,143,-64,Severe
16,4,196,F,26,6,6,78,-118,Severe
16,3,195,M,59,9,1,109,-86,Severe
17,11,215,F,40,7,5,89,-126,Severe
15,11,191,M,17,6,0,72,-119,Severe
16,3,195,F,67,9,10,118,-77,Severe
13,11,167,F,69,10,1,121,-46,Severe
6,4,76,M,23,6,4,76,0,Neutral
7,8,92,F,89,12,1,145,53,Well
13,3,159,M,84,11,7,139,-20,Severe
16,2,194,F,87,11,11,143,-51,Severe
9,6,114,F,50,8,3,99,-15,Severe
18,7,223,M,13,5,9,69,-154,Severe
8,1,97,M,2,5,3,63,-34,Severe
8,7,103,F,81,11,4,136,33,Well
16,3,195,M,88,12,0,144,-51,Severe
14,11,179,M,47,8,0,96,-83,Severe
6,1,73,F,58,9,0,108,35,Well
18,5,221,F,20,6,2,74,-147,Severe
11,8,140,M,100,13,3,159,19,Well
17,6,210,F,72,10,4,124,-86,Severe
14,3,171,M,51,8,4,100,-71,Severe
10,7,127,F,94,12,7,151,24,Well
5,2,62,F,55,8,8,104,42,Well
14,9,177,F,91,12,4,148,-29,Severe
8,5,101,F,84,11,7,139,38,Well
12,0,144,F,25,6,5,77,-67,Severe
6,9,81,F,9,5,7,67,-14,Severe
11,0,132,F,19,6,1,73,-59,Severe
13,3,159,M,94,12,7,151,-8,Severe
17,11,215,M,68,10,0,120,-95,Severe
6,3,75,M,68,10,0,120,45,Well
15,2,182,M,63,9,6,114,-68,Severe
10,11,131,F,93,12,6,150,19,Well
12,3,147,M,10,5,7,67,-80,Severe
12,4,148,M,25,6,5,77,-71,Severe
14,5,173,M,65,9,8,116,-57,Severe
17,10,214,F,50,8,3,99,-115,Severe
11,10,142,F,31,6,9,81,-61,Severe
18,11,227,F,106,13,10,166,-61,Severe
9,9,117,F,60,9,2,110,-7,Severe
6,11,83,F,22,6,3,75,-8,Severe
5,10,70,F,59,9,1,109,39,Well
17,10,214,F,89,12,1,145,-69,Severe
6,11,83,F,87,11,11,143,60,Well
12,8,152,F,7,5,6,66,-86,Severe
8,11,107,F,14,5,10,70,-37,Severe
14,11,179,M,21,6,2,74,-105,Severe
16,1,193,M,81,11,4,136,-57,Severe
17,6,210,F,91,12,4,148,-62,Severe
9,1,109,M,73,10,6,126,17,Well
8,9,105,F,74,10,7,127,22,Well
9,2,110,M,51,8,4,100,-10,Severe
16,1,193,F,11,5,8,68,-125,Severe
6,9,81,F,74,10,7,127,46,Well
7,7,91,M,29,6,8,80,-11,Severe
6,6,78,M,105,13,9,165,87,Well
8,3,99,F,78,11,0,132,33,Well
6,1,73,F,104,13,7,163,90,Well
12,9,153,M,58,9,0,108,-45,Severe
11,7,139,M,35,7,1,85,-54,Severe
11,5,137,M,29,6,8,80,-57,Severe
17,6,210,M,33,6,11,83,-127,Severe
13,4,160,M,61,9,3,111,-49,Severe
12,8,152,M,71,10,3,123,-29,Severe
16,8,200,M,36,7,2,86,-114,Severe
18,11,227,F,99,13,1,157,-70,Severe
14,5,173,M,97,12,11,155,-18,Severe
16,5,197,F,82,11,5,137,-60,Severe
8,9,105,F,106,13,10,166,61,Well
8,0,96,M,34,7,0,84,-12,Severe
15,9,189,F,68,10,0,120,-69,Severe
13,6,162,M,65,9,8,116,-46,Severe
5,3,63,M,45,7,10,94,31,Well
14,11,179,F,14,5,10,70,-109,Severe
13,5,161,F,17,6,0,72,-89,Severe
5,0,60,M,107,13,11,167,107,Well
9,1,109,F,60,9,2,110,1,Good
6,1,73,M,99,13,1,157,84,Well
11,4,136,F,7,5,6,66,-70,Severe
9,0,108,M,10,5,7,67,-41,Severe
9,4,112,M,62,9,4,112,0,Neutral
7,4,88,F,47,8,0,96,8,Well
8,9,105,M,106,13,10,166,61,Well
12,9,153,M,22,6,3,75,-78,Severe
17,8,212,F,92,12,5,149,-63,Severe
13,2,158,F,59,9,1,109,-49,Severe
15,0,180,F,70,10,2,122,-58,Severe
15,9,189,F,33,6,11,83,-106,Severe
10,3,123,M,110,14,3,171,48,Well
15,11,191,M,38,7,4,88,-103,Severe
5,0,60,M,101,13,4,160,100,Well
15,8,188,F,35,7,1,85,-103,Severe
7,3,87,F,91,12,4,148,61,Well
18,3,219,F,18,6,1,73,-146,Severe
10,3,123,M,11,5,8,68,-55,Severe
6,3,75,F,43,7,8,92,17,Well
18,3,219,M,104,13,7,163,-56,Severe
9,4,112,M,4,5,4,64,-48,Severe
8,0,96,M,103,13,6,162,66,Well
13,10,166,M,29,6,8,80,-86,Severe
17,2,206,M,97,12,11,155,-51,Severe
9,4,112,F,97,12,11,155,43,Well
13,8,164,M,109,14,1,169,5,Good
14,0,168,F,18,6,1,73,-95,Severe
12,3,147,F,45,7,10,94,-53,Severe
13,6,162,F,107,13,11,167,5,Good
5,8,68,M,73,10,6,126,58,Well
15,0,180,M,72,10,4,124,-56,Severe
10,10,130,M,66,9,9,117,-13,Severe
5,0,60,M,23,6,4,76,16,Well
7,11,95,M,58,9,0,108,13,Well
13,5,161,F,48,8,1,97,-64,Severe
10,9,129,F,40,7,5,89,-40,Severe
10,7,127,F,57,8,10,106,-21,Severe
18,8,224,M,106,13,10,166,-58,Severe
8,9,105,F,72,10,4,124,19,Well
6,9,81,M,85,11,9,141,60,Well
14,10,178,F,5,5,5,65,-113,Severe
8,2,98,M,64,9,7,115,17,Well
15,8,188,M,107,13,11,167,-21,Severe
15,11,191,F,50,8,3,99,-92,Severe
16,8,200,F,17,6,0,72,-128,Severe
15,8,188,F,102,13,6,162,-26,Severe
15,9,189,M,77,10,11,131,-58,Severe
11,3,135,M,52,8,5,101,-34,Severe
5,4,64,F,2,5,3,63,-1,Mild
12,8,152,F,93,12,6,150,-2,Mild
11,3,135,F,98,13,0,156,21,Well
8,4,100,F,63,9,6,114,14,Well
13,1,157,M,66,9,9,117,-40,Severe
8,6,102,F,36,7,2,86,-16,Severe
17,8,212,F,101,13,4,160,-52,Severe
7,8,92,F,24,6,5,77,-15,Severe
10,10,130,F,109,14,1,169,39,Well
14,11,179,M,52,8,5,101,-78,Severe
15,11,191,F,57,8,10,106,-85,Severe
18,5,221,F,12,5,9,69,-152,Severe
10,7,127,F,54,8,7,103,-24,Severe
8,8,104,M,62,9,4,112,8,Well
13,6,162,M,72,10,4,124,-38,Severe
12,9,153,F,18,6,1,73,-80,Severe
18,10,226,M,18,6,1,73,-153,Severe
14,0,168,F,72,10,4,124,-44,Severe
5,4,64,M,76,10,10,130,66,Well
14,7,175,M,13,5,9,69,-106,Severe
15,5,185,F,4,5,4,64,-121,Severe
10,3,123,F,61,9,3,111,-12,Severe
12,11,155,M,31,6,9,81,-74,Severe
15,3,183,M,101,13,4,160,-23,Severe
8,3,99,F,27,6,7,79,-20,Severe
9,0,108,F,61,9,3,111,3,Good
5,10,70,M,89,12,1,145,75,Well
13,0,156,M,2,5,3,63,-93,Severe
17,4,208,F,47,8,0,96,-112,Severe
6,6,78,M,95,12,9,153,75,Well
9,11,119,F,82,11,5,137,18,Well
14,4,172,M,27,6,7,79,-93,Severe
5,1,61,M,20,6,2,74,13,Well
8,0,96,M,93,12,6,150,54,Well
15,10,190,M,27,6,7,79,-111,Severe
8,5,101,F,64,9,7,115,14,Well
16,7,199,F,33,6,11,83,-116,Severe
16,10,202,M,95,12,9,153,-49,Severe
10,10,130,M,73,10,6,126,-4,Mild
13,11,167,F,52,8,5,101,-66,Severe
10,7,127,M,21,6,2,74,-53,Severe
17,7,211,M,19,6,1,73,-138,Severe
9,6,114,F,26,6,6,78,-36,Severe
14,8,176,F,47,8,0,96,-80,Severe
11,9,141,F,98,13,0,156,15,Well
16,5,197,F,84,11,7,139,-58,Severe
17,1,205,M,24,6,5,77,-128,Severe
12,3,147,F,106,13,10,166,19,Well
8,10,106,M,54,8,7,103,-3,Mild
8,6,102,F,43,7,8,92,-10,Severe
14,4,172,M,100,13,3,159,-13,Severe
9,3,111,F,48,8,1,97,-14,Severe
6,7,79,M,97,12,11,155,76,Well
8,1,97,F,49,8,2,98,1,Good
10,6,126,M,77,10,11,131,5,Good
6,4,76,M,31,6,9,81,5,Good
6,4,76,M,107,13,11,167,91,Well
16,2,194,F,14,5,10,70,-124,Severe
14,8,176,M,77,10,11,131,-45,Severe
12,1,145,M,52,8,5,101,-44,Severe
15,8,188,M,51,8,4,100,-88,Severe
12,9,153,M,84,11,7,139,-14,Severe
8,11,107,F,17,6,0,72,-35,Severe
14,3,171,F,23,6,4,76,-95,Severe
6,9,81,M,84,11,7,139,58,Well
18,10,226,F,28,6,8,80,-146,Severe
11,0,132,F,91,12,4,148,16,Well
14,2,170,F,77,10,11,131,-39,Severe
9,11,119,F,16,5,11,71,-48,Severe
9,7,115,M,103,13,6,162,47,Well
5,4,64,F,73,10,6,126,62,Well
12,5,149,F,8,5,6,66,-83,Severe
5,3,63,F,24,6,5,77,14,Well
18,5,221,M,51,8,4,100,-121,Severe
18,2,218,F,4,5,4,64,-154,Severe
16,1,193,M,21,6,2,74,-119,Severe
10,3,123,F,69,10,1,121,-2,Mild
12,7,151,F,9,5,7,67,-84,Severe
17,3,207,M,91,12,4,148,-59,Severe
16,3,195,F,72,10,4,124,-71,Severe
6,8,80,M,74,10,7,127,47,Well
7,5,89,F,29,6,8,80,-9,Severe
7,6,90,F,31,6,9,81,-9,Severe
6,2,74,F,98,13,0,156,82,Well
7,3,87,M,2,5,3,63,-24,Severe
9,2,110,F,71,10,3,123,13,Well
8,1,97,M,97,12,11,155,58,Well
7,0,84,M,39,7,5,89,5,Good
7,11,95,M,56,8,9,105,10,Well
11,8,140,F,91,12,4,148,8,Well
13,3,159,F,24,6,5,77,-82,Severe
15,0,180,F,91,12,4,148,-32,Severe
12,7,151,F,96,12,10,154,3,Good
6,0,72,F,75,10,9,129,57,Well
13,11,167,F,37,7,3,87,-80,Severe
5,3,63,M,12,5,9,69,6,Well
16,2,194,F,84,11,7,139,-55,Severe
13,2,158,M,85,11,9,141,-17,Severe
9,2,110,M,83,11,6,138,28,Well
12,3,147,F,52,8,5,101,-46,Severe
14,9,177,F,68,10,0,120,-57,Severe
16,0,192,M,96,12,10,154,-38,Severe
13,6,162,M,104,13,7,163,1,Good
11,2,134,F,76,10,10,130,-4,Mild
8,9,105,F,47,8,0,96,-9,Severe
12,1,145,M,51,8,4,100,-45,Severe
10,5,125,F,93,12,6,150,25,Well
11,11,143,F,93,12,6,150,7,Well
12,1,145,M,109,14,1,169,24,Well
9,1,109,F,52,8,5,101,-8,Severe
17,4,208,M,43,7,8,92,-116,Severe
13,0,156,M,42,7,7,91,-65,Severe
9,11,119,F,84,11,7,139,20,Well
6,11,83,F,94,12,7,151,68,Well
18,5,221,F,17,6,0,72,-149,Severe
12,9,153,M,73,10,6,126,-27,Severe
8,8,104,F,106,13,10,166,62,Well
8,4,100,F,38,7,4,88,-12,Severe
13,9,165,M,62,9,4,112,-53,Severe
14,0,168,F,83,11,6,138,-30,Severe
13,5,161,M,20,6,2,74,-87,Severe
6,11,83,M,41,7,6,90,7,Well
10,1,121,M,40,7,5,89,-32,Severe
14,3,171,F,57,8,10,106,-65,Severe
11,5,137,M,60,9,2,110,-27,Severe
6,9,81,M,25,6,5,77,-4,Mild
12,6,150,M,110,14,3,171,21,Well
10,3,123,F,29,6,8,80,-43,Severe
16,6,198,M,65,9,8,116,-82,Severe
9,5,113,F,53,8,6,102,-11,Severe
12,4,148,M,91,12,4,148,0,Neutral
15,4,184,F,62,9,4,112,-72,Severe
10,6,126,M,2,5,3,63,-63,Severe
15,1,181,F,94,12,7,151,-30,Severe
11,1,133,F,49,8,2,98,-35,Severe
10,11,131,M,35,7,1,85,-46,Severe
15,9,189,M,100,13,3,159,-30,Severe
10,4,124,F,105,13,9,165,41,Well
17,11,215,M,12,5,9,69,-146,Severe
5,8,68,F,59,9,1,109,41,Well
12,5,149,F,16,5,11,71,-78,Severe
16,7,199,F,35,7,1,85,-114,Severe
14,1,169,M,62,9,4,112,-57,Severe
7,10,94,M,59,9,1,109,15,Well
11,8,140,F,5,5,5,65,-75,Severe
5,1,61,M,31,6,9,81,20,Well
6,10,82,F,105,13,9,165,83,Well
6,3,75,M,102,13,6,162,87,Well
7,11,95,M,25,6,5,77,-18,Severe
7,7,91,F,93,12,6,150,59,Well
10,3,123,M,9,5,7,67,-56,Severe
14,11,179,F,40,7,5,89,-90,Severe
15,3,183,F,69,10,1,121,-62,Severe
12,1,145,F,44,7,9,93,-52,Severe
8,8,104,M,4,5,4,64,-40,Severe
5,5,65,F,73,10,6,126,61,Well
15,8,188,M,61,9,3,111,-77,Severe
17,1,205,M,64,9,7,115,-90,Severe
15,1,181,M,99,13,1,157,-24,Severe
14,2,170,M,28,6,8,80,-90,Severe
5,5,65,F,77,10,11,131,66,Well
14,2,170,F,49,8,2,98,-72,Severe
11,9,141,M,75,10,9,129,-12,Severe
13,10,166,M,37,7,3,87,-79,Severe
11,7,139,M,48,8,1,97,-42,Severe
12,7,151,F,20,6,2,74,-77,Severe
8,3,99,F,51,8,4,100,1,Good
15,9,189,M,65,9,8,116,-73,Severe
10,6,126,F,18,6,1,73,-53,Severe
11,10,142,F,86,11,10,142,0,Neutral
5,2,62,M,85,11,9,141,79,Well
17,8,212,M,81,11,4,136,-76,Severe
17,9,213,M,57,8,10,106,-107,Severe
16,3,195,M,65,9,8,116,-79,Severe
10,5,125,M,42,7,7,91,-34,Severe
17,11,215,F,32,6,10,82,-133,Severe
16,6,198,M,36,7,2,86,-112,Severe
18,8,224,M,93,12,6,150,-74,Severe
14,4,172,M,36,7,2,86,-86,Severe
9,8,116,F,107,13,11,167,51,Well
16,2,194,F,20,6,2,74,-120,Severe
8,3,99,M,96,12,10,154,55,Well
17,7,211,F,43,7,8,92,-119,Severe
7,11,95,M,97,12,11,155,60,Well
14,7,175,M,59,9,1,109,-66,Severe
10,10,130,M,96,12,10,154,24,Well
14,3,171,F,81,11,4,136,-35,Severe
9,8,116,F,69,10,1,121,5,Good
13,8,164,M,83,11,6,138,-26,Severe
18,11,227,M,71,10,3,123,-104,Severe
9,5,113,F,30,6,9,81,-32,Severe
18,1,217,F,33,6,11,83,-134,Severe
12,1,145,F,35,7,1,85,-60,Severe
14,11,179,M,30,6,9,81,-98,Severe
18,0,216,M,36,7,2,86,-130,Severe
7,7,91,M,16,5,11,71,-20,Severe
16,1,193,M,89,12,1,145,-48,Severe
15,6,186,F,79,11,1,133,-53,Severe
13,2,158,M,41,7,6,90,-68,Severe
13,3,159,F,69,10,1,121,-38,Severe
10,10,130,M,19,6,1,73,-57,Severe
9,5,113,M,110,14,3,171,58,Well
12,9,153,M,74,10,7,127,-26,Severe
7,3,87,F,99,13,1,157,70,Well
13,4,160,M,105,13,9,165,5,Good
6,2,74,F,8,5,6,66,-8,Severe
8,8,104,F,98,13,0,156,52,Well
14,9,177,M,20,6,2,74,-103,Severe
16,1,193,M,36,7,2,86,-107,Severe
10,7,127,M,51,8,4,100,-27,Severe
12,1,145,F,26,6,6,78,-67,Severe
7,3,87,M,5,5,5,65,-22,Severe
6,5,77,F,93,12,6,150,73,Well
8,5,101,M,65,9,8,116,15,Well
9,8,116,F,59,9,1,109,-7,Severe
17,6,210,M,106,13,10,166,-44,Severe
7,11,95,M,20,6,2,74,-21,Severe
9,8,116,M,36,7,2,86,-30,Severe
12,3,147,M,103,13,6,162,15,Well
15,3,183,F,87,11,11,143,-40,Severe
18,6,222,M,12,5,9,69,-153,Severe
16,11,203,M,48,8,1,97,-106,Severe
12,3,147,M,30,6,9,81,-66,Severe
17,4,208,F,43,7,8,92,-116,Severe
11,8,140,F,32,6,10,82,-58,Severe
8,2,98,M,55,8,8,104,6,Well
7,1,85,F,88,12,0,144,59,Well
6,9,81,F,31,6,9,81,0,Neutral
5,11,71,M,12,5,9,69,-2,Mild
14,3,171,M,54,8,7,103,-68,Severe
17,9,213,F,93,12,6,150,-63,Severe
8,3,99,F,62,9,4,112,13,Well
11,7,139,F,5,5,5,65,-74,Severe
14,3,171,M,58,9,0,108,-63,Severe
7,7,91,M,67,9,10,118,27,Well
7,0,84,F,74,10,7,127,43,Well
5,7,67,F,48,8,1,97,30,Well
11,3,135,M,5,5,5,65,-70,Severe
7,0,84,F,26,6,6,78,-6,Severe
9,7,115,M,27,6,7,79,-36,Severe
5,8,68,M,37,7,3,87,19,Well
17,0,204,F,100,13,3,159,-45,Severe
9,10,118,M,44,7,9,93,-25,Severe
18,7,223,M,62,9,4,112,-111,Severe
6,6,78,M,49,8,2,98,20,Well
7,8,92,M,71,10,3,123,31,Well
6,4,76,M,55,8,8,104,28,Well
16,3,195,M,35,7,1,85,-110,Severe
10,1,121,M,29,6,8,80,-41,Severe
8,4,100,F,12,5,9,69,-31,Severe
12,8,152,M,61,9,3,111,-41,Severe
11,0,132,F,31,6,9,81,-51,Severe
8,2,98,F,49,8,2,98,0,Neutral
14,3,171,F,54,8,7,103,-68,Severe
13,9,165,M,106,13,10,166,1,Good
18,3,219,F,82,11,5,137,-82,Severe
5,9,69,M,104,13,7,163,94,Well
7,9,93,F,21,6,2,74,-19,Severe
12,7,151,F,46,7,11,95,-56,Severe
7,3,87,F,57,8,10,106,19,Well
9,9,117,F,74,10,7,127,10,Well
16,8,200,M,23,6,4,76,-124,Severe
17,3,207,F,19,6,1,73,-134,Severe
12,0,144,M,60,9,2,110,-34,Severe
12,3,147,M,5,5,5,65,-82,Severe
16,9,201,M,76,10,10,130,-71,Severe
16,1,193,M,104,13,7,163,-30,Severe
16,6,198,F,77,10,11,131,-67,Severe
10,9,129,M,74,10,7,127,-2,Mild
13,5,161,M,53,8,6,102,-59,Severe
15,5,185,M,86,11,10,142,-43,Severe
8,3,99,F,110,14,3,171,72,Well
7,4,88,M,30,6,9,81,-7,Severe
11,10,142,M,5,5,5,65,-77,Severe
10,9,129,M,66,9,9,117,-12,Severe
5,3,63,M,31,6,9,81,18,Well
8,5,101,M,32,6,10,82,-19,Severe
14,6,174,F,31,6,9,81,-93,Severe
5,4,64,M,63,9,6,114,50,Well
16,0,192,M,108,14,0,168,-24,Severe
18,7,223,M,100,13,3,159,-64,Severe
14,3,171,F,69,10,1,121,-50,Severe
18,10,226,F,61,9,3,111,-115,Severe
8,8,104,M,49,8,2,98,-6,Severe
7,1,85,F,48,8,1,97,12,Well
9,5,113,M,5,5,5,65,-48,Severe
16,9,201,F,78,11,0,132,-69,Severe
13,8,164,M,24,6,5,77,-87,Severe
17,10,214,F,69,10,1,121,-93,Severe
7,9,93,M,105,13,9,165,72,Well
11,6,138,M,12,5,9,69,-69,Severe
12,4,148,F,84,11,7,139,-9,Severe
10,7,127,M,83,11,6,138,11,Well
7,5,89,F,102,13,6,162,73,Well
17,4,208,F,2,5,3,63,-145,Severe
7,0,84,F,76,10,10,130,46,Well
15,5,185,F,86,11,10,142,-43,Severe
12,3,147,M,14,5,10,70,-77,Severe
14,7,175,M,86,11,10,142,-33,Severe
7,3,87,M,89,12,1,145,58,Well
8,7,103,F,65,9,8,116,13,Well
7,9,93,M,100,13,3,159,66,Well
10,5,125,M,103,13,6,162,37,Well
12,0,144,F,76,10,10,130,-14,Severe
5,9,69,M,17,6,0,72,3,Good
10,8,128,M,102,13,6,162,34,Well
6,10,82,F,76,10,10,130,48,Well
18,3,219,M,26,6,6,78,-141,Severe
12,2,146,F,92,12,5,149,3,Good
16,2,194,F,10,5,7,67,-127,Severe
14,5,173,F,27,6,7,79,-94,Severe
13,11,167,F,58,9,0,108,-59,Severe
5,9,69,F,67,9,10,118,49,Well
16,8,200,M,45,7,10,94,-106,Severe
5,2,62,M,92,12,5,149,87,Well
16,2,194,M,62,9,4,112,-82,Severe
13,7,163,M,22,6,3,75,-88,Severe
14,7,175,M,30,6,9,81,-94,Severe
6,3,75,M,110,14,3,171,96,Well
6,7,79,F,5,5,5,65,-14,Severe
8,2,98,M,6,5,5,65,-33,Severe
14,7,175,M,79,11,1,133,-42,Severe
8,2,98,F,33,6,11,83,-15,Severe
18,6,222,F,105,13,9,165,-57,Severe
14,3,171,F,52,8,5,101,-70,Severe
8,3,99,M,20,6,2,74,-25,Severe
16,3,195,M,32,6,10,82,-113,Severe
10,5,125,F,77,10,11,131,6,Well
5,8,68,F,61,9,3,111,43,Well
15,9,189,F,57,8,10,106,-83,Severe
18,9,225,M,80,11,3,135,-90,Severe
12,0,144,F,68,10,0,120,-24,Severe
17,3,207,M,35,7,1,85,-122,Severe
12,7,151,M,65,9,8,116,-35,Severe
16,9,201,M,30,6,9,81,-120,Severe
10,5,125,M,40,7,5,89,-36,Severe
9,6,114,F,29,6,8,80,-34,Severe
18,8,224,F,11,5,8,68,-156,Severe
6,10,82,M,44,7,9,93,11,Well
12,3,147,F,34,7,0,84,-63,Severe
12,9,153,F,108,14,0,168,15,Well
7,7,91,M,36,7,2,86,-5,Mild
6,9,81,F,107,13,11,167,86,Well
6,8,80,F,7,5,6,66,-14,Severe
10,5,125,M,104,13,7,163,38,Well
12,3,147,F,85,11,9,141,-6,Severe
10,4,124,F,32,6,10,82,-42,Severe
5,11,71,F,52,8,5,101,30,Well
18,8,224,M,22,6,3,75,-149,Severe
11,9,141,F,10,5,7,67,-74,Severe
5,5,65,F,58,9,0,108,43,Well
18,3,219,M,16,5,11,71,-148,Severe
18,7,223,F,86,11,10,142,-81,Severe
14,10,178,M,100,13,3,159,-19,Severe
17,3,207,F,65,9,8,116,-91,Severe
16,3,195,F,22,6,3,75,-120,Severe
17,7,211,M,2,5,3,63,-148,Severe
14,7,175,M,10,5,7,67,-108,Severe
6,11,83,F,79,11,1,133,50,Well
12,5,149,F,48,8,1,97,-52,Severe
10,0,120,M,31,6,9,81,-39,Severe
18,1,217,M,11,5,8,68,-149,Severe
9,6,114,M,83,11,6,138,24,Well
16,9,201,M,109,14,1,169,-32,Severe
11,4,136,F,56,8,9,105,-31,Severe
11,4,136,M,35,7,1,85,-51,Severe
16,2,194,M,107,13,11,167,-27,Severe
9,3,111,F,18,6,1,73,-38,Severe
16,10,202,M,20,6,2,74,-128,Severe
13,1,157,F,68,10,0,120,-37,Severe
13,9,165,M,100,13,3,159,-6,Severe
12,9,153,M,103,13,6,162,9,Well
15,1,181,F,87,11,11,143,-38,Severe
6,1,73,F,97,12,11,155,82,Well
5,11,71,F,80,11,3,135,64,Well
5,3,63,F,61,9,3,111,48,Well
5,11,71,F,106,13,10,166,95,Well
5,7,67,M,18,6,1,73,6,Well
12,4,148,F,82,11,5,137,-11,Severe
15,7,187,M,7,5,6,66,-121,Severe
14,5,173,M,44,7,9,93,-80,Severe
13,8,164,M,94,12,7,151,-13,Severe
6,9,81,M,17,6,0,72,-9,Severe
15,8,188,M,17,6,0,72,-116,Severe
11,10,142,M,58,9,0,108,-34,Severe
13,10,166,M,14,5,10,70,-96,Severe
12,5,149,F,97,12,11,155,6,Well
13,3,159,F,81,11,4,136,-23,Severe
16,11,203,F,90,12,3,147,-56,Severe
7,0,84,M,61,9,3,111,27,Well
5,7,67,M,32,6,10,82,15,Well
18,3,219,M,28,6,8,80,-139,Severe
18,2,218,M,52,8,5,101,-117,Severe
17,4,208,M,84,11,7,139,-69,Severe
8,9,105,M,51,8,4,100,-5,Mild
17,1,205,F,17,6,0,72,-133,Severe
16,3,195,M,22,6,3,75,-120,Severe
12,7,151,M,94,12,7,151,0,Neutral
5,3,63,F,106,13,10,166,103,Well
8,11,107,F,59,9,1,109,2,Good
8,3,99,F,13,5,9,69,-30,Severe
7,2,86,M,2,5,3,63,-23,Severe
9,5,113,F,5,5,5,65,-48,Severe
12,5,149,M,67,9,10,118,-31,Severe
6,11,83,M,92,12,5,149,66,Well
12,3,147,F,25,6,5,77,-70,Severe
16,10,202,F,70,10,2,122,-80,Severe
15,5,185,M,102,13,6,162,-23,Severe
15,3,183,M,8,5,6,66,-117,Severe
10,8,128,M,44,7,9,93,-35,Severe
15,5,185,F,90,12,3,147,-38,Severe
6,3,75,M,23,6,4,76,1,Good
17,2,206,F,55,8,8,104,-102,Severe
10,3,123,M,84,11,7,139,16,Well
16,1,193,F,106,13,10,166,-27,Severe
16,3,195,M,95,12,9,153,-42,Severe
5,5,65,M,32,6,10,82,17,Well
17,0,204,F,35,7,1,85,-119,Severe
10,0,120,M,3,5,3,63,-57,Severe
8,7,103,M,13,5,9,69,-34,Severe
9,11,119,F,95,12,9,153,34,Well
9,7,115,F,2,5,3,63,-52,Severe
17,8,212,M,11,5,8,68,-144,Severe
13,0,156,F,89,12,1,145,-11,Severe
14,3,171,M,2,5,3,63,-108,Severe
18,10,226,M,80,11,3,135,-91,Severe
6,10,82,F,89,12,1,145,63,Well
9,2,110,F,65,9,8,116,6,Well
9,0,108,M,109,14,1,169,61,Well
8,10,106,F,101,13,4,160,54,Well
11,4,136,M,58,9,0,108,-28,Severe
7,3,87,M,63,9,6,114,27,Well
15,9,189,M,27,6,7,79,-110,Severe
15,2,182,M,76,10,10,130,-52,Severe
16,6,198,M,61,9,3,111,-87,Severe
14,0,168,F,98,13,0,156,-12,Severe
14,7,175,F,79,11,1,133,-42,Severe
6,4,76,F,68,10,0,120,44,Well
14,3,171,F,53,8,6,102,-69,Severe
5,5,65,M,31,6,9,81,16,Well
10,5,125,F,110,14,3,171,46,Well
9,0,108,M,9,5,7,67,-41,Severe
8,3,99,F,65,9,8,116,17,Well
13,2,158,M,17,6,0,72,-86,Severe
15,5,185,F,104,13,7,163,-22,Severe
8,5,101,F,30,6,9,81,-20,Severe
18,10,226,M,105,13,9,165,-61,Severe
10,3,123,M,104,13,7,163,40,Well
16,0,192,M,53,8,6,102,-90,Severe
6,8,80,F,64,9,7,115,35,Well
6,2,74,F,2,5,3,63,-11,Severe
10,7,127,F,90,12,3,147,20,Well
9,4,112,F,38,7,4,88,-24,Severe
14,10,178,F,27,6,7,79,-99,Severe
18,11,227,M,21,6,2,74,-153,Severe
5,5,65,F,86,11,10,142,77,Well
17,10,214,F,61,9,3,111,-103,Severe
13,7,163,F,51,8,4,100,-63,Severe
10,7,127,M,3,5,3,63,-64,Severe
13,8,164,F,2,5,3,63,-101,Severe
18,10,226,M,21,6,2,74,-152,Severe
9,3,111,M,102,13,6,162,51,Well
8,4,100,M,14,5,10,70,-30,Severe
10,3,123,F,8,5,6,66,-57,Severe
14,0,168,F,84,11,7,139,-29,Severe
14,9,177,M,95,12,9,153,-24,Severe
18,0,216,M,91,12,4,148,-68,Severe
8,3,99,F,75,10,9,129,30,Well
16,10,202,M,92,12,5,149,-53,Severe
15,10,190,F,65,9,8,116,-74,Severe
15,3,183,F,33,6,11,83,-100,Severe
18,7,223,F,50,8,3,99,-124,Severe
11,9,141,M,51,8,4,100,-41,Severe
18,0,216,F,45,7,10,94,-122,Severe
12,1,145,F,62,9,4,112,-33,Severe
6,0,72,F,34,7,0,84,12,Well
5,1,61,F,84,11,7,139,78,Well
11,8,140,F,92,12,5,149,9,Well
8,0,96,M,44,7,9,93,-3,Mild
15,1,181,M,2,5,3,63,-118,Severe
5,10,70,M,95,12,9,153,83,Well
18,2,218,F,102,13,6,162,-56,Severe
5,1,61,M,9,5,7,67,6,Well
18,3,219,F,53,8,6,102,-117,Severe
14,6,174,M,17,6,0,72,-102,Severe
6,4,76,M,12,5,9,69,-7,Severe
14,9,177,F,81,11,4,136,-41,Severe
17,5,209,F,55,8,8,104,-105,Severe
6,3,75,F,86,11,10,142,67,Well
6,2,74,M,81,11,4,136,62,Well
11,5,137,M,48,8,1,97,-40,Severe
8,2,98,F,100,13,3,159,61,Well
13,10,166,F,9,5,7,67,-99,Severe
15,3,183,M,46,7,11,95,-88,Severe
13,8,164,M,9,5,7,67,-97,Severe
15,5,185,F,47,8,0,96,-89,Severe
13,10,166,F,89,12,1,145,-21,Severe
7,5,89,M,35,7,1,85,-4,Mild
6,11,83,F,61,9,3,111,28,Well
9,11,119,M,3,5,3,63,-56,Severe
10,2,122,F,71,10,3,123,1,Good
16,2,194,F,15,5,11,71,-123,Severe
5,11,71,F,86,11,10,142,71,Well
17,8,212,M,32,6,10,82,-130,Severe
16,8,200,F,69,10,1,121,-79,Severe
15,5,185,M,39,7,5,89,-96,Severe
5,4,64,F,21,6,2,74,10,Well
15,8,188,M,78,11,0,132,-56,Severe
12,2,146,M,68,10,0,120,-26,Severe
14,8,176,F,9,5,7,67,-109,Severe
18,5,221,F,31,6,9,81,-140,Severe
11,1,133,F,27,6,7,79,-54,Severe
10,3,123,F,53,8,6,102,-21,Severe
9,3,111,F,63,9,6,114,3,Good
12,0,144,M,49,8,2,98,-46,Severe
14,2,170,F,43,7,8,92,-78,Severe
18,9,225,M,39,7,5,89,-136,Severe
9,0,108,F,69,10,1,121,13,Well
10,11,131,M,68,10,0,120,-11,Severe
8,7,103,M,28,6,8,80,-23,Severe
13,10,166,M,31,6,9,81,-85,Severe
7,1,85,F,102,13,6,162,77,Well
6,7,79,M,98,13,0,156,77,Well
7,7,91,M,44,7,9,93,2,Good
10,10,130,F,23,6,4,76,-54,Severe
9,4,112,F,89,12,1,145,33,Well
10,2,122,M,46,7,11,95,-27,Severe
11,3,135,F,8,5,6,66,-69,Severe
16,1,193,F,92,12,5,149,-44,Severe
10,10,130,F,82,11,5,137,7,Well
6,6,78,F,72,10,4,124,46,Well
12,3,147,M,86,11,10,142,-5,Mild
5,10,70,M,71,10,3,123,53,Well
8,5,101,M,56,8,9,105,4,Good
13,4,160,M,100,13,3,159,-1,Mild
10,2,122,F,47,8,0,96,-26,Severe
10,7,127,F,69,10,1,121,-6,Severe
16,0,192,F,77,10,11,131,-61,Severe
7,6,90,M,34,7,0,84,-6,Severe
5,3,63,M,9,5,7,67,4,Good
13,1,157,F,38,7,4,88,-69,Severe
7,3,87,M,110,14,3,171,84,Well
13,3,159,F,44,7,9,93,-66,Severe
13,10,166,M,90,12,3,147,-19,Severe
12,7,151,F,37,7,3,87,-64,Severe
8,5,101,F,108,14,0,168,67,Well
11,4,136,M,60,9,2,110,-26,Severe
14,9,177,M,34,7,0,84,-93,Severe
6,6,78,F,110,14,3,171,93,Well
6,5,77,M,105,13,9,165,88,Well
11,4,136,M,107,13,11,167,31,Well
8,4,100,M,44,7,9,93,-7,Severe
8,4,100,F,97,12,11,155,55,Well
10,2,122,M,83,11,6,138,16,Well
13,5,161,F,52,8,5,101,-60,Severe
7,6,90,M,87,11,11,143,53,Well
7,1,85,M,34,7,0,84,-1,Mild
11,10,142,M,12,5,9,69,-73,Severe
15,11,191,M,16,5,11,71,-120,Severe
17,8,212,M,12,5,9,69,-143,Severe
7,1,85,M,38,7,4,88,3,Good
15,7,187,M,82,11,5,137,-50,Severe
14,4,172,M,64,9,7,115,-57,Severe
17,7,211,M,4,5,4,64,-147,Severe
6,3,75,M,7,5,6,66,-9,Severe
18,9,225,F,37,7,3,87,-138,Severe
11,3,135,M,34,7,0,84,-51,Severe
18,1,217,F,28,6,8,80,-137,Severe
18,1,217,F,71,10,3,123,-94,Severe
8,9,105,F,18,6,1,73,-32,Severe
17,3,207,F,48,8,1,97,-110,Severe
16,6,198,M,68,10,0,120,-78,Severe
10,9,129,F,105,13,9,165,36,Well
16,3,195,M,11,5,8,68,-127,Severe
7,0,84,M,13,5,9,69,-15,Severe
8,0,96,M,28,6,8,80,-16,Severe
11,9,141,M,65,9,8,116,-25,Severe
17,3,207,M,14,5,10,70,-137,Severe
17,8,212,F,27,6,7,79,-133,Severe
5,2,62,M,50,8,3,99,37,Well
18,10,226,F,50,8,3,99,-127,Severe
6,5,77,M,52,8,5,101,24,Well
18,8,224,F,98,13,0,156,-68,Severe
8,3,99,F,28,6,8,80,-19,Severe
17,9,213,F,31,6,9,81,-132,Severe
18,9,225,F,38,7,4,88,-137,Severe
8,6,102,F,25,6,5,77,-25,Severe
14,0,168,M,32,6,10,82,-86,Severe
6,4,76,M,103,13,6,162,86,Well
5,6,66,F,22,6,3,75,9,Well
14,10,178,M,43,7,8,92,-86,Severe
16,0,192,M,101,13,4,160,-32,Severe
11,3,135,M,18,6,1,73,-62,Severe
16,8,200,M,66,9,9,117,-83,Severe
11,10,142,F,49,8,2,98,-44,Severe
9,3,111,F,32,6,10,82,-29,Severe
18,7,223,F,83,11,6,138,-85,Severe
9,4,112,F,78,11,0,132,20,Well
10,7,127,M,91,12,4,148,21,Well
13,3,159,M,23,6,4,76,-83,Severe
8,1,97,M,94,12,7,151,54,Well
15,5,185,F,74,10,7,127,-58,Severe
15,0,180,M,86,11,10,142,-38,Severe
7,10,94,F,30,6,9,81,-13,Severe
14,2,170,M,12,5,9,69,-101,Severe
15,3,183,F,72,10,4,124,-59,Severe
14,1,169,F,73,10,6,126,-43,Severe
6,9,81,F,20,6,2,74,-7,Severe
11,4,136,M,43,7,8,92,-44,Severe
6,3,75,F,106,13,10,166,91,Well
9,2,110,F,52,8,5,101,-9,Severe
17,9,213,M,9,5,7,67,-146,Severe
14,2,170,M,81,11,4,136,-34,Severe
8,1,97,F,65,9,8,116,19,Well
15,2,182,F,57,8,10,106,-76,Severe
11,8,140,M,52,8,5,101,-39,Severe
13,1,157,F,71,10,3,123,-34,Severe
7,1,85,F,85,11,9,141,56,Well
5,3,63,M,104,13,7,163,100,Well
5,8,68,F,33,6,11,83,15,Well
11,5,137,M,21,6,2,74,-63,Severe
15,6,186,F,82,11,5,137,-49,Severe
10,10,130,F,105,13,9,165,35,Well
8,1,97,M,107,13,11,167,70,Well
10,6,126,F,6,5,5,65,-61,Severe
5,9,69,M,96,12,10,154,85,Well
9,4,112,M,60,9,2,110,-2,Mild
17,3,207,F,110,14,3,171,-36,Severe
17,0,204,M,58,9,0,108,-96,Severe
13,8,164,F,89,12,1,145,-19,Severe
17,5,209,M,90,12,3,147,-62,Severe
13,8,164,M,65,9,8,116,-48,Severe
15,11,191,F,17,6,0,72,-119,Severe
12,10,154,M,72,10,4,124,-30,Severe
8,2,98,M,39,7,5,89,-9,Severe
13,3,159,M,108,14,0,168,9,Well
12,1,145,M,57,8,10,106,-39,Severe
7,3,87,M,35,7,1,85,-2,Mild
11,10,142,F,35,7,1,85,-57,Severe
12,4,148,F,18,6,1,73,-75,Severe
15,5,185,F,19,6,1,73,-112,Severe
17,5,209,F,22,6,3,75,-134,Severe
13,8,164,M,8,5,6,66,-98,Severe
9,6,114,M,81,11,4,136,22,Well
12,7,151,F,100,13,3,159,8,Well
5,8,68,M,77,10,11,131,63,Well
12,8,152,M,24,6,5,77,-75,Severe
6,10,82,M,57,8,10,106,24,Well
11,11,143,F,103,13,6,162,19,Well
9,3,111,M,69,10,1,121,10,Well
17,5,209,M,68,10,0,120,-89,Severe
11,11,143,F,68,10,0,120,-23,Severe
14,6,174,M,18,6,1,73,-101,Severe
5,7,67,M,2,5,3,63,-4,Mild
18,11,227,F,33,6,11,83,-144,Severe
13,3,159,M,22,6,3,75,-84,Severe
12,0,144,M,98,13,0,156,12,Well
5,3,63,M,48,8,1,97,34,Well
12,6,150,F,105,13,9,165,15,Well
16,6,198,M,9,5,7,67,-131,Severe
14,0,168,M,103,13,6,162,-6,Severe
9,9,117,M,55,8,8,104,-13,Severe
17,8,212,F,39,7,5,89,-123,Severe
13,5,161,M,73,10,6,126,-35,Severe
10,4,124,F,49,8,2,98,-26,Severe
10,9,129,F,13,5,9,69,-60,Severe
9,6,114,F,6,5,5,65,-49,Severe
18,9,225,F,53,8,6,102,-123,Severe
18,1,217,F,107,13,11,167,-50,Severe
17,0,204,F,21,6,2,74,-130,Severe
18,2,218,F,45,7,10,94,-124,Severe
10,2,122,M,34,7,0,84,-38,Severe
18,4,220,F,101,13,4,160,-60,Severe
17,8,212,M,110,14,3,171,-41,Severe
15,10,190,F,100,13,3,159,-31,Severe
12,9,153,M,27,6,7,79,-74,Severe
6,0,72,M,28,6,8,80,8,Well
15,9,189,F,47,8,0,96,-93,Severe
11,10,142,M,10,5,7,67,-75,Severe
16,0,192,F,54,8,7,103,-89,Severe
9,6,114,M,106,13,10,166,52,Well
14,8,176,F,43,7,8,92,-84,Severe
12,8,152,M,62,9,4,112,-40,Severe
18,8,224,M,28,6,8,80,-144,Severe
12,4,148,M,93,12,6,150,2,Good
12,2,146,F,78,11,0,132,-14,Severe
14,11,179,M,50,8,3,99,-80,Severe
8,5,101,F,36,7,2,86,-15,Severe
11,9,141,M,5,5,5,65,-76,Severe
9,8,116,M,24,6,5,77,-39,Severe
7,8,92,F,102,13,6,162,70,Well
5,3,63,M,96,12,10,154,91,Well
5,0,60,F,30,6,9,81,21,Well
18,3,219,F,63,9,6,114,-105,Severe
17,1,205,M,16,5,11,71,-134,Severe
10,0,120,F,94,12,7,151,31,Well
8,1,97,F,59,9,1,109,12,Well
12,10,154,M,52,8,5,101,-53,Severe
9,0,108,F,20,6,2,74,-34,Severe
18,4,220,F,91,12,4,148,-72,Severe
15,9,189,M,59,9,1,109,-80,Severe
10,11,131,M,20,6,2,74,-57,Severe
16,10,202,M,88,12,0,144,-58,Severe
16,8,200,M,54,8,7,103,-97,Severe
12,11,155,F,95,12,9,153,-2,Mild
15,2,182,M,16,5,11,71,-111,Severe
15,1,181,M,77,10,11,131,-50,Severe
17,2,206,F,19,6,1,73,-133,Severe
6,2,74,M,37,7,3,87,13,Well
15,2,182,M,14,5,10,70,-112,Severe
14,8,176,M,104,13,7,163,-13,Severe
12,5,149,F,15,5,11,71,-78,Severe
15,11,191,M,49,8,2,98,-93,Severe
12,3,147,F,68,10,0,120,-27,Severe
12,8,152,M,32,6,10,82,-70,Severe
6,10,82,M,25,6,5,77,-5,Mild
5,5,65,F,98,13,0,156,91,Well
6,10,82,F,2,5,3,63,-19,Severe
17,4,208,M,40,7,5,89,-119,Severe
12,3,147,F,55,8,8,104,-43,Severe
15,3,183,F,98,13,0,156,-27,Severe
10,10,130,M,26,6,6,78,-52,Severe
10,7,127,M,86,11,10,142,15,Well
16,5,197,F,99,13,1,157,-40,Severe
16,3,195,M,86,11,10,142,-53,Severe
7,10,94,F,71,10,3,123,29,Well
7,6,90,M,52,8,5,101,11,Well
8,10,106,F,17,6,0,72,-34,Severe
16,1,193,M,107,13,11,167,-26,Severe
7,8,92,M,32,6,10,82,-10,Severe
8,10,106,F,80,11,3,135,29,Well
12,10,154,M,79,11,1,133,-21,Severe
16,8,200,M,55,8,8,104,-96,Severe
11,6,138,F,91,12,4,148,10,Well
18,4,220,F,77,10,11,131,-89,Severe
7,4,88,F,30,6,9,81,-7,Severe
6,11,83,F,55,8,8,104,21,Well
14,3,171,M,12,5,9,69,-102,Severe
18,7,223,F,91,12,4,148,-75,Severe
6,8,80,M,94,12,7,151,71,Well
16,6,198,F,109,14,1,169,-29,Severe
17,4,208,F,103,13,6,162,-46,Severe
8,3,99,M,74,10,7,127,28,Well
7,9,93,F,18,6,1,73,-20,Severe
14,10,178,F,71,10,3,123,-55,Severe
9,3,111,M,8,5,6,66,-45,Severe
16,3,195,F,52,8,5,101,-94,Severe
14,1,169,M,89,12,1,145,-24,Severe
8,3,99,M,60,9,2,110,11,Well
17,10,214,F,110,14,3,171,-43,Severe
18,3,219,M,73,10,6,126,-93,Severe
16,1,193,F,70,10,2,122,-71,Severe
7,6,90,F,74,10,7,127,37,Well
11,8,140,F,109,14,1,169,29,Well
14,1,169,M,58,9,0,108,-61,Severe
15,4,184,M,95,12,9,153,-31,Severe
7,1,85,F,68,10,0,120,35,Well
16,1,193,M,59,9,1,109,-84,Severe
15,11,191,F,76,10,10,130,-61,Severe
14,0,168,M,64,9,7,115,-53,Severe
16,2,194,F,18,6,1,73,-121,Severe
12,3,147,F,15,5,11,71,-76,Severe
12,6,150,F,62,9,4,112,-38,Severe
15,11,191,M,24,6,5,77,-114,Severe
14,11,179,F,53,8,6,102,-77,Severe
6,2,74,F,27,6,7,79,5,Good
11,9,141,F,92,12,5,149,8,Well
6,3,75,M,58,9,0,108,33,Well
9,3,111,M,5,5,5,65,-46,Severe
14,2,170,M,83,11,6,138,-32,Severe
14,3,171,F,109,14,1,169,-2,Mild
17,5,209,M,12,5,9,69,-140,Severe
16,4,196,M,99,13,1,157,-39,Severe
5,3,63,M,64,9,7,115,52,Well
14,10,178,F,97,12,11,155,-23,Severe
5,5,65,F,6,5,5,65,0,Neutral
12,11,155,F,5,5,5,65,-90,Severe
8,6,102,M,59,9,1,109,7,Well
7,2,86,M,57,8,10,106,20,Well
7,8,92,M,26,6,6,78,-14,Severe
12,5,149,F,76,10,10,130,-19,Severe
8,1,97,F,20,6,2,74,-23,Severe
15,7,187,F,48,8,1,97,-90,Severe
11,8,140,F,100,13,3,159,19,Well
12,3,147,M,15,5,11,71,-76,Severe
9,2,110,M,89,12,1,145,35,Well
12,0,144,M,32,6,10,82,-62,Severe
11,3,135,M,48,8,1,97,-38,Severe
17,1,205,M,89,12,1,145,-60,Severe
12,8,152,F,99,13,1,157,5,Good
7,4,88,F,26,6,6,78,-10,Severe
5,7,67,M,67,9,10,118,51,Well
8,5,101,M,8,5,6,66,-35,Severe
9,3,111,F,33,6,11,83,-28,Severe
6,4,76,M,50,8,3,99,23,Well
7,2,86,F,96,12,10,154,68,Well
8,9,105,M,42,7,7,91,-14,Severe
18,2,218,M,35,7,1,85,-133,Severe
6,3,75,M,109,14,1,169,94,Well
16,7,199,F,86,11,10,142,-57,Severe
17,2,206,F,72,10,4,124,-82,Severe
10,7,127,F,101,13,4,160,33,Well
8,6,102,M,39,7,5,89,-13,Severe
16,0,192,M,68,10,0,120,-72,Severe
17,9,213,F,68,10,0,120,-93,Severe
11,4,136,M,52,8,5,101,-35,Severe
17,3,207,M,54,8,7,103,-104,Severe
18,4,220,M,48,8,1,97,-123,Severe
14,11,179,M,54,8,7,103,-76,Severe
6,8,80,F,11,5,8,68,-12,Severe
7,4,88,F,109,14,1,169,81,Well
14,10,178,M,39,7,5,89,-89,Severe
9,1,109,F,58,9,0,108,-1,Mild
10,2,122,M,108,14,0,168,46,Well
10,3,123,F,56,8,9,105,-18,Severe
7,6,90,M,83,11,6,138,48,Well
14,6,174,M,86,11,10,142,-32,Severe
7,11,95,M,68,10,0,120,25,Well
18,9,225,M,70,10,2,122,-103,Severe
6,9,81,M,70,10,2,122,41,Well
12,6,150,M,43,7,8,92,-58,Severe
14,5,173,M,104,13,7,163,-10,Severe
12,10,154,F,66,9,9,117,-37,Severe
9,7,115,M,38,7,4,88,-27,Severe
7,11,95,F,80,11,3,135,40,Well
18,11,227,F,85,11,9,141,-86,Severe
18,7,223,F,42,7,7,91,-132,Severe
17,7,211,F,80,11,3,135,-76,Severe
12,10,154,M,91,12,4,148,-6,Severe
10,0,120,M,108,14,0,168,48,Well
10,3,123,M,73,10,6,126,3,Good
12,3,147,M,62,9,4,112,-35,Severe
6,8,80,F,96,12,10,154,74,Well
18,1,217,M,5,5,5,65,-152,Severe
12,4,148,F,89,12,1,145,-3,Mild
12,11,155,F,15,5,11,71,-84,Severe
8,4,100,F,100,13,3,159,59,Well
8,3,99,M,16,5,11,71,-28,Severe
16,8,200,F,52,8,5,101,-99,Severe
17,9,213,M,75,10,9,129,-84,Severe
6,3,75,F,73,10,6,126,51,Well
9,8,116,M,35,7,1,85,-31,Severe
6,9,81,M,87,11,11,143,62,Well
15,8,188,F,38,7,4,88,-100,Severe
9,4,112,F,12,5,9,69,-43,Severe
16,0,192,M,48,8,1,97,-95,Severe
13,6,162,F,32,6,10,82,-80,Severe
6,11,83,M,61,9,3,111,28,Well
7,3,87,F,38,7,4,88,1,Good
17,11,215,F,59,9,1,109,-106,Severe
18,0,216,F,72,10,4,124,-92,Severe
16,11,203,F,13,5,9,69,-134,Severe
8,0,96,M,19,6,1,73,-23,Severe
5,9,69,M,90,12,3,147,78,Well
15,10,190,M,34,7,0,84,-106,Severe
5,8,68,F,18,6,1,73,5,Good
12,10,154,M,50,8,3,99,-55,Severe
8,5,101,F,22,6,3,75,-26,Severe
13,7,163,F,29,6,8,80,-83,Severe
10,6,126,M,10,5,7,67,-59,Severe
5,7,67,M,74,10,7,127,60,Well
18,3,219,F,40,7,5,89,-130,Severe
9,8,116,M,95,12,9,153,37,Well
17,4,208,M,109,14,1,169,-39,Severe
5,11,71,M,84,11,7,139,68,Well
7,11,95,F,30,6,9,81,-14,Severe
6,9,81,M,100,13,3,159,78,Well
17,8,212,F,95,12,9,153,-59,Severe
18,8,224,M,79,11,1,133,-91,Severe
12,10,154,M,70,10,2,122,-32,Severe
5,4,64,F,88,12,0,144,80,Well
15,1,181,F,74,10,7,127,-54,Severe
11,9,141,F,95,12,9,153,12,Well
5,1,61,M,103,13,6,162,101,Well
6,8,80,F,20,6,2,74,-6,Severe
5,3,63,F,11,5,8,68,5,Good
13,5,161,M,12,5,9,69,-92,Severe
18,1,217,M,7,5,6,66,-151,Severe
5,9,69,M,30,6,9,81,12,Well
13,1,157,M,24,6,5,77,-80,Severe
14,3,171,M,20,6,2,74,-97,Severe
13,5,161,F,26,6,6,78,-83,Severe
5,11,71,M,55,8,8,104,33,Well
14,3,171,F,67,9,10,118,-53,Severe
10,5,125,F,72,10,4,124,-1,Mild
15,7,187,M,100,13,3,159,-28,Severe
10,3,123,F,21,6,2,74,-49,Severe
9,0,108,M,4,5,4,64,-44,Severe
11,7,139,F,47,8,0,96,-43,Severe
10,2,122,M,13,5,9,69,-53,Severe
18,2,218,M,107,13,11,167,-51,Severe
8,2,98,F,80,11,3,135,37,Well
13,3,159,F,2,5,3,63,-96,Severe
6,6,78,F,22,6,3,75,-3,Mild
6,10,82,F,63,9,6,114,32,Well
5,1,61,F,72,10,4,124,63,Well
14,7,175,M,7,5,6,66,-109,Severe
18,0,216,M,57,8,10,106,-110,Severe
16,3,195,M,90,12,3,147,-48,Severe
14,1,169,M,10,5,7,67,-102,Severe
17,5,209,F,99,13,1,157,-52,Severe
9,6,114,F,84,11,7,139,25,Well
5,2,62,M,96,12,10,154,92,Well
16,4,196,M,68,10,0,120,-76,Severe
16,9,201,M,27,6,7,79,-122,Severe
9,5,113,M,76,10,10,130,17,Well
11,0,132,F,37,7,3,87,-45,Severe
13,6,162,F,84,11,7,139,-23,Severe
5,11,71,F,76,10,10,130,59,Well
13,7,163,M,51,8,4,100,-63,Severe
12,9,153,M,32,6,10,82,-71,Severe
9,3,111,M,78,11,0,132,21,Well
5,3,63,F,83,11,6,138,75,Well
18,8,224,F,63,9,6,114,-110,Severe
18,3,219,F,44,7,9,93,-126,Severe
12,6,150,F,28,6,8,80,-70,Severe
13,11,167,M,110,14,3,171,4,Good
14,8,176,F,78,11,0,132,-44,Severe
15,7,187,M,98,13,0,156,-31,Severe
10,6,126,M,43,7,8,92,-34,Severe
14,7,175,M,78,11,0,132,-43,Severe
17,0,204,M,92,12,5,149,-55,Severe
17,3,207,M,110,14,3,171,-36,Severe
9,6,114,M,57,8,10,106,-8,Severe
14,10,178,F,66,9,9,117,-61,Severe
11,6,138,M,64,9,7,115,-23,Severe
12,9,153,M,4,5,4,64,-89,Severe
17,8,212,M,72,10,4,124,-88,Severe
18,10,226,M,83,11,6,138,-88,Severe
15,3,183,F,54,8,7,103,-80,Severe
10,3,123,F,42,7,7,91,-32,Severe
14,0,168,F,110,14,3,171,3,Good
11,0,132,M,46,7,11,95,-37,Severe
9,11,119,M,91,12,4,148,29,Well
6,7,79,M,7,5,6,66,-13,Severe
13,7,163,F,24,6,5,77,-86,Severe
15,1,181,F,49,8,2,98,-83,Severe
9,8,116,F,10,5,7,67,-49,Severe
10,2,122,F,57,8,10,106,-16,Severe
12,2,146,F,51,8,4,100,-46,Severe
10,1,121,F,64,9,7,115,-6,Severe
15,5,185,M,85,11,9,141,-44,Severe
15,4,184,M,27,6,7,79,-105,Severe
6,11,83,M,45,7,10,94,11,Well
13,11,167,M,66,9,9,117,-50,Severe
12,5,149,F,29,6,8,80,-69,Severe
12,7,151,F,87,11,11,143,-8,Severe
16,11,203,M,67,9,10,118,-85,Severe
11,1,133,M,67,9,10,118,-15,Severe
13,2,158,F,82,11,5,137,-21,Severe
14,3,171,F,44,7,9,93,-78,Severe
18,2,218,M,7,5,6,66,-152,Severe
18,1,217,F,40,7,5,89,-128,Severe
17,1,205,F,94,12,7,151,-54,Severe
5,8,68,F,110,14,3,171,103,Well
13,4,160,M,33,6,11,83,-77,Severe
7,10,94,F,13,5,9,69,-25,Severe
18,6,222,F,50,8,3,99,-123,Severe
18,9,225,F,105,13,9,165,-60,Severe
11,4,136,F,11,5,8,68,-68,Severe
13,2,158,M,107,13,11,167,9,Well
17,8,212,M,8,5,6,66,-146,Severe
14,9,177,F,32,6,10,82,-95,Severe
11,5,137,F,38,7,4,88,-49,Severe
5,1,61,M,61,9,3,111,50,Well
10,8,128,F,55,8,8,104,-24,Severe
7,9,93,M,51,8,4,100,7,Well
18,6,222,M,54,8,7,103,-119,Severe
11,3,135,M,81,11,4,136,1,Good
14,5,173,F,31,6,9,81,-92,Severe
17,0,204,M,103,13,6,162,-42,Severe
13,9,165,F,6,5,5,65,-100,Severe
16,1,193,F,39,7,5,89,-104,Severe
8,8,104,M,24,6,5,77,-27,Severe
16,10,202,F,57,8,10,106,-96,Severe
7,6,90,F,45,7,10,94,4,Good
6,1,73,M,62,9,4,112,39,Well
8,3,99,M,37,7,3,87,-12,Severe
7,10,94,M,67,9,10,118,24,Well
13,2,158,M,64,9,7,115,-43,Severe
13,10,166,F,102,13,6,162,-4,Mild
8,2,98,M,62,9,4,112,14,Well
11,10,142,M,77,10,11,131,-11,Severe
17,7,211,M,84,11,7,139,-72,Severe
11,4,136,F,57,8,10,106,-30,Severe
11,7,139,M,60,9,2,110,-29,Severe
9,10,118,F,6,5,5,65,-53,Severe
16,3,195,M,41,7,6,90,-105,Severe
14,3,171,F,34,7,0,84,-87,Severe
15,10,190,F,64,9,7,115,-75,Severe
7,8,92,F,97,12,11,155,63,Well
10,1,121,F,54,8,7,103,-18,Severe
18,7,223,M,5,5,5,65,-158,Severe
12,11,155,F,49,8,2,98,-57,Severe
16,2,194,F,72,10,4,124,-70,Severe
12,11,155,F,10,5,7,67,-88,Severe
14,1,169,M,25,6,5,77,-92,Severe
6,11,83,F,42,7,7,91,8,Well
15,4,184,M,92,12,5,149,-35,Severe
15,9,189,F,18,6,1,73,-116,Severe
12,5,149,M,23,6,4,76,-73,Severe
14,1,169,F,24,6,5,77,-92,Severe
17,11,215,F,67,9,10,118,-97,Severe
13,3,159,F,104,13,7,163,4,Good
8,1,97,M,74,10,7,127,30,Well
6,4,76,F,43,7,8,92,16,Well
11,3,135,F,44,7,9,93,-42,Severe
12,0,144,F,41,7,6,90,-54,Severe
9,10,118,F,27,6,7,79,-39,Severe
7,8,92,M,9,5,7,67,-25,Severe
11,1,133,F,71,10,3,123,-10,Severe
13,9,165,M,49,8,2,98,-67,Severe
10,9,129,F,55,8,8,104,-25,Severe
17,7,211,M,54,8,7,103,-108,Severe
10,10,130,F,97,12,11,155,25,Well
17,9,213,F,46,7,11,95,-118,Severe
10,11,131,F,57,8,10,106,-25,Severe
8,6,102,M,16,5,11,71,-31,Severe
9,0,108,F,84,11,7,139,31,Well
18,3,219,F,69,10,1,121,-98,Severe
11,8,140,M,94,12,7,151,11,Well
14,5,173,M,68,10,0,120,-53,Severe
8,4,100,M,84,11,7,139,39,Well
15,5,185,M,25,6,5,77,-108,Severe
6,9,81,F,102,13,6,162,81,Well
6,3,75,F,59,9,1,109,34,Well
7,5,89,M,60,9,2,110,21,Well
17,6,210,M,70,10,2,122,-88,Severe
8,4,100,F,17,6,0,72,-28,Severe
8,1,97,M,10,5,7,67,-30,Severe
18,4,220,F,67,9,10,118,-102,Severe
14,9,177,M,107,13,11,167,-10,Severe
13,1,157,F,67,9,10,118,-39,Severe
10,11,131,M,26,6,6,78,-53,Severe
12,9,153,M,90,12,3,147,-6,Severe
11,3,135,F,55,8,8,104,-31,Severe
12,2,146,M,80,11,3,135,-11,Severe
12,9,153,M,62,9,4,112,-41,Severe
15,3,183,F,18,6,1,73,-110,Severe
12,11,155,M,71,10,3,123,-32,Severe
8,3,99,M,98,13,0,156,57,Well
7,5,89,F,58,9,0,108,19,Well
11,0,132,M,41,7,6,90,-42,Severe
14,4,172,M,11,5,8,68,-104,Severe
12,3,147,F,57,8,10,106,-41,Severe
18,3,219,M,70,10,2,122,-97,Severe
11,7,139,M,93,12,6,150,11,Well
17,10,214,M,4,5,4,64,-150,Severe
13,2,158,F,55,8,8,104,-54,Severe
10,1,121,F,51,8,4,100,-21,Severe
16,6,198,M,70,10,2,122,-76,Severe
10,8,128,F,72,10,4,124,-4,Mild
16,5,197,M,76,10,10,130,-67,Severe
15,3,183,M,21,6,2,74,-109,Severe
15,9,189,M,38,7,4,88,-101,Severe
5,2,62,F,85,11,9,141,79,Well
14,11,179,M,18,6,1,73,-106,Severe
11,10,142,M,62,9,4,112,-30,Severe
5,0,60,F,56,8,9,105,45,Well
9,8,116,F,46,7,11,95,-21,Severe
16,9,201,M,24,6,5,77,-124,Severe
6,5,77,M,45,7,10,94,17,Well
13,11,167,M,101,13,4,160,-7,Severe
15,2,182,M,4,5,4,64,-118,Severe
12,3,147,M,9,5,7,67,-80,Severe
10,3,123,F,51,8,4,100,-23,Severe
11,3,135,F,22,6,3,75,-60,Severe
6,3,75,F,10,5,7,67,-8,Severe
13,8,164,F,110,14,3,171,7,Well
18,8,224,M,16,5,11,71,-153,Severe
6,11,83,F,66,9,9,117,34,Well
12,0,144,M,15,5,11,71,-73,Severe
6,0,72,F,67,9,10,118,46,Well
7,4,88,M,4,5,4,64,-24,Severe
12,1,145,M,66,9,9,117,-28,Severe
11,3,135,M,10,5,7,67,-68,Severe
16,4,196,M,55,8,8,104,-92,Severe
16,5,197,M,57,8,10,106,-91,Severe
9,3,111,F,104,13,7,163,52,Well
6,9,81,M,62,9,4,112,31,Well
15,7,187,M,94,12,7,151,-36,Severe
5,3,63,F,96,12,10,154,91,Well
14,3,171,M,93,12,6,150,-21,Severe
9,8,116,M,55,8,8,104,-12,Severe
15,9,189,M,48,8,1,97,-92,Severe
11,0,132,F,95,12,9,153,21,Well
14,3,171,M,28,6,8,80,-91,Severe
13,9,165,F,59,9,1,109,-56,Severe
11,0,132,F,46,7,11,95,-37,Severe
14,0,168,M,98,13,0,156,-12,Severe
17,3,207,F,92,12,5,149,-58,Severe
11,4,136,M,100,13,3,159,23,Well
17,1,205,M,51,8,4,100,-105,Severe
8,1,97,M,62,9,4,112,15,Well
7,2,86,M,47,8,0,96,10,Well
13,3,159,F,54,8,7,103,-56,Severe
15,0,180,F,79,11,1,133,-47,Severe
15,3,183,M,108,14,0,168,-15,Severe
16,3,195,F,79,11,1,133,-62,Severe
11,2,134,F,42,7,7,91,-43,Severe
12,9,153,M,51,8,4,100,-53,Severe
7,8,92,F,63,9,6,114,22,Well
18,8,224,F,2,5,3,63,-161,Severe
10,8,128,M,75,10,9,129,1,Good
8,4,100,M,10,5,7,67,-33,Severe
6,11,83,M,39,7,5,89,6,Well
16,7,199,M,76,10,10,130,-69,Severe
12,1,145,F,50,8,3,99,-46,Severe
9,1,109,F,2,5,3,63,-46,Severe
17,8,212,M,26,6,6,78,-134,Severe
14,1,169,F,36,7,2,86,-83,Severe
14,2,170,M,24,6,5,77,-93,Severe
14,10,178,M,31,6,9,81,-97,Severe
6,8,80,F,14,5,10,70,-10,Severe
15,2,182,F,32,6,10,82,-100,Severe
15,10,190,F,21,6,2,74,-116,Severe
5,2,62,F,89,12,1,145,83,Well
7,8,92,M,57,8,10,106,14,Well
17,3,207,M,15,5,11,71,-136,Severe
9,2,110,M,50,8,3,99,-11,Severe
12,11,155,F,82,11,5,137,-18,Severe
13,11,167,F,47,8,0,96,-71,Severe
9,9,117,F,38,7,4,88,-29,Severe
17,1,205,F,16,5,11,71,-134,Severe
17,7,211,F,84,11,7,139,-72,Severe
5,8,68,F,52,8,5,101,33,Well
14,9,177,F,34,7,0,84,-93,Severe
15,2,182,F,34,7,0,84,-98,Severe
14,6,174,F,80,11,3,135,-39,Severe
18,8,224,F,36,7,2,86,-138,Severe
7,8,92,F,52,8,5,101,9,Well
15,3,183,F,107,13,11,167,-16,Severe
12,6,150,F,110,14,3,171,21,Well
11,0,132,M,100,13,3,159,27,Well
6,10,82,F,83,11,6,138,56,Well
12,5,149,M,28,6,8,80,-69,Severe
8,3,99,F,55,8,8,104,5,Good
12,1,145,F,38,7,4,88,-57,Severe
9,9,117,F,26,6,6,78,-39,Severe
11,9,141,F,81,11,4,136,-5,Mild
9,3,111,F,50,8,3,99,-12,Severe
8,3,99,M,52,8,5,101,2,Good
5,10,70,M,40,7,5,89,19,Well
18,1,217,M,84,11,7,139,-78,Severe
14,3,171,M,89,12,1,145,-26,Severe
18,1,217,F,5,5,5,65,-152,Severe
11,1,133,F,110,14,3,171,38,Well
16,10,202,F,74,10,7,127,-75,Severe
16,9,201,F,34,7,0,84,-117,Severe
13,11,167,F,40,7,5,89,-78,Severe
6,6,78,M,8,5,6,66,-12,Severe
14,3,171,F,7,5,6,66,-105,Severe
15,9,189,F,27,6,7,79,-110,Severe
7,3,87,F,54,8,7,103,16,Well
16,9,201,M,32,6,10,82,-119,Severe
12,5,149,F,24,6,5,77,-72,Severe
13,11,167,M,27,6,7,79,-88,Severe
5,3,63,M,74,10,7,127,64,Well
14,3,171,F,79,11,1,133,-38,Severe
16,6,198,M,22,6,3,75,-123,Severe
15,0,180,M,99,13,1,157,-23,Severe
5,2,62,F,90,12,3,147,85,Well
18,5,221,F,86,11,10,142,-79,Severe
10,3,123,F,103,13,6,162,39,Well
17,9,213,M,54,8,7,103,-110,Severe
11,9,141,M,4,5,4,64,-77,Severe
6,4,76,M,15,5,11,71,-5,Mild
10,4,124,F,37,7,3,87,-37,Severe
7,3,87,M,44,7,9,93,6,Well
16,3,195,F,7,5,6,66,-129,Severe
10,6,126,F,12,5,9,69,-57,Severe
10,3,123,F,98,13,0,156,33,Well
5,7,67,M,92,12,5,149,82,Well
11,9,141,F,57,8,10,106,-35,Severe
7,1,85,F,37,7,3,87,2,Good
11,3,135,F,29,6,8,80,-55,Severe
13,9,165,F,35,7,1,85,-80,Severe
17,4,208,F,39,7,5,89,-119,Severe
13,7,163,F,102,13,6,162,-1,Mild
11,5,137,F,70,10,2,122,-15,Severe
11,10,142,F,11,5,8,68,-74,Severe
5,3,63,M,73,10,6,126,63,Well
8,6,102,F,14,5,10,70,-32,Severe
10,11,131,M,8,5,6,66,-65,Severe
6,3,75,F,102,13,6,162,87,Well
9,8,116,M,37,7,3,87,-29,Severe
16,6,198,F,62,9,4,112,-86,Severe
15,4,184,F,95,12,9,153,-31,Severe
15,11,191,F,68,10,0,120,-71,Severe
18,9,225,F,4,5,4,64,-161,Severe
6,3,75,F,25,6,5,77,2,Good
14,5,173,F,106,13,10,166,-7,Severe
5,3,63,M,3,5,3,63,0,Neutral
14,4,172,M,46,7,11,95,-77,Severe
15,3,183,M,87,11,11,143,-40,Severe
11,4,136,F,2,5,3,63,-73,Severe
6,6,78,F,3,5,3,63,-15,Severe
18,5,221,M,75,10,9,129,-92,Severe
7,4,88,M,102,13,6,162,74,Well
8,7,103,F,101,13,4,160,57,Well
9,7,115,F,80,11,3,135,20,Well
18,3,219,M,50,8,3,99,-120,Severe
6,1,73,M,60,9,2,110,37,Well
9,4,112,M,45,7,10,94,-18,Severe
10,3,123,F,55,8,8,104,-19,Severe
8,5,101,F,28,6,8,80,-21,Severe
10,7,127,M,34,7,0,84,-43,Severe
8,1,97,M,4,5,4,64,-33,Severe
15,10,190,M,44,7,9,93,-97,Severe
6,3,75,F,56,8,9,105,30,Well
11,8,140,M,44,7,9,93,-47,Severe
8,5,101,F,103,13,6,162,61,Well
17,7,211,F,98,13,0,156,-55,Severe
15,10,190,F,75,10,9,129,-61,Severe
18,7,223,M,43,7,8,92,-131,Severe
9,3,111,M,92,12,5,149,38,Well
18,2,218,M,6,5,5,65,-153,Severe
17,3,207,F,40,7,5,89,-118,Severe
11,6,138,F,102,13,6,162,24,Well
8,8,104,M,52,8,5,101,-3,Mild
16,3,195,F,3,5,3,63,-132,Severe
5,11,71,M,66,9,9,117,46,Well
11,2,134,M,100,13,3,159,25,Well
11,9,141,M,9,5,7,67,-74,Severe
6,11,83,F,84,11,7,139,56,Well
7,8,92,F,8,5,6,66,-26,Severe
10,11,131,F,109,14,1,169,38,Well
12,0,144,F,30,6,9,81,-63,Severe
15,10,190,M,12,5,9,69,-121,Severe
18,8,224,F,100,13,3,159,-65,Severe
18,7,223,M,35,7,1,85,-138,Severe
15,2,182,F,80,11,3,135,-47,Severe
12,7,151,M,35,7,1,85,-66,Severe
9,8,116,M,8,5,6,66,-50,Severe
10,7,127,F,88,12,0,144,17,Well
17,1,205,M,28,6,8,80,-125,Severe
9,10,118,M,83,11,6,138,20,Well
17,8,212,F,61,9,3,111,-101,Severe
17,3,207,F,82,11,5,137,-70,Severe
6,3,75,F,25,6,5,77,2,Good
14,11,179,M,51,8,4,100,-79,Severe
9,5,113,F,31,6,9,81,-32,Severe
13,9,165,M,69,10,1,121,-44,Severe
17,5,209,F,90,12,3,147,-62,Severe
13,5,161,M,78,11,0,132,-29,Severe
10,3,123,M,92,12,5,149,26,Well
16,10,202,F,93,12,6,150,-52,Severe
14,7,175,M,11,5,8,68,-107,Severe
15,11,191,F,61,9,3,111,-80,Severe
8,11,107,F,95,12,9,153,46,Well
6,5,77,M,11,5,8,68,-9,Severe
16,6,198,F,24,6,5,77,-121,Severe
9,6,114,F,90,12,3,147,33,Well
11,1,133,F,80,11,3,135,2,Good
17,7,211,M,102,13,6,162,-49,Severe
8,5,101,M,14,5,10,70,-31,Severe
7,5,89,M,37,7,3,87,-2,Mild
6,5,77,M,76,10,10,130,53,Well
11,6,138,F,14,5,10,70,-68,Severe
13,6,162,M,13,5,9,69,-93,Severe
16,8,200,F,106,13,10,166,-34,Severe
9,7,115,F,63,9,6,114,-1,Mild
15,5,185,M,16,5,11,71,-114,Severe
12,3,147,F,47,8,0,96,-51,Severe
6,7,79,F,34,7,0,84,5,Good
16,4,196,M,42,7,7,91,-105,Severe
14,1,169,M,33,6,11,83,-86,Severe
7,2,86,F,71,10,3,123,37,Well
11,11,143,M,9,5,7,67,-76,Severe
5,8,68,F,83,11,6,138,70,Well
17,11,215,F,100,13,3,159,-56,Severe
15,0,180,F,58,9,0,108,-72,Severe
8,3,99,F,108,14,0,168,69,Well
10,6,126,F,24,6,5,77,-49,Severe
6,9,81,F,52,8,5,101,20,Well
16,0,192,F,45,7,10,94,-98,Severe
13,11,167,F,82,11,5,137,-30,Severe
13,0,156,F,40,7,5,89,-67,Severe
14,11,179,F,54,8,7,103,-76,Severe
5,1,61,F,85,11,9,141,80,Well
7,3,87,M,21,6,2,74,-13,Severe
14,0,168,F,10,5,7,67,-101,Severe
17,9,213,M,58,9,0,108,-105,Severe
13,2,158,M,88,12,0,144,-14,Severe
7,5,89,M,25,6,5,77,-12,Severe
10,11,131,F,17,6,0,72,-59,Severe
6,10,82,F,54,8,7,103,21,Well
6,8,80,F,37,7,3,87,7,Well
12,2,146,F,93,12,6,150,4,Good
16,0,192,F,107,13,11,167,-25,Severe
8,11,107,F,64,9,7,115,8,Well
12,8,152,F,34,7,0,84,-68,Severe
7,8,92,M,10,5,7,67,-25,Severe
15,5,185,F,43,7,8,92,-93,Severe
16,4,196,F,102,13,6,162,-34,Severe
16,11,203,M,19,6,1,73,-130,Severe
6,5,77,M,13,5,9,69,-8,Severe
7,0,84,M,83,11,6,138,54,Well
15,9,189,M,94,12,7,151,-38,Severe
18,7,223,M,6,5,5,65,-158,Severe
5,3,63,F,49,8,2,98,35,Well
13,7,163,M,95,12,9,153,-10,Severe
9,4,112,M,26,6,6,78,-34,Severe
14,6,174,F,17,6,0,72,-102,Severe
12,2,146,F,103,13,6,162,16,Well
5,5,65,F,96,12,10,154,89,Well
18,6,222,M,28,6,8,80,-142,Severe
9,0,108,F,28,6,8,80,-28,Severe
5,10,70,M,63,9,6,114,44,Well
6,4,76,M,87,11,11,143,67,Well
15,0,180,M,5,5,5,65,-115,Severe
13,3,159,F,57,8,10,106,-53,Severe
14,8,176,M,75,10,9,129,-47,Severe
10,7,127,F,2,5,3,63,-64,Severe
6,9,81,M,64,9,7,115,34,Well
5,11,71,M,96,12,10,154,83,Well
15,2,182,F,45,7,10,94,-88,Severe
7,0,84,M,27,6,7,79,-5,Mild
6,9,81,M,68,10,0,120,39,Well
12,8,152,M,72,10,4,124,-28,Severe
17,10,214,M,5,5,5,65,-149,Severe
7,1,85,M,103,13,6,162,77,Well
5,1,61,F,102,13,6,162,101,Well
9,5,113,F,107,13,11,167,54,Well
5,11,71,F,11,5,8,68,-3,Mild
7,9,93,M,82,11,5,137,44,Well
16,11,203,M,13,5,9,69,-134,Severe
12,7,151,F,32,6,10,82,-69,Severe
8,1,97,F,100,13,3,159,62,Well
12,3,147,M,9,5,7,67,-80,Severe
9,5,113,M,74,10,7,127,14,Well
13,2,158,M,32,6,10,82,-76,Severe
12,3,147,F,53,8,6,102,-45,Severe
10,3,123,M,8,5,6,66,-57,Severe
16,11,203,M,15,5,11,71,-132,Severe
13,6,162,F,78,11,0,132,-30,Severe
6,8,80,F,54,8,7,103,23,Well
6,10,82,M,85,11,9,141,59,Well
18,10,226,F,105,13,9,165,-61,Severe
7,5,89,F,63,9,6,114,25,Well
16,2,194,M,3,5,3,63,-131,Severe
7,1,85,F,39,7,5,89,4,Good
10,3,123,M,34,7,0,84,-39,Severe
14,7,175,M,63,9,6,114,-61,Severe
10,2,122,F,28,6,8,80,-42,Severe
11,6,138,F,66,9,9,117,-21,Severe
16,8,200,F,91,12,4,148,-52,Severe
8,7,103,F,102,13,6,162,59,Well
8,3,99,M,64,9,7,115,16,Well
10,11,131,F,91,12,4,148,17,Well
15,3,183,F,100,13,3,159,-24,Severe
5,3,63,F,99,13,1,157,94,Well
13,9,165,M,13,5,9,69,-96,Severe
15,3,183,F,27,6,7,79,-104,Severe
9,3,111,F,95,12,9,153,42,Well
9,2,110,F,17,6,0,72,-38,Severe
15,11,191,M,57,8,10,106,-85,Severe
6,11,83,F,57,8,10,106,23,Well
17,6,210,M,101,13,4,160,-50,Severe
10,4,124,M,96,12,10,154,30,Well
8,5,101,M,76,10,10,130,29,Well
5,0,60,M,64,9,7,115,55,Well
13,4,160,M,102,13,6,162,2,Good
18,0,216,M,48,8,1,97,-119,Severe
8,1,97,F,38,7,4,88,-9,Severe
18,7,223,M,66,9,9,117,-106,Severe
7,4,88,F,41,7,6,90,2,Good
12,11,155,M,32,6,10,82,-73,Severe
8,2,98,M,101,13,4,160,62,Well
6,3,75,F,3,5,3,63,-12,Severe
13,11,167,M,30,6,9,81,-86,Severe
9,3,111,M,93,12,6,150,39,Well
7,11,95,M,57,8,10,106,11,Well
5,5,65,M,22,6,3,75,10,Well
14,11,179,F,38,7,4,88,-91,Severe
7,7,91,M,103,13,6,162,71,Well
7,1,85,F,87,11,11,143,58,Well
12,10,154,F,74,10,7,127,-27,Severe
13,6,162,F,90,12,3,147,-15,Severe
11,0,132,F,107,13,11,167,35,Well
17,2,206,M,109,14,1,169,-37,Severe
9,7,115,F,51,8,4,100,-15,Severe
15,3,183,F,9,5,7,67,-116,Severe
14,3,171,M,80,11,3,135,-36,Severe
15,8,188,F,107,13,11,167,-21,Severe
17,5,209,F,4,5,4,64,-145,Severe
5,6,66,F,59,9,1,109,43,Well
17,9,213,M,14,5,10,70,-143,Severe
13,4,160,M,91,12,4,148,-12,Severe
7,0,84,M,21,6,2,74,-10,Severe
13,8,164,M,35,7,1,85,-79,Severe
16,3,195,F,101,13,4,160,-35,Severe
12,3,147,F,15,5,11,71,-76,Severe
16,2,194,F,50,8,3,99,-95,Severe
10,0,120,M,27,6,7,79,-41,Severe
16,9,201,F,35,7,1,85,-116,Severe
7,5,89,F,9,5,7,67,-22,Severe
14,4,172,F,80,11,3,135,-37,Severe
15,8,188,F,8,5,6,66,-122,Severe
18,6,222,M,105,13,9,165,-57,Severe
11,11,143,F,51,8,4,100,-43,Severe
5,1,61,F,105,13,9,165,104,Well
18,1,217,F,6,5,5,65,-152,Severe
5,0,60,M,58,9,0,108,48,Well
18,4,220,M,15,5,11,71,-149,Severe
5,2,62,M,73,10,6,126,64,Well
9,7,115,M,71,10,3,123,8,Well
10,10,130,F,4,5,4,64,-66,Severe
7,5,89,F,18,6,1,73,-16,Severe
12,6,150,F,71,10,3,123,-27,Severe
14,2,170,F,34,7,0,84,-86,Severe
5,3,63,F,88,12,0,144,81,Well
16,10,202,M,27,6,7,79,-123,Severe
9,2,110,M,60,9,2,110,0,Neutral
18,7,223,F,29,6,8,80,-143,Severe
17,10,214,F,35,7,1,85,-129,Severe
15,1,181,F,58,9,0,108,-73,Severe
15,3,183,M,18,6,1,73,-110,Severe
6,1,73,F,32,6,10,82,9,Well
9,11,119,M,41,7,6,90,-29,Severe
15,6,186,M,24,6,5,77,-109,Severe
11,2,134,M,74,10,7,127,-7,Severe
14,10,178,M,96,12,10,154,-24,Severe
15,5,185,F,92,12,5,149,-36,Severe
5,3,63,M,18,6,1,73,10,Well
15,3,183,F,109,14,1,169,-14,Severe
14,2,170,M,18,6,1,73,-97,Severe
14,10,178,M,64,9,7,115,-63,Severe
9,9,117,M,32,6,10,82,-35,Severe
6,0,72,M,85,11,9,141,69,Well
6,6,78,M,84,11,7,139,61,Well
7,7,91,F,61,9,3,111,20,Well
5,3,63,M,49,8,2,98,35,Well
7,1,85,F,9,5,7,67,-18,Severe
14,6,174,F,61,9,3,111,-63,Severe
13,2,158,F,92,12,5,149,-9,Severe
17,3,207,F,100,13,3,159,-48,Severe
5,3,63,F,73,10,6,126,63,Well
17,6,210,M,81,11,4,136,-74,Severe
8,9,105,M,48,8,1,97,-8,Severe
11,9,141,M,104,13,7,163,22,Well
12,4,148,F,94,12,7,151,3,Good
18,9,225,M,48,8,1,97,-128,Severe
8,11,107,M,99,13,1,157,50,Well
8,2,98,F,76,10,10,130,32,Well
18,5,221,F,29,6,8,80,-141,Severe
11,6,138,F,19,6,1,73,-65,Severe
11,7,139,F,105,13,9,165,26,Well
5,9,69,M,87,11,11,143,74,Well
5,5,65,M,109,14,1,169,104,Well
9,1,109,F,109,14,1,169,60,Well
17,8,212,M,2,5,3,63,-149,Severe
10,7,127,M,68,10,0,120,-7,Severe
8,8,104,F,62,9,4,112,8,Well
10,3,123,F,71,10,3,123,0,Neutral
14,9,177,F,66,9,9,117,-60,Severe
5,3,63,M,12,5,9,69,6,Well
6,9,81,F,37,7,3,87,6,Well
13,4,160,F,97,12,11,155,-5,Mild
5,3,63,M,93,12,6,150,87,Well
15,0,180,M,92,12,5,149,-31,Severe
6,4,76,M,66,9,9,117,41,Well
18,7,223,M,12,5,9,69,-154,Severe
16,4,196,F,25,6,5,77,-119,Severe
14,5,173,M,91,12,4,148,-25,Severe
5,4,64,M,47,8,0,96,32,Well
13,7,163,M,90,12,3,147,-16,Severe
9,3,111,F,9,5,7,67,-44,Severe
9,6,114,M,34,7,0,84,-30,Severe
14,8,176,M,51,8,4,100,-76,Severe
13,0,156,F,37,7,3,87,-69,Severe
7,2,86,M,86,11,10,142,56,Well
9,10,118,F,21,6,2,74,-44,Severe
18,4,220,F,46,7,11,95,-125,Severe
18,1,217,M,14,5,10,70,-147,Severe
6,4,76,F,110,14,3,171,95,Well
9,6,114,M,2,5,3,63,-51,Severe
8,7,103,M,103,13,6,162,59,Well
7,10,94,F,45,7,10,94,0,Neutral
17,4,208,M,67,9,10,118,-90,Severe
12,2,146,M,17,6,0,72,-74,Severe
7,11,95,F,21,6,2,74,-21,Severe
7,11,95,F,96,12,10,154,59,Well
15,3,183,M,27,6,7,79,-104,Severe
14,11,179,F,108,14,0,168,-11,Severe
5,8,68,M,93,12,6,150,82,Well
8,8,104,M,17,6,0,72,-32,Severe
6,8,80,M,15,5,11,71,-9,Severe
14,3,171,F,16,5,11,71,-100,Severe
10,6,126,M,89,12,1,145,19,Well
12,0,144,F,61,9,3,111,-33,Severe
17,1,205,F,96,12,10,154,-51,Severe
13,10,166,M,81,11,4,136,-30,Severe
14,2,170,F,89,12,1,145,-25,Severe
18,3,219,M,48,8,1,97,-122,Severe
11,5,137,M,25,6,5,77,-60,Severe
11,8,140,M,51,8,4,100,-40,Severe
12,8,152,F,82,11,5,137,-15,Severe
16,10,202,M,18,6,1,73,-129,Severe
12,8,152,F,35,7,1,85,-67,Severe
5,6,66,M,6,5,5,65,-1,Mild
10,11,131,M,74,10,7,127,-4,Mild
15,10,190,F,12,5,9,69,-121,Severe
11,4,136,F,38,7,4,88,-48,Severe
15,3,183,M,20,6,2,74,-109,Severe
8,3,99,F,56,8,9,105,6,Well
12,7,151,M,101,13,4,160,9,Well
13,10,166,F,108,14,0,168,2,Good
9,4,112,F,94,12,7,151,39,Well
17,3,207,M,66,9,9,117,-90,Severe
13,11,167,F,3,5,3,63,-104,Severe
10,4,124,M,33,6,11,83,-41,Severe
16,3,195,F,16,5,11,71,-124,Severe
14,5,173,F,36,7,2,86,-87,Severe
6,11,83,F,27,6,7,79,-4,Mild
15,10,190,M,77,10,11,131,-59,Severe
6,0,72,M,100,13,3,159,87,Well
17,7,211,M,36,7,2,86,-125,Severe
18,6,222,M,49,8,2,98,-124,Severe
8,5,101,M,18,6,1,73,-28,Severe
7,3,87,M,51,8,4,100,13,Well
17,1,205,M,74,10,7,127,-78,Severe
7,3,87,M,105,13,9,165,78,Well
14,9,177,F,26,6,6,78,-99,Severe
8,3,99,M,41,7,6,90,-9,Severe
6,8,80,F,28,6,8,80,0,Neutral
12,9,153,F,87,11,11,143,-10,Severe
14,8,176,M,26,6,6,78,-98,Severe
7,0,84,F,5,5,5,65,-19,Severe
6,6,78,F,101,13,4,160,82,Well
14,4,172,M,13,5,9,69,-103,Severe
5,3,63,M,14,5,10,70,7,Well
6,0,72,M,21,6,2,74,2,Good
8,8,104,M,50,8,3,99,-5,Mild
13,2,158,M,110,14,3,171,13,Well
12,5,149,M,6,5,5,65,-84,Severe
18,0,216,M,75,10,9,129,-87,Severe
8,0,96,F,6,5,5,65,-31,Severe
15,8,188,M,24,6,5,77,-111,Severe
12,7,151,M,75,10,9,129,-22,Severe
17,7,211,F,29,6,8,80,-131,Severe
9,3,111,F,21,6,2,74,-37,Severe
15,6,186,F,47,8,0,96,-90,Severe
14,9,177,F,77,10,11,131,-46,Severe
7,5,89,F,98,13,0,156,67,Well
15,8,188,M,84,11,7,139,-49,Severe
10,7,127,M,10,5,7,67,-60,Severe
7,4,88,M,62,9,4,112,24,Well
10,2,122,M,10,5,7,67,-55,Severe
11,9,141,M,103,13,6,162,21,Well
9,8,116,F,3,5,3,63,-53,Severe
7,4,88,M,51,8,4,100,12,Well
17,5,209,F,95,12,9,153,-56,Severe
10,4,124,M,98,13,0,156,32,Well
8,3,99,F,64,9,7,115,16,Well
8,3,99,M,73,10,6,126,27,Well
10,3,123,F,105,13,9,165,42,Well
16,5,197,F,69,10,1,121,-76,Severe
11,8,140,F,23,6,4,76,-64,Severe
18,7,223,M,59,9,1,109,-114,Severe
14,7,175,F,73,10,6,126,-49,Severe
9,10,118,M,101,13,4,160,42,Well
9,11,119,M,8,5,6,66,-53,Severe
18,4,220,F,103,13,6,162,-58,Severe
13,10,166,M,67,9,10,118,-48,Severe
7,9,93,F,108,14,0,168,75,Well
16,8,200,F,33,6,11,83,-117,Severe
18,7,223,F,70,10,2,122,-101,Severe
14,9,177,F,45,7,10,94,-83,Severe
7,5,89,F,78,11,0,132,43,Well
16,10,202,F,79,11,1,133,-69,Severe
18,3,219,M,49,8,2,98,-121,Severe
11,0,132,M,47,8,0,96,-36,Severe
12,3,147,F,69,10,1,121,-26,Severe
13,0,156,M,17,6,0,72,-84,Severe
9,10,118,F,107,13,11,167,49,Well
18,6,222,M,99,13,1,157,-65,Severe
7,5,89,F,19,6,1,73,-16,Severe
17,4,208,F,34,7,0,84,-124,Severe
13,3,159,F,100,13,3,159,0,Neutral
15,8,188,M,26,6,6,78,-110,Severe
8,0,96,F,59,9,1,109,13,Well
16,3,195,M,44,7,9,93,-102,Severe
11,3,135,F,47,8,0,96,-39,Severe
18,3,219,F,30,6,9,81,-138,Severe
11,3,135,M,44,7,9,93,-42,Severe
16,7,199,F,89,12,1,145,-54,Severe
15,7,187,F,44,7,9,93,-94,Severe
11,5,137,F,66,9,9,117,-20,Severe
9,8,116,F,31,6,9,81,-35,Severe
12,3,147,F,82,11,5,137,-10,Severe
18,1,217,M,99,13,1,157,-60,Severe
7,6,90,F,9,5,7,67,-23,Severe
13,3,159,F,36,7,2,86,-73,Severe
17,7,211,M,29,6,8,80,-131,Severe
17,4,208,M,60,9,2,110,-98,Severe
16,4,196,F,53,8,6,102,-94,Severe
16,7,199,F,82,11,5,137,-62,Severe
11,1,133,F,48,8,1,97,-36,Severe
12,3,147,F,54,8,7,103,-44,Severe
10,9,129,M,86,11,10,142,13,Well
10,3,123,M,109,14,1,169,46,Well
13,11,167,M,81,11,4,136,-31,Severe
6,0,72,M,43,7,8,92,20,Well
7,10,94,F,68,10,0,120,26,Well
9,7,115,F,74,10,7,127,12,Well
14,9,177,F,16,5,11,71,-106,Severe
12,2,146,M,14,5,10,70,-76,Severe
18,5,221,F,59,9,1,109,-112,Severe
9,7,115,M,107,13,11,167,52,Well
9,4,112,M,33,6,11,83,-29,Severe
17,4,208,M,93,12,6,150,-58,Severe
9,3,111,M,73,10,6,126,15,Well
15,10,190,M,81,11,4,136,-54,Severe
18,1,217,F,93,12,6,150,-67,Severe
17,3,207,M,12,5,9,69,-138,Severe
6,9,81,M,80,11,3,135,54,Well
7,0,84,F,41,7,6,90,6,Well
18,11,227,M,34,7,0,84,-143,Severe
9,3,111,M,82,11,5,137,26,Well
8,10,106,M,98,13,0,156,50,Well
9,6,114,M,19,6,1,73,-41,Severe
11,7,139,F,70,10,2,122,-17,Severe
17,1,205,F,92,12,5,149,-56,Severe
16,3,195,F,16,5,11,71,-124,Severe
10,3,123,M,34,7,0,84,-39,Severe
10,8,128,M,87,11,11,143,15,Well
9,10,118,M,89,12,1,145,27,Well
13,10,166,F,91,12,4,148,-18,Severe
8,6,102,F,49,8,2,98,-4,Mild
6,4,76,M,16,5,11,71,-5,Mild
6,3,75,M,105,13,9,165,90,Well
6,3,75,F,75,10,9,129,54,Well
14,4,172,M,65,9,8,116,-56,Severe
7,8,92,M,108,14,0,168,76,Well
6,3,75,M,85,11,9,141,66,Well
8,5,101,M,21,6,2,74,-27,Severe
5,6,66,M,23,6,4,76,10,Well
5,11,71,F,68,10,0,120,49,Well
5,11,71,M,60,9,2,110,39,Well
11,9,141,F,91,12,4,148,7,Well
13,6,162,M,77,10,11,131,-31,Severe
10,10,130,M,31,6,9,81,-49,Severe
17,3,207,M,49,8,2,98,-109,Severe
15,6,186,M,15,5,11,71,-115,Severe
14,4,172,F,76,10,10,130,-42,Severe
13,6,162,M,109,14,1,169,7,Well
16,9,201,M,56,8,9,105,-96,Severe
10,2,122,M,60,9,2,110,-12,Severe
18,1,217,F,99,13,1,157,-60,Severe
8,7,103,F,75,10,9,129,26,Well
11,10,142,F,64,9,7,115,-27,Severe
18,0,216,M,42,7,7,91,-125,Severe
14,4,172,F,9,5,7,67,-105,Severe
17,2,206,F,59,9,1,109,-97,Severe
13,10,166,M,89,12,1,145,-21,Severe
8,10,106,M,60,9,2,110,4,Good
6,3,75,M,6,5,5,65,-10,Severe
13,2,158,M,89,12,1,145,-13,Severe
11,2,134,F,75,10,9,129,-5,Mild
10,3,123,F,103,13,6,162,39,Well
7,3,87,M,76,10,10,130,43,Well
9,3,111,F,7,5,6,66,-45,Severe
11,8,140,F,43,7,8,92,-48,Severe
15,6,186,F,73,10,6,126,-60,Severe
17,5,209,M,98,13,0,156,-53,Severe
10,3,123,F,65,9,8,116,-7,Severe
14,5,173,M,99,13,1,157,-16,Severe
18,6,222,M,95,12,9,153,-69,Severe
13,10,166,F,36,7,2,86,-80,Severe
13,2,158,M,95,12,9,153,-5,Mild
7,2,86,F,35,7,1,85,-1,Mild
13,8,164,F,34,7,0,84,-80,Severe
13,4,160,F,68,10,0,120,-40,Severe
11,10,142,M,84,11,7,139,-3,Mild
8,2,98,F,101,13,4,160,62,Well
17,3,207,F,65,9,8,116,-91,Severe
18,11,227,M,62,9,4,112,-115,Severe
15,7,187,M,97,12,11,155,-32,Severe
8,10,106,M,45,7,10,94,-12,Severe
5,3,63,M,80,11,3,135,72,Well
10,0,120,M,20,6,2,74,-46,Severe
12,1,145,F,92,12,5,149,4,Good
9,4,112,F,72,10,4,124,12,Well
11,11,143,M,74,10,7,127,-16,Severe
18,7,223,F,109,14,1,169,-54,Severe
6,4,76,F,6,5,5,65,-11,Severe
8,9,105,M,21,6,2,74,-31,Severe
13,0,156,M,102,13,6,162,6,Well
15,0,180,M,38,7,4,88,-92,Severe
15,5,185,M,70,10,2,122,-63,Severe
5,1,61,M,47,8,0,96,35,Well
8,2,98,M,52,8,5,101,3,Good
10,11,131,F,48,8,1,97,-34,Severe
15,4,184,M,86,11,10,142,-42,Severe
6,5,77,F,86,11,10,142,65,Well
10,9,129,M,97,12,11,155,26,Well
14,2,170,F,88,12,0,144,-26,Severe
18,8,224,F,12,5,9,69,-155,Severe
8,5,101,F,14,5,10,70,-31,Severe
15,3,183,M,4,5,4,64,-119,Severe
11,1,133,M,98,13,0,156,23,Well
12,8,152,F,40,7,5,89,-63,Severe
12,9,153,F,29,6,8,80,-73,Severe
6,11,83,M,66,9,9,117,34,Well
10,3,123,F,16,5,11,71,-52,Severe
16,3,195,F,43,7,8,92,-103,Severe
9,3,111,M,55,8,8,104,-7,Severe
10,2,122,M,5,5,5,65,-57,Severe
14,7,175,F,76,10,10,130,-45,Severe
8,5,101,F,10,5,7,67,-34,Severe
9,6,114,F,85,11,9,141,27,Well
9,10,118,F,90,12,3,147,29,Well
9,7,115,M,28,6,8,80,-35,Severe
12,5,149,M,88,12,0,144,-5,Mild
12,8,152,M,40,7,5,89,-63,Severe
8,2,98,M,33,6,11,83,-15,Severe
10,8,128,M,41,7,6,90,-38,Severe
7,6,90,F,30,6,9,81,-9,Severe
10,3,123,M,98,13,0,156,33,Well
11,0,132,M,40,7,5,89,-43,Severe
13,1,157,M,14,5,10,70,-87,Severe
11,5,137,M,84,11,7,139,2,Good
15,11,191,M,4,5,4,64,-127,Severe
11,11,143,M,109,14,1,169,26,Well
18,1,217,F,21,6,2,74,-143,Severe
13,7,163,F,32,6,10,82,-81,Severe
16,4,196,F,5,5,5,65,-131,Severe
18,9,225,M,19,6,1,73,-152,Severe
8,1,97,M,51,8,4,100,3,Good
8,10,106,F,66,9,9,117,11,Well
8,9,105,M,96,12,10,154,49,Well
10,8,128,F,41,7,6,90,-38,Severe
15,2,182,M,65,9,8,116,-66,Severe
6,2,74,F,45,7,10,94,20,Well
14,4,172,M,31,6,9,81,-91,Severe
5,9,69,F,99,13,1,157,88,Well
13,5,161,F,39,7,5,89,-72,Severe
16,4,196,M,36,7,2,86,-110,Severe
9,1,109,M,80,11,3,135,26,Well
9,8,116,M,46,7,11,95,-21,Severe
6,7,79,F,38,7,4,88,9,Well
10,11,131,M,36,7,2,86,-45,Severe
16,0,192,F,99,13,1,157,-35,Severe
10,1,121,M,34,7,0,84,-37,Severe
17,6,210,F,47,8,0,96,-114,Severe
7,7,91,F,104,13,7,163,72,Well
17,11,215,F,42,7,7,91,-124,Severe
18,9,225,F,87,11,11,143,-82,Severe
18,4,220,F,79,11,1,133,-87,Severe
18,10,226,M,94,12,7,151,-75,Severe
7,6,90,F,55,8,8,104,14,Well
15,3,183,F,59,9,1,109,-74,Severe
15,4,184,F,2,5,3,63,-121,Severe
16,4,196,F,2,5,3,63,-133,Severe
14,10,178,F,107,13,11,167,-11,Severe
16,3,195,F,90,12,3,147,-48,Severe
8,2,98,F,17,6,0,72,-26,Severe
13,5,161,F,61,9,3,111,-50,Severe
6,10,82,M,47,8,0,96,14,Well
13,6,162,F,9,5,7,67,-95,Severe
13,8,164,M,60,9,2,110,-54,Severe
8,7,103,M,38,7,4,88,-15,Severe
16,7,199,M,53,8,6,102,-97,Severe
5,11,71,F,83,11,6,138,67,Well
9,0,108,M,53,8,6,102,-6,Severe
6,3,75,M,89,12,1,145,70,Well
11,4,136,F,48,8,1,97,-39,Severe
7,8,92,F,62,9,4,112,20,Well
18,3,219,F,70,10,2,122,-97,Severe
18,11,227,M,80,11,3,135,-92,Severe
16,7,199,M,104,13,7,163,-36,Severe
17,11,215,F,80,11,3,135,-80,Severe
15,9,189,F,3,5,3,63,-126,Severe
16,3,195,M,24,6,5,77,-118,Severe
10,1,121,M,59,9,1,109,-12,Severe
11,0,132,M,8,5,6,66,-66,Severe
7,8,92,M,65,9,8,116,24,Well
15,3,183,M,68,10,0,120,-63,Severe
15,5,185,M,91,12,4,148,-37,Severe
7,11,95,F,108,14,0,168,73,Well
8,3,99,F,12,5,9,69,-30,Severe
10,3,123,M,74,10,7,127,4,Good
11,3,135,F,77,10,11,131,-4,Mild
13,7,163,F,49,8,2,98,-65,Severe
14,11,179,F,18,6,1,73,-106,Severe
14,4,172,F,13,5,9,69,-103,Severe
16,6,198,F,107,13,11,167,-31,Severe
7,11,95,F,22,6,3,75,-20,Severe
16,3,195,F,65,9,8,116,-79,Severe
13,7,163,F,98,13,0,156,-7,Severe
15,9,189,M,67,9,10,118,-71,Severe
15,6,186,F,90,12,3,147,-39,Severe
12,0,144,F,44,7,9,93,-51,Severe
7,3,87,M,25,6,5,77,-10,Severe
8,6,102,F,40,7,5,89,-13,Severe
11,3,135,M,37,7,3,87,-48,Severe
10,3,123,M,99,13,1,157,34,Well
11,2,134,F,55,8,8,104,-30,Severe
5,6,66,F,73,10,6,126,60,Well
17,0,204,F,51,8,4,100,-104,Severe
9,3,111,M,3,5,3,63,-48,Severe
18,7,223,F,64,9,7,115,-108,Severe
8,1,97,F,19,6,1,73,-24,Severe
12,10,154,M,95,12,9,153,-1,Mild
18,8,224,F,86,11,10,142,-82,Severe
18,3,219,F,66,9,9,117,-102,Severe
18,7,223,F,39,7,5,89,-134,Severe
10,10,130,F,60,9,2,110,-20,Severe
12,3,147,F,73,10,6,126,-21,Severe
15,2,182,F,77,10,11,131,-51,Severe
10,2,122,M,12,5,9,69,-53,Severe
13,1,157,M,95,12,9,153,-4,Mild
5,1,61,F,54,8,7,103,42,Well
10,0,120,M,16,5,11,71,-49,Severe
11,9,141,M,82,11,5,137,-4,Mild
8,4,100,F,95,12,9,153,53,Well
15,3,183,M,105,13,9,165,-18,Severe
7,11,95,M,2,5,3,63,-32,Severe
14,10,178,F,106,13,10,166,-12,Severe
12,8,152,M,30,6,9,81,-71,Severe
16,9,201,F,44,7,9,93,-108,Severe
18,1,217,F,88,12,0,144,-73,Severe
6,3,75,M,63,9,6,114,39,Well
5,7,67,F,13,5,9,69,2,Good
15,7,187,F,24,6,5,77,-110,Severe
16,6,198,M,45,7,10,94,-104,Severe
6,3,75,M,62,9,4,112,37,Well
7,10,94,M,106,13,10,166,72,Well
5,7,67,F,60,9,2,110,43,Well
14,11,179,F,55,8,8,104,-75,Severe
7,11,95,F,26,6,6,78,-17,Severe
6,3,75,F,80,11,3,135,60,Well
6,0,72,F,45,7,10,94,22,Well
15,7,187,M,80,11,3,135,-52,Severe
16,9,201,M,84,11,7,139,-62,Severe
12,5,149,F,75,10,9,129,-20,Severe
17,8,212,F,90,12,3,147,-65,Severe
10,8,128,F,35,7,1,85,-43,Severe
8,1,97,F,74,10,7,127,30,Well
10,10,130,F,79,11,1,133,3,Good
17,3,207,M,69,10,1,121,-86,Severe
5,10,70,F,80,11,3,135,65,Well
13,9,165,M,31,6,9,81,-84,Severe
10,4,124,F,8,5,6,66,-58,Severe
13,11,167,F,41,7,6,90,-77,Severe
18,8,224,F,78,11,0,132,-92,Severe
5,5,65,F,34,7,0,84,19,Well
7,9,93,M,34,7,0,84,-9,Severe
7,6,90,M,35,7,1,85,-5,Mild
12,5,149,F,10,5,7,67,-82,Severe
10,8,128,F,26,6,6,78,-50,Severe
5,6,66,F,63,9,6,114,48,Well
18,3,219,F,106,13,10,166,-53,Severe
17,4,208,F,65,9,8,116,-92,Severe
9,9,117,M,94,12,7,151,34,Well
18,8,224,F,94,12,7,151,-73,Severe
17,7,211,F,38,7,4,88,-123,Severe
7,11,95,M,13,5,9,69,-26,Severe
7,1,85,M,58,9,0,108,23,Well
6,11,83,M,62,9,4,112,29,Well
8,7,103,M,48,8,1,97,-6,Severe
16,1,193,M,93,12,6,150,-43,Severe
17,3,207,F,9,5,7,67,-140,Severe
18,9,225,F,109,14,1,169,-56,Severe
11,11,143,F,45,7,10,94,-49,Severe
10,5,125,F,75,10,9,129,4,Good
7,3,87,F,105,13,9,165,78,Well
5,9,69,M,49,8,2,98,29,Well
5,4,64,F,64,9,7,115,51,Well
11,0,132,M,29,6,8,80,-52,Severe
11,3,135,M,56,8,9,105,-30,Severe
9,0,108,M,69,10,1,121,13,Well
16,4,196,M,62,9,4,112,-84,Severe
12,10,154,M,83,11,6,138,-16,Severe
18,6,222,F,76,10,10,130,-92,Severe
15,11,191,M,88,12,0,144,-47,Severe
6,1,73,M,29,6,8,80,7,Well
6,9,81,F,4,5,4,64,-17,Severe
16,4,196,M,37,7,3,87,-109,Severe
16,5,197,F,72,10,4,124,-73,Severe
6,10,82,M,39,7,5,89,7,Well
9,10,118,M,11,5,8,68,-50,Severe
7,11,95,M,72,10,4,124,29,Well
13,5,161,M,24,6,5,77,-84,Severe
15,8,188,M,86,11,10,142,-46,Severe
14,3,171,M,52,8,5,101,-70,Severe
8,11,107,M,77,10,11,131,24,Well
15,5,185,M,41,7,6,90,-95,Severe
15,2,182,M,74,10,7,127,-55,Severe
18,9,225,F,39,7,5,89,-136,Severe
6,11,83,F,88,12,0,144,61,Well
11,1,133,F,103,13,6,162,29,Well
17,10,214,M,20,6,2,74,-140,Severe
11,8,140,M,81,11,4,136,-4,Mild
12,6,150,M,44,7,9,93,-57,Severe
6,3,75,F,39,7,5,89,14,Well
6,4,76,F,28,6,8,80,4,Good
15,4,184,M,4,5,4,64,-120,Severe
5,4,64,F,15,5,11,71,7,Well
8,9,105,M,7,5,6,66,-39,Severe
17,1,205,M,70,10,2,122,-83,Severe
8,5,101,F,100,13,3,159,58,Well
5,10,70,F,67,9,10,118,48,Well
11,11,143,F,60,9,2,110,-33,Severe
9,11,119,M,60,9,2,110,-9,Severe
11,3,135,M,51,8,4,100,-35,Severe
15,4,184,F,84,11,7,139,-45,Severe
17,9,213,F,27,6,7,79,-134,Severe
15,10,190,M,41,7,6,90,-100,Severe
5,6,66,M,49,8,2,98,32,Well
15,6,186,F,55,8,8,104,-82,Severe
14,3,171,M,93,12,6,150,-21,Severe
15,11,191,F,34,7,0,84,-107,Severe
6,5,77,F,88,12,0,144,67,Well
14,6,174,F,42,7,7,91,-83,Severe
11,1,133,M,55,8,8,104,-29,Severe
16,4,196,F,59,9,1,109,-87,Severe
8,11,107,M,85,11,9,141,34,Well
12,10,154,F,90,12,3,147,-7,Severe
16,9,201,M,88,12,0,144,-57,Severe
15,10,190,F,92,12,5,149,-41,Severe
18,3,219,M,83,11,6,138,-81,Severe
16,5,197,M,77,10,11,131,-66,Severe
17,6,210,M,11,5,8,68,-142,Severe
17,11,215,M,45,7,10,94,-121,Severe
6,8,80,M,23,6,4,76,-4,Mild
8,8,104,M,61,9,3,111,7,Well
17,3,207,M,71,10,3,123,-84,Severe
14,9,177,M,35,7,1,85,-92,Severe
16,5,197,F,58,9,0,108,-89,Severe
17,9,213,M,45,7,10,94,-119,Severe
14,5,173,F,74,10,7,127,-46,Severe
11,2,134,F,11,5,8,68,-66,Severe
7,3,87,M,22,6,3,75,-12,Severe
17,5,209,F,27,6,7,79,-130,Severe
9,1,109,M,88,12,0,144,35,Well
7,3,87,F,14,5,10,70,-17,Severe
5,1,61,F,47,8,0,96,35,Well
7,4,88,M,80,11,3,135,47,Well
6,2,74,F,82,11,5,137,63,Well
12,7,151,F,13,5,9,69,-82,Severe
7,11,95,M,70,10,2,122,27,Well
12,10,154,M,87,11,11,143,-11,Severe
9,3,111,F,100,13,3,159,48,Well
15,11,191,M,2,5,3,63,-128,Severe
16,5,197,M,59,9,1,109,-88,Severe
13,10,166,M,103,13,6,162,-4,Mild
16,8,200,M,22,6,3,75,-125,Severe
12,2,146,F,27,6,7,79,-67,Severe
5,4,64,F,90,12,3,147,83,Well
10,3,123,M,100,13,3,159,36,Well
10,4,124,M,88,12,0,144,20,Well
8,3,99,F,91,12,4,148,49,Well
6,4,76,M,57,8,10,106,30,Well
7,8,92,M,83,11,6,138,46,Well
12,7,151,F,73,10,6,126,-25,Severe
12,7,151,F,42,7,7,91,-60,Severe
7,7,91,M,87,11,11,143,52,Well
11,10,142,M,33,6,11,83,-59,Severe
12,3,147,F,102,13,6,162,15,Well
9,3,111,F,13,5,9,69,-42,Severe
16,2,194,M,43,7,8,92,-102,Severe
6,8,80,M,98,13,0,156,76,Well
6,11,83,M,32,6,10,82,-1,Mild
6,1,73,M,100,13,3,159,86,Well
18,10,226,F,64,9,7,115,-111,Severe
5,10,70,M,70,10,2,122,52,Well
17,5,209,F,15,5,11,71,-138,Severe
6,11,83,F,101,13,4,160,77,Well
15,10,190,M,79,11,1,133,-57,Severe
5,10,70,M,24,6,5,77,7,Well
13,6,162,M,94,12,7,151,-11,Severe
12,7,151,M,67,9,10,118,-33,Severe
17,0,204,F,41,7,6,90,-114,Severe
15,11,191,F,74,10,7,127,-64,Severe
7,1,85,F,64,9,7,115,30,Well
10,7,127,F,53,8,6,102,-25,Severe
15,11,191,F,70,10,2,122,-69,Severe
9,11,119,F,12,5,9,69,-50,Severe
8,11,107,M,102,13,6,162,55,Well
6,5,77,F,27,6,7,79,2,Good
10,7,127,M,26,6,6,78,-49,Severe
15,4,184,M,104,13,7,163,-21,Severe
14,10,178,F,80,11,3,135,-43,Severe
9,3,111,M,51,8,4,100,-11,Severe
10,10,130,F,102,13,6,162,32,Well
8,5,101,F,5,5,5,65,-36,Severe
9,6,114,F,97,12,11,155,41,Well
5,2,62,F,84,11,7,139,77,Well
13,1,157,M,65,9,8,116,-41,Severe
18,3,219,M,107,13,11,167,-52,Severe
14,11,179,M,69,10,1,121,-58,Severe
5,9,69,F,12,5,9,69,0,Neutral
9,4,112,F,71,10,3,123,11,Well
18,3,219,M,72,10,4,124,-95,Severe
8,2,98,M,82,11,5,137,39,Well
11,6,138,M,79,11,1,133,-5,Mild
8,11,107,F,61,9,3,111,4,Good
14,4,172,F,46,7,11,95,-77,Severe
16,3,195,F,95,12,9,153,-42,Severe
9,4,112,M,27,6,7,79,-33,Severe
6,1,73,M,6,5,5,65,-8,Severe
18,3,219,F,99,13,1,157,-62,Severe
14,10,178,M,58,9,0,108,-70,Severe
8,10,106,F,33,6,11,83,-23,Severe
5,2,62,F,64,9,7,115,53,Well
5,1,61,M,104,13,7,163,102,Well
7,6,90,F,102,13,6,162,72,Well
8,0,96,M,58,9,0,108,12,Well
6,10,82,F,61,9,3,111,29,Well
17,5,209,M,38,7,4,88,-121,Severe
6,7,79,M,79,11,1,133,54,Well
8,3,99,F,34,7,0,84,-15,Severe
16,4,196,M,19,6,1,73,-123,Severe
16,11,203,F,42,7,7,91,-112,Severe
12,2,146,M,92,12,5,149,3,Good
15,1,181,F,14,5,10,70,-111,Severe
15,0,180,F,71,10,3,123,-57,Severe
14,4,172,M,37,7,3,87,-85,Severe
8,0,96,F,31,6,9,81,-15,Severe
11,2,134,F,30,6,9,81,-53,Severe
14,1,169,M,69,10,1,121,-48,Severe
14,0,168,M,59,9,1,109,-59,Severe
16,0,192,F,80,11,3,135,-57,Severe
15,4,184,M,31,6,9,81,-103,Severe
11,11,143,F,73,10,6,126,-17,Severe
13,3,159,M,5,5,5,65,-94,Severe
13,2,158,F,77,10,11,131,-27,Severe
12,7,151,M,22,6,3,75,-76,Severe
17,9,213,F,92,12,5,149,-64,Severe
9,9,117,F,105,13,9,165,48,Well
10,4,124,M,11,5,8,68,-56,Severe
6,4,76,F,2,5,3,63,-13,Severe
9,3,111,F,100,13,3,159,48,Well
11,6,138,F,59,9,1,109,-29,Severe
13,1,157,F,28,6,8,80,-77,Severe
13,1,157,F,22,6,3,75,-82,Severe
17,3,207,M,6,5,5,65,-142,Severe
7,10,94,F,85,11,9,141,47,Well
15,0,180,F,99,13,1,157,-23,Severe
13,2,158,F,66,9,9,117,-41,Severe
9,2,110,M,90,12,3,147,37,Well
11,11,143,F,65,9,8,116,-27,Severe
14,2,170,F,48,8,1,97,-73,Severe
5,6,66,M,71,10,3,123,57,Well
11,9,141,F,48,8,1,97,-44,Severe
18,5,221,F,36,7,2,86,-135,Severe
8,3,99,M,45,7,10,94,-5,Mild
13,2,158,F,2,5,3,63,-95,Severe
12,7,151,F,83,11,6,138,-13,Severe
16,10,202,M,74,10,7,127,-75,Severe
18,0,216,M,89,12,1,145,-71,Severe
11,3,135,M,32,6,10,82,-53,Severe
6,0,72,F,8,5,6,66,-6,Severe
10,0,120,F,28,6,8,80,-40,Severe
6,9,81,F,61,9,3,111,30,Well
14,1,169,M,80,11,3,135,-34,Severe
14,6,174,M,77,10,11,131,-43,Severe
13,9,165,M,21,6,2,74,-91,Severe
12,2,146,M,96,12,10,154,8,Well
9,2,110,M,78,11,0,132,22,Well
8,3,99,F,14,5,10,70,-29,Severe
7,0,84,F,71,10,3,123,39,Well
18,4,220,M,83,11,6,138,-82,Severe
14,7,175,M,34,7,0,84,-91,Severe
10,4,124,M,91,12,4,148,24,Well
12,3,147,F,10,5,7,67,-80,Severe
18,2,218,M,31,6,9,81,-137,Severe
9,9,117,M,35,7,1,85,-32,Severe
17,11,215,M,55,8,8,104,-111,Severe
14,10,178,F,35,7,1,85,-93,Severe
14,3,171,M,6,5,5,65,-106,Severe
11,1,133,F,72,10,4,124,-9,Severe
18,6,222,M,44,7,9,93,-129,Severe
12,4,148,M,98,13,0,156,8,Well
11,3,135,M,24,6,5,77,-58,Severe
8,9,105,F,32,6,10,82,-23,Severe
17,9,213,F,79,11,1,133,-80,Severe
10,6,126,F,65,9,8,116,-10,Severe
7,5,89,F,42,7,7,91,2,Good
9,8,116,F,57,8,10,106,-10,Severe
12,1,145,F,9,5,7,67,-78,Severe
8,2,98,M,61,9,3,111,13,Well
9,10,118,F,58,9,0,108,-10,Severe
18,4,220,M,24,6,5,77,-143,Severe
17,8,212,M,42,7,7,91,-121,Severe
18,3,219,M,91,12,4,148,-71,Severe
5,6,66,M,10,5,7,67,1,Good
14,3,171,M,78,11,0,132,-39,Severe
11,3,135,M,50,8,3,99,-36,Severe
7,10,94,F,55,8,8,104,10,Well
7,7,91,F,100,13,3,159,68,Well
15,11,191,F,58,9,0,108,-83,Severe
12,7,151,M,70,10,2,122,-29,Severe
14,0,168,F,81,11,4,136,-32,Severe
11,2,134,F,29,6,8,80,-54,Severe
18,3,219,M,94,12,7,151,-68,Severe
15,5,185,M,45,7,10,94,-91,Severe
16,2,194,M,63,9,6,114,-80,Severe
15,3,183,M,25,6,5,77,-106,Severe
5,5,65,F,69,10,1,121,56,Well
8,7,103,M,10,5,7,67,-36,Severe
10,6,126,F,90,12,3,147,21,Well
9,10,118,M,43,7,8,92,-26,Severe
11,7,139,F,39,7,5,89,-50,Severe
10,9,129,M,95,12,9,153,24,Well
15,4,184,M,40,7,5,89,-95,Severe
16,3,195,F,89,12,1,145,-50,Severe
12,10,154,F,69,10,1,121,-33,Severe
11,2,134,M,19,6,1,73,-61,Severe
9,3,111,M,43,7,8,92,-19,Severe
11,6,138,F,46,7,11,95,-43,Severe
11,5,137,F,99,13,1,157,20,Well
14,4,172,F,89,12,1,145,-27,Severe
13,1,157,M,67,9,10,118,-39,Severe
7,11,95,M,81,11,4,136,41,Well
17,8,212,M,3,5,3,63,-149,Severe
15,1,181,M,62,9,4,112,-69,Severe
8,10,106,M,13,5,9,69,-37,Severe
9,0,108,M,80,11,3,135,27,Well
14,5,173,F,97,12,11,155,-18,Severe
13,11,167,F,22,6,3,75,-92,Severe
18,3,219,M,103,13,6,162,-57,Severe
5,5,65,M,84,11,7,139,74,Well
8,8,104,M,76,10,10,130,26,Well
6,0,72,M,83,11,6,138,66,Well
11,3,135,F,3,5,3,63,-72,Severe
9,11,119,M,80,11,3,135,16,Well
12,11,155,F,99,13,1,157,2,Good
12,2,146,M,104,13,7,163,17,Well
13,7,163,M,78,11,0,132,-31,Severe
12,0,144,F,9,5,7,67,-77,Severe
11,3,135,M,87,11,11,143,8,Well
6,9,81,M,7,5,6,66,-15,Severe
15,7,187,M,42,7,7,91,-96,Severe
9,11,119,F,65,9,8,116,-3,Mild
15,0,180,M,3,5,3,63,-117,Severe
8,10,106,M,70,10,2,122,16,Well
9,8,116,F,22,6,3,75,-41,Severe
7,3,87,M,36,7,2,86,-1,Mild
6,8,80,F,98,13,0,156,76,Well
9,4,112,M,56,8,9,105,-7,Severe
7,5,89,F,7,5,6,66,-23,Severe
9,6,114,F,23,6,4,76,-38,Severe
9,6,114,F,52,8,5,101,-13,Severe
6,8,80,F,42,7,7,91,11,Well
9,3,111,M,100,13,3,159,48,Well
9,10,118,M,93,12,6,150,32,Well
11,0,132,M,20,6,2,74,-58,Severe
12,9,153,M,48,8,1,97,-56,Severe
5,2,62,F,6,5,5,65,3,Good
11,5,137,F,53,8,6,102,-35,Severe
10,6,126,F,13,5,9,69,-57,Severe
14,0,168,F,48,8,1,97,-71,Severe
15,5,185,F,77,10,11,131,-54,Severe
18,11,227,M,55,8,8,104,-123,Severe
8,5,101,M,15,5,11,71,-30,Severe
11,3,135,M,77,10,11,131,-4,Mild
8,7,103,M,77,10,11,131,28,Well
16,1,193,F,94,12,7,151,-42,Severe
9,4,112,F,31,6,9,81,-31,Severe
6,3,75,M,93,12,6,150,75,Well
17,11,215,F,13,5,9,69,-146,Severe
9,1,109,M,93,12,6,150,41,Well
6,6,78,M,88,12,0,144,66,Well
12,7,151,F,67,9,10,118,-33,Severe
11,10,142,M,94,12,7,151,9,Well
12,9,153,F,53,8,6,102,-51,Severe
13,10,166,F,92,12,5,149,-17,Severe
6,11,83,M,74,10,7,127,44,Well
13,11,167,M,69,10,1,121,-46,Severe
15,3,183,M,35,7,1,85,-98,Severe
10,9,129,F,45,7,10,94,-35,Severe
18,9,225,M,4,5,4,64,-161,Severe
15,1,181,M,49,8,2,98,-83,Severe
17,8,212,F,17,6,0,72,-140,Severe
12,7,151,F,16,5,11,71,-80,Severe
9,6,114,F,77,10,11,131,17,Well
18,10,226,F,95,12,9,153,-73,Severe
13,4,160,M,50,8,3,99,-61,Severe
7,7,91,M,14,5,10,70,-21,Severe
15,9,189,M,6,5,5,65,-124,Severe
9,0,108,M,40,7,5,89,-19,Severe
11,11,143,F,22,6,3,75,-68,Severe
14,0,168,F,47,8,0,96,-72,Severe
12,9,153,M,67,9,10,118,-35,Severe
5,10,70,M,88,12,0,144,74,Well
12,5,149,M,27,6,7,79,-70,Severe
7,11,95,F,4,5,4,64,-31,Severe
7,10,94,F,91,12,4,148,54,Well
8,0,96,M,105,13,9,165,69,Well
11,10,142,M,103,13,6,162,20,Well
15,8,188,M,59,9,1,109,-79,Severe
9,10,118,M,58,9,0,108,-10,Severe
10,3,123,M,10,5,7,67,-56,Severe
17,10,214,M,8,5,6,66,-148,Severe
17,3,207,F,60,9,2,110,-97,Severe
11,2,134,F,24,6,5,77,-57,Severe
17,8,212,F,109,14,1,169,-43,Severe
15,1,181,M,41,7,6,90,-91,Severe
16,3,195,M,46,7,11,95,-100,Severe
14,3,171,M,85,11,9,141,-30,Severe
17,11,215,M,10,5,7,67,-148,Severe
18,0,216,F,65,9,8,116,-100,Severe
6,3,75,F,24,6,5,77,2,Good
6,11,83,M,89,12,1,145,62,Well
15,1,181,M,108,14,0,168,-13,Severe
8,11,107,M,59,9,1,109,2,Good
14,2,170,F,10,5,7,67,-103,Severe
15,2,182,M,11,5,8,68,-114,Severe
13,8,164,M,18,6,1,73,-91,Severe
17,11,215,F,93,12,6,150,-65,Severe
9,1,109,M,2,5,3,63,-46,Severe
7,7,91,M,38,7,4,88,-3,Mild
15,1,181,F,110,14,3,171,-10,Severe
14,10,178,F,46,7,11,95,-83,Severe
16,9,201,F,5,5,5,65,-136,Severe
6,4,76,M,19,6,1,73,-3,Mild
17,6,210,M,31,6,9,81,-129,Severe
8,7,103,F,109,14,1,169,66,Well
13,3,159,M,13,5,9,69,-90,Severe
13,1,157,F,79,11,1,133,-24,Severe
7,10,94,M,75,10,9,129,35,Well
9,6,114,F,86,11,10,142,28,Well
15,3,183,F,54,8,7,103,-80,Severe
13,0,156,M,53,8,6,102,-54,Severe
8,0,96,F,83,11,6,138,42,Well
8,1,97,F,109,14,1,169,72,Well
15,4,184,M,81,11,4,136,-48,Severe
11,4,136,M,64,9,7,115,-21,Severe
16,10,202,F,54,8,7,103,-99,Severe
9,3,111,F,5,5,5,65,-46,Severe
17,5,209,F,100,13,3,159,-50,Severe
17,8,212,F,6,5,5,65,-147,Severe
11,2,134,F,16,5,11,71,-63,Severe
14,6,174,F,40,7,5,89,-85,Severe
14,8,176,M,17,6,0,72,-104,Severe
16,0,192,M,20,6,2,74,-118,Severe
5,7,67,F,76,10,10,130,63,Well
11,6,138,F,103,13,6,162,24,Well
5,0,60,F,102,13,6,162,102,Well
7,7,91,F,81,11,4,136,45,Well
18,9,225,M,34,7,0,84,-141,Severe
11,10,142,M,64,9,7,115,-27,Severe
16,7,199,F,19,6,1,73,-126,Severe
8,10,106,F,75,10,9,129,23,Well
7,5,89,F,57,8,10,106,17,Well
12,1,145,F,52,8,5,101,-44,Severe
13,0,156,F,48,8,1,97,-59,Severe
8,2,98,F,8,5,6,66,-32,Severe
10,3,123,M,89,12,1,145,22,Well
8,2,98,M,87,11,11,143,45,Well
17,6,210,M,10,5,7,67,-143,Severe
12,5,149,M,25,6,5,77,-72,Severe
15,0,180,M,45,7,10,94,-86,Severe
15,6,186,F,45,7,10,94,-92,Severe
11,10,142,F,77,10,11,131,-11,Severe
18,3,219,M,13,5,9,69,-150,Severe
7,6,90,M,46,7,11,95,5,Good
11,3,135,M,8,5,6,66,-69,Severe
16,8,200,F,77,10,11,131,-69,Severe
17,1,205,F,48,8,1,97,-108,Severe
12,3,147,F,21,6,2,74,-73,Severe
18,7,223,M,76,10,10,130,-93,Severe
17,3,207,M,34,7,0,84,-123,Severe
16,3,195,M,98,13,0,156,-39,Severe
17,4,208,M,8,5,6,66,-142,Severe
12,2,146,F,23,6,4,76,-70,Severe
17,9,213,F,88,12,0,144,-69,Severe
18,6,222,F,74,10,7,127,-95,Severe
7,11,95,F,61,9,3,111,16,Well
17,0,204,F,9,5,7,67,-137,Severe
8,7,103,F,57,8,10,106,3,Good
16,3,195,F,83,11,6,138,-57,Severe
6,11,83,M,36,7,2,86,3,Good
8,3,99,F,76,10,10,130,31,Well
10,9,129,M,45,7,10,94,-35,Severe
10,5,125,F,7,5,6,66,-59,Severe
13,7,163,M,19,6,1,73,-90,Severe
17,2,206,F,89,12,1,145,-61,Severe
13,4,160,F,18,6,1,73,-87,Severe
18,3,219,M,86,11,10,142,-77,Severe
15,3,183,M,28,6,8,80,-103,Severe
11,3,135,F,68,10,0,120,-15,Severe
14,11,179,F,81,11,4,136,-43,Severe
10,0,120,M,97,12,11,155,35,Well
17,7,211,F,99,13,1,157,-54,Severe
6,11,83,M,54,8,7,103,20,Well
10,3,123,F,30,6,9,81,-42,Severe
12,3,147,F,57,8,10,106,-41,Severe
14,3,171,M,68,10,0,120,-51,Severe
12,3,147,F,29,6,8,80,-67,Severe
16,9,201,M,78,11,0,132,-69,Severe
16,3,195,F,100,13,3,159,-36,Severe
5,9,69,M,51,8,4,100,31,Well
10,10,130,M,17,6,0,72,-58,Severe
6,9,81,F,49,8,2,98,17,Well
9,8,116,M,80,11,3,135,19,Well
5,8,68,M,100,13,3,159,91,Well
16,7,199,F,6,5,5,65,-134,Severe
8,3,99,M,15,5,11,71,-28,Severe
13,0,156,F,34,7,0,84,-72,Severe
8,9,105,M,70,10,2,122,17,Well
18,5,221,M,56,8,9,105,-116,Severe
17,5,209,M,52,8,5,101,-108,Severe
8,4,100,F,84,11,7,139,39,Well
16,8,200,F,15,5,11,71,-129,Severe
15,0,180,M,10,5,7,67,-113,Severe
17,10,214,F,84,11,7,139,-75,Severe
18,0,216,F,19,6,1,73,-143,Severe
7,5,89,M,3,5,3,63,-26,Severe
10,7,127,F,65,9,8,116,-11,Severe
11,6,138,F,50,8,3,99,-39,Severe
13,4,160,M,19,6,1,73,-87,Severe
13,9,165,F,66,9,9,117,-48,Severe
15,8,188,F,33,6,11,83,-105,Severe
9,7,115,M,76,10,10,130,15,Well
18,8,224,M,68,10,0,120,-104,Severe
6,2,74,F,14,5,10,70,-4,Mild
8,10,106,F,85,11,9,141,35,Well
17,6,210,M,71,10,3,123,-87,Severe
8,9,105,M,55,8,8,104,-1,Mild
13,0,156,F,98,13,0,156,0,Neutral
14,3,171,F,92,12,5,149,-22,Severe
10,5,125,F,71,10,3,123,-2,Mild
5,11,71,F,58,9,0,108,37,Well
5,5,65,M,108,14,0,168,103,Well
18,10,226,M,35,7,1,85,-141,Severe
13,4,160,F,40,7,5,89,-71,Severe
8,11,107,F,55,8,8,104,-3,Mild
11,10,142,F,74,10,7,127,-15,Severe
16,11,203,M,61,9,3,111,-92,Severe
11,4,136,M,23,6,4,76,-60,Severe
6,10,82,F,86,11,10,142,60,Well
10,1,121,F,77,10,11,131,10,Well
16,10,202,F,61,9,3,111,-91,Severe
14,7,175,F,50,8,3,99,-76,Severe
11,3,135,F,72,10,4,124,-11,Severe
15,11,191,F,47,8,0,96,-95,Severe
9,2,110,M,23,6,4,76,-34,Severe
11,4,136,M,65,9,8,116,-20,Severe
7,9,93,M,12,5,9,69,-24,Severe
15,1,181,M,87,11,11,143,-38,Severe
13,10,166,F,59,9,1,109,-57,Severe
7,9,93,F,33,6,11,83,-10,Severe
12,8,152,F,90,12,3,147,-5,Mild
13,3,159,F,22,6,3,75,-84,Severe
10,7,127,F,15,5,11,71,-56,Severe
13,0,156,M,4,5,4,64,-92,Severe
11,7,139,M,88,12,0,144,5,Good
6,3,75,F,48,8,1,97,22,Well
14,5,173,F,24,6,5,77,-96,Severe
6,6,78,M,74,10,7,127,49,Well
14,6,174,F,23,6,4,76,-98,Severe
8,2,98,M,9,5,7,67,-31,Severe
5,3,63,F,47,8,0,96,33,Well
6,11,83,F,65,9,8,116,33,Well
7,8,92,M,82,11,5,137,45,Well
7,10,94,F,78,11,0,132,38,Well
13,6,162,F,31,6,9,81,-81,Severe
7,6,90,F,75,10,9,129,39,Well
8,2,98,M,72,10,4,124,26,Well
11,4,136,M,86,11,10,142,6,Well
14,5,173,M,80,11,3,135,-38,Severe
7,7,91,M,17,6,0,72,-19,Severe
11,4,136,M,79,11,1,133,-3,Mild
17,0,204,F,68,10,0,120,-84,Severe
11,6,138,M,99,13,1,157,19,Well
10,11,131,M,64,9,7,115,-16,Severe
18,10,226,F,101,13,4,160,-66,Severe
9,1,109,F,15,5,11,71,-38,Severe
12,5,149,M,92,12,5,149,0,Neutral
11,6,138,M,72,10,4,124,-14,Severe
11,6,138,F,34,7,0,84,-54,Severe
16,2,194,M,66,9,9,117,-77,Severe
11,3,135,M,72,10,4,124,-11,Severe
15,11,191,F,100,13,3,159,-32,Severe
18,3,219,M,38,7,4,88,-131,Severe
5,6,66,M,102,13,6,162,96,Well
15,6,186,M,47,8,0,96,-90,Severe
10,11,131,F,15,5,11,71,-60,Severe
13,7,163,F,69,10,1,121,-42,Severe
14,0,168,F,38,7,4,88,-80,Severe
13,9,165,M,98,13,0,156,-9,Severe
14,11,179,M,86,11,10,142,-37,Severe
8,3,99,F,18,6,1,73,-26,Severe
7,10,94,M,64,9,7,115,21,Well
17,6,210,M,88,12,0,144,-66,Severe
6,1,73,F,24,6,5,77,4,Good
12,3,147,M,46,7,11,95,-52,Severe
13,3,159,M,30,6,9,81,-78,Severe
15,10,190,F,96,12,10,154,-36,Severe
11,2,134,F,69,10,1,121,-13,Severe
8,5,101,M,29,6,8,80,-21,Severe
13,11,167,F,48,8,1,97,-70,Severe
13,3,159,F,4,5,4,64,-95,Severe
5,6,66,M,42,7,7,91,25,Well
12,3,147,M,89,12,1,145,-2,Mild
11,8,140,M,50,8,3,99,-41,Severe
10,11,131,F,2,5,3,63,-68,Severe
10,11,131,M,22,6,3,75,-56,Severe
18,4,220,F,69,10,1,121,-99,Severe
14,8,176,M,21,6,2,74,-102,Severe
8,9,105,M,38,7,4,88,-17,Severe
16,6,198,F,43,7,8,92,-106,Severe
10,2,122,F,39,7,5,89,-33,Severe
13,2,158,F,99,13,1,157,-1,Mild
13,7,163,F,53,8,6,102,-61,Severe
9,5,113,M,57,8,10,106,-7,Severe
13,0,156,M,13,5,9,69,-87,Severe
10,10,130,F,48,8,1,97,-33,Severe
14,5,173,M,82,11,5,137,-36,Severe
7,6,90,F,96,12,10,154,64,Well
6,7,79,M,61,9,3,111,32,Well
7,3,87,M,3,5,3,63,-24,Severe
11,10,142,F,102,13,6,162,20,Well
12,2,146,F,20,6,2,74,-72,Severe
15,4,184,F,23,6,4,76,-108,Severe
17,3,207,F,34,7,0,84,-123,Severe
6,6,78,F,87,11,11,143,65,Well
7,8,92,F,58,9,0,108,16,Well
18,1,217,F,73,10,6,126,-91,Severe
10,9,129,F,69,10,1,121,-8,Severe
12,2,146,F,49,8,2,98,-48,Severe
6,3,75,F,109,14,1,169,94,Well
18,4,220,M,95,12,9,153,-67,Severe
13,6,162,F,65,9,8,116,-46,Severe
11,7,139,F,32,6,10,82,-57,Severe
15,3,183,M,81,11,4,136,-47,Severe
14,9,177,M,91,12,4,148,-29,Severe
16,2,194,M,17,6,0,72,-122,Severe
5,3,63,M,106,13,10,166,103,Well
11,0,132,F,27,6,7,79,-53,Severe
11,0,132,M,91,12,4,148,16,Well
14,0,168,M,97,12,11,155,-13,Severe
6,4,76,M,77,10,11,131,55,Well
18,2,218,M,47,8,0,96,-122,Severe
9,1,109,M,9,5,7,67,-42,Severe
5,3,63,M,62,9,4,112,49,Well
7,3,87,M,59,9,1,109,22,Well
10,9,129,M,71,10,3,123,-6,Severe
15,9,189,M,90,12,3,147,-42,Severe
13,9,165,M,27,6,7,79,-86,Severe
5,1,61,F,53,8,6,102,41,Well
8,6,102,F,57,8,10,106,4,Good
9,3,111,M,4,5,4,64,-47,Severe
14,5,173,M,63,9,6,114,-59,Severe
12,8,152,F,81,11,4,136,-16,Severe
11,6,138,M,87,11,11,143,5,Good
8,10,106,M,31,6,9,81,-25,Severe
12,5,149,F,49,8,2,98,-51,Severe
12,3,147,M,91,12,4,148,1,Good
12,1,145,M,80,11,3,135,-10,Severe
15,10,190,M,43,7,8,92,-98,Severe
15,3,183,M,67,9,10,118,-65,Severe
13,3,159,F,89,12,1,145,-14,Severe
15,0,180,F,46,7,11,95,-85,Severe
5,3,63,M,59,9,1,109,46,Well
12,4,148,F,2,5,3,63,-85,Severe
6,4,76,F,8,5,6,66,-10,Severe
7,10,94,M,61,9,3,111,17,Well
10,3,123,M,5,5,5,65,-58,Severe
5,2,62,F,75,10,9,129,67,Well
7,5,89,M,78,11,0,132,43,Well
10,1,121,M,51,8,4,100,-21,Severe
9,3,111,M,108,14,0,168,57,Well
13,1,157,F,21,6,2,74,-83,Severe
8,3,99,F,43,7,8,92,-7,Severe
9,4,112,M,88,12,0,144,32,Well
9,9,117,M,76,10,10,130,13,Well
18,7,223,M,37,7,3,87,-136,Severe
11,8,140,F,76,10,10,130,-10,Severe
14,10,178,F,24,6,5,77,-101,Severe
10,5,125,F,14,5,10,70,-55,Severe
15,5,185,M,78,11,0,132,-53,Severe
18,6,222,F,63,9,6,114,-108,Severe
13,6,162,M,93,12,6,150,-12,Severe
17,3,207,M,41,7,6,90,-117,Severe
17,3,207,M,38,7,4,88,-119,Severe
13,4,160,M,9,5,7,67,-93,Severe
18,2,218,F,36,7,2,86,-132,Severe
16,10,202,M,86,11,10,142,-60,Severe
9,3,111,M,59,9,1,109,-2,Mild
5,1,61,M,94,12,7,151,90,Well
10,10,130,F,27,6,7,79,-51,Severe
10,7,127,M,2,5,3,63,-64,Severe
11,0,132,F,40,7,5,89,-43,Severe
15,5,185,F,52,8,5,101,-84,Severe
7,5,89,F,48,8,1,97,8,Well
5,2,62,F,103,13,6,162,100,Well
16,2,194,M,52,8,5,101,-93,Severe
11,11,143,F,85,11,9,141,-2,Mild
10,4,124,M,90,12,3,147,23,Well
6,11,83,M,4,5,4,64,-19,Severe
6,10,82,M,72,10,4,124,42,Well
9,10,118,M,106,13,10,166,48,Well
18,0,216,F,100,13,3,159,-57,Severe
16,10,202,M,21,6,2,74,-128,Severe
9,5,113,M,89,12,1,145,32,Well
10,1,121,M,35,7,1,85,-36,Severe
5,10,70,F,49,8,2,98,28,Well
8,8,104,M,47,8,0,96,-8,Severe
6,5,77,M,41,7,6,90,13,Well
10,4,124,F,47,8,0,96,-28,Severe
16,2,194,F,41,7,6,90,-104,Severe
13,5,161,M,26,6,6,78,-83,Severe
17,6,210,M,29,6,8,80,-130,Severe
15,0,180,M,87,11,11,143,-37,Severe
15,3,183,F,55,8,8,104,-79,Severe
11,0,132,F,34,7,0,84,-48,Severe
9,1,109,M,28,6,8,80,-29,Severe
5,10,70,M,21,6,2,74,4,Good
9,7,115,F,66,9,9,117,2,Good
16,3,195,F,78,11,0,132,-63,Severe
16,2,194,F,3,5,3,63,-131,Severe
13,7,163,M,97,12,11,155,-8,Severe
10,11,131,F,106,13,10,166,35,Well
9,11,119,F,27,6,7,79,-40,Severe
5,0,60,F,77,10,11,131,71,Well
8,8,104,M,90,12,3,147,43,Well
8,1,97,F,45,7,10,94,-3,Mild
13,6,162,F,93,12,6,150,-12,Severe
6,5,77,F,6,5,5,65,-12,Severe
10,4,124,M,56,8,9,105,-19,Severe
8,4,100,F,85,11,9,141,41,Well
9,1,109,F,3,5,3,63,-46,Severe
16,5,197,F,2,5,3,63,-134,Severe
9,6,114,F,92,12,5,149,35,Well
18,0,216,M,101,13,4,160,-56,Severe
17,3,207,M,57,8,10,106,-101,Severe
9,11,119,M,47,8,0,96,-23,Severe
14,7,175,M,15,5,11,71,-104,Severe
5,0,60,M,57,8,10,106,46,Well
18,5,221,M,58,9,0,108,-113,Severe
11,3,135,F,103,13,6,162,27,Well
16,4,196,F,45,7,10,94,-102,Severe
9,1,109,F,76,10,10,130,21,Well
17,11,215,M,70,10,2,122,-93,Severe
11,9,141,F,35,7,1,85,-56,Severe
8,1,97,M,78,11,0,132,35,Well
8,10,106,M,30,6,9,81,-25,Severe
16,10,202,M,45,7,10,94,-108,Severe
10,5,125,M,69,10,1,121,-4,Mild
15,0,180,M,50,8,3,99,-81,Severe
18,11,227,M,105,13,9,165,-62,Severe
10,4,124,M,51,8,4,100,-24,Severe
12,2,146,M,66,9,9,117,-29,Severe
5,2,62,F,42,7,7,91,29,Well
11,3,135,M,42,7,7,91,-44,Severe
14,6,174,F,100,13,3,159,-15,Severe
10,9,129,M,3,5,3,63,-66,Severe
8,10,106,F,90,12,3,147,41,Well
14,6,174,F,16,5,11,71,-103,Severe
7,11,95,M,43,7,8,92,-3,Mild
6,4,76,F,72,10,4,124,48,Well
11,8,140,F,50,8,3,99,-41,Severe
12,5,149,M,37,7,3,87,-62,Severe
18,2,218,F,83,11,6,138,-80,Severe
11,9,141,M,34,7,0,84,-57,Severe
11,3,135,M,97,12,11,155,20,Well
9,11,119,M,49,8,2,98,-21,Severe
11,0,132,M,74,10,7,127,-5,Mild
15,9,189,M,108,14,0,168,-21,Severe
10,5,125,M,14,5,10,70,-55,Severe
10,11,131,F,70,10,2,122,-9,Severe
16,8,200,M,93,12,6,150,-50,Severe
10,4,124,F,67,9,10,118,-6,Severe
6,7,79,F,82,11,5,137,58,Well
5,10,70,F,88,12,0,144,74,Well
9,5,113,F,42,7,7,91,-22,Severe
10,1,121,M,16,5,11,71,-50,Severe
14,3,171,F,8,5,6,66,-105,Severe
15,3,183,M,72,10,4,124,-59,Severe
10,0,120,F,9,5,7,67,-53,Severe
10,7,127,M,30,6,9,81,-46,Severe
15,2,182,M,103,13,6,162,-20,Severe
13,1,157,F,13,5,9,69,-88,Severe
14,6,174,F,102,13,6,162,-12,Severe
6,3,75,F,35,7,1,85,10,Well
18,11,227,M,44,7,9,93,-134,Severe
7,9,93,F,46,7,11,95,2,Good
6,7,79,F,92,12,5,149,70,Well
9,3,111,F,91,12,4,148,37,Well
5,3,63,M,78,11,0,132,69,Well
10,3,123,M,53,8,6,102,-21,Severe
5,11,71,M,27,6,7,79,8,Well
6,11,83,F,20,6,2,74,-9,Severe
13,11,167,M,99,13,1,157,-10,Severe
16,9,201,M,15,5,11,71,-130,Severe
13,2,158,F,87,11,11,143,-15,Severe
10,0,120,M,58,9,0,108,-12,Severe
11,5,137,M,23,6,4,76,-61,Severe
14,6,174,F,49,8,2,98,-76,Severe
17,1,205,M,106,13,10,166,-39,Severe
9,0,108,F,14,5,10,70,-38,Severe
18,3,219,M,100,13,3,159,-60,Severe
5,0,60,F,44,7,9,93,33,Well
15,9,189,M,46,7,11,95,-94,Severe
17,6,210,F,66,9,9,117,-93,Severe
15,7,187,M,20,6,2,74,-113,Severe
6,9,81,M,39,7,5,89,8,Well
15,1,181,M,58,9,0,108,-73,Severe
15,1,181,M,29,6,8,80,-101,Severe
9,8,116,M,17,6,0,72,-44,Severe
8,9,105,M,56,8,9,105,0,Neutral
6,0,72,F,109,14,1,169,97,Well
8,3,99,F,7,5,6,66,-33,Severe
17,10,214,M,82,11,5,137,-77,Severe
9,8,116,M,20,6,2,74,-42,Severe
13,11,167,F,83,11,6,138,-29,Severe
5,8,68,M,80,11,3,135,67,Well
5,0,60,M,83,11,6,138,78,Well
10,3,123,F,79,11,1,133,10,Well
10,11,131,F,27,6,7,79,-52,Severe
15,7,187,F,67,9,10,118,-69,Severe
10,3,123,M,12,5,9,69,-54,Severe
14,8,176,F,103,13,6,162,-14,Severe
6,4,76,M,70,10,2,122,46,Well
11,6,138,M,94,12,7,151,13,Well
16,10,202,F,27,6,7,79,-123,Severe
17,3,207,F,76,10,10,130,-77,Severe
17,3,207,F,108,14,0,168,-39,Severe
6,4,76,M,105,13,9,165,89,Well
13,0,156,F,10,5,7,67,-89,Severe
8,9,105,M,13,5,9,69,-36,Severe
8,6,102,M,64,9,7,115,13,Well
11,9,141,F,96,12,10,154,13,Well
10,0,120,F,49,8,2,98,-22,Severe
5,5,65,M,65,9,8,116,51,Well
5,0,60,F,109,14,1,169,109,Well
16,8,200,M,59,9,1,109,-91,Severe
11,0,132,M,10,5,7,67,-65,Severe
14,1,169,F,105,13,9,165,-4,Mild
8,3,99,M,35,7,1,85,-14,Severe
14,5,173,M,88,12,0,144,-29,Severe
7,3,87,M,48,8,1,97,10,Well
15,10,190,M,91,12,4,148,-42,Severe
10,3,123,F,90,12,3,147,24,Well
6,0,72,M,71,10,3,123,51,Well
6,7,79,F,37,7,3,87,8,Well
16,4,196,F,44,7,9,93,-103,Severe
5,2,62,F,8,5,6,66,4,Good
7,3,87,M,40,7,5,89,2,Good
14,0,168,M,91,12,4,148,-20,Severe
14,5,173,F,105,13,9,165,-8,Severe
12,7,151,M,89,12,1,145,-6,Severe
11,2,134,F,25,6,5,77,-57,Severe
8,0,96,F,96,12,10,154,58,Well
8,4,100,F,78,11,0,132,32,Well
17,11,215,F,26,6,6,78,-137,Severe
5,8,68,M,55,8,8,104,36,Well
9,9,117,M,110,14,3,171,54,Well
5,5,65,F,53,8,6,102,37,Well
18,8,224,F,18,6,1,73,-151,Severe
16,3,195,F,39,7,5,89,-106,Severe
15,0,180,M,37,7,3,87,-93,Severe
11,9,141,F,65,9,8,116,-25,Severe
6,3,75,M,27,6,7,79,4,Good
10,6,126,M,53,8,6,102,-24,Severe
14,1,169,M,6,5,5,65,-104,Severe
15,7,187,F,95,12,9,153,-34,Severe
6,10,82,M,74,10,7,127,45,Well
18,2,218,F,86,11,10,142,-76,Severe
18,11,227,F,88,12,0,144,-83,Severe
18,6,222,F,13,5,9,69,-153,Severe
16,3,195,M,8,5,6,66,-129,Severe
12,0,144,M,8,5,6,66,-78,Severe
6,10,82,F,49,8,2,98,16,Well
8,4,100,F,70,10,2,122,22,Well
15,7,187,F,103,13,6,162,-25,Severe
14,0,168,F,69,10,1,121,-47,Severe
14,6,174,F,85,11,9,141,-33,Severe
14,5,173,F,60,9,2,110,-63,Severe
5,11,71,F,39,7,5,89,18,Well
5,11,71,F,17,6,0,72,1,Good
16,3,195,F,15,5,11,71,-124,Severe
17,1,205,F,93,12,6,150,-55,Severe
10,3,123,M,44,7,9,93,-30,Severe
9,4,112,M,35,7,1,85,-27,Severe
12,0,144,M,71,10,3,123,-21,Severe
15,9,189,F,104,13,7,163,-26,Severe
6,9,81,M,32,6,10,82,1,Good
5,2,62,F,108,14,0,168,106,Well
16,3,195,M,5,5,5,65,-130,Severe
13,2,158,F,105,13,9,165,7,Well
5,4,64,F,85,11,9,141,77,Well
16,9,201,M,89,12,1,145,-56,Severe
8,5,101,F,67,9,10,118,17,Well
5,4,64,F,104,13,7,163,99,Well
5,4,64,M,13,5,9,69,5,Good
9,3,111,M,47,8,0,96,-15,Severe
12,7,151,M,103,13,6,162,11,Well
6,6,78,F,49,8,2,98,20,Well
11,10,142,M,49,8,2,98,-44,Severe
14,0,168,F,35,7,1,85,-83,Severe
7,10,94,F,57,8,10,106,12,Well
10,10,130,M,57,8,10,106,-24,Severe
17,8,212,M,94,12,7,151,-61,Severe
12,3,147,M,29,6,8,80,-67,Severe
9,9,117,M,99,13,1,157,40,Well
15,9,189,M,99,13,1,157,-32,Severe
18,9,225,M,47,8,0,96,-129,Severe
6,8,80,M,43,7,8,92,12,Well
5,6,66,F,66,9,9,117,51,Well
18,1,217,M,94,12,7,151,-66,Severe
12,2,146,M,26,6,6,78,-68,Severe
5,5,65,M,17,6,0,72,7,Well
15,10,190,F,68,10,0,120,-70,Severe
17,10,214,F,104,13,7,163,-51,Severe
5,11,71,M,11,5,8,68,-3,Mild
11,11,143,F,62,9,4,112,-31,Severe
9,1,109,F,57,8,10,106,-3,Mild
12,7,151,M,43,7,8,92,-59,Severe
5,5,65,M,39,7,5,89,24,Well
7,0,84,M,107,13,11,167,83,Well
14,2,170,F,59,9,1,109,-61,Severe
5,8,68,F,71,10,3,123,55,Well
16,2,194,M,64,9,7,115,-79,Severe
6,9,81,F,60,9,2,110,29,Well
16,10,202,F,3,5,3,63,-139,Severe
13,6,162,F,53,8,6,102,-60,Severe
5,4,64,M,74,10,7,127,63,Well
18,8,224,F,27,6,7,79,-145,Severe
11,3,135,M,65,9,8,116,-19,Severe
7,5,89,F,97,12,11,155,66,Well
18,0,216,M,29,6,8,80,-136,Severe
10,3,123,M,107,13,11,167,44,Well
13,2,158,F,98,13,0,156,-2,Mild
16,6,198,F,72,10,4,124,-74,Severe
12,4,148,M,11,5,8,68,-80,Severe
8,10,106,F,55,8,8,104,-2,Mild
10,5,125,F,40,7,5,89,-36,Severe
12,5,149,M,79,11,1,133,-16,Severe
6,11,83,F,39,7,5,89,6,Well
15,0,180,M,29,6,8,80,-100,Severe
6,6,78,F,77,10,11,131,53,Well
6,2,74,F,25,6,5,77,3,Good
15,4,184,M,8,5,6,66,-118,Severe
18,1,217,M,45,7,10,94,-123,Severe
12,7,151,F,4,5,4,64,-87,Severe
9,0,108,F,56,8,9,105,-3,Mild
18,3,219,F,49,8,2,98,-121,Severe
9,7,115,M,95,12,9,153,38,Well
18,4,220,M,58,9,0,108,-112,Severe
17,8,212,F,77,10,11,131,-81,Severe
6,11,83,M,101,13,4,160,77,Well
7,1,85,M,87,11,11,143,58,Well
5,3,63,M,81,11,4,136,73,Well
18,3,219,F,107,13,11,167,-52,Severe
18,2,218,M,10,5,7,67,-151,Severe
10,10,130,F,7,5,6,66,-64,Severe
13,0,156,F,19,6,1,73,-83,Severe
6,9,81,F,30,6,9,81,0,Neutral
15,10,190,M,69,10,1,121,-69,Severe
15,3,183,M,37,7,3,87,-96,Severe
16,8,200,F,27,6,7,79,-121,Severe
11,8,140,M,64,9,7,115,-25,Severe
11,2,134,F,33,6,11,83,-51,Severe
11,7,139,M,47,8,0,96,-43,Severe
16,3,195,F,68,10,0,120,-75,Severe
14,6,174,M,34,7,0,84,-90,Severe
15,10,190,M,56,8,9,105,-85,Severe
12,0,144,M,27,6,7,79,-65,Severe
7,5,89,M,31,6,9,81,-8,Severe
9,2,110,F,83,11,6,138,28,Well
16,11,203,M,37,7,3,87,-116,Severe
12,0,144,F,81,11,4,136,-8,Severe
9,5,113,F,3,5,3,63,-50,Severe
16,11,203,F,96,12,10,154,-49,Severe
18,8,224,F,22,6,3,75,-149,Severe
16,3,195,F,80,11,3,135,-60,Severe
17,1,205,M,87,11,11,143,-62,Severe
6,9,81,F,84,11,7,139,58,Well
15,5,185,M,23,6,4,76,-109,Severe
8,6,102,M,104,13,7,163,61,Well
13,9,165,F,88,12,0,144,-21,Severe
15,2,182,F,6,5,5,65,-117,Severe
13,6,162,F,72,10,4,124,-38,Severe
14,3,171,F,36,7,2,86,-85,Severe
14,10,178,F,39,7,5,89,-89,Severe
11,4,136,M,40,7,5,89,-47,Severe
7,3,87,F,40,7,5,89,2,Good
18,4,220,F,66,9,9,117,-103,Severe
9,1,109,F,25,6,5,77,-32,Severe
8,4,100,M,64,9,7,115,15,Well
16,9,201,M,8,5,6,66,-135,Severe
9,8,116,M,65,9,8,116,0,Neutral
17,0,204,F,39,7,5,89,-115,Severe
12,3,147,M,107,13,11,167,20,Well
16,4,196,F,101,13,4,160,-36,Severe
14,11,179,F,21,6,2,74,-105,Severe
5,7,67,M,10,5,7,67,0,Neutral
8,9,105,F,91,12,4,148,43,Well
13,1,157,F,84,11,7,139,-18,Severe
8,10,106,M,107,13,11,167,61,Well
12,0,144,M,58,9,0,108,-36,Severe
18,10,226,F,98,13,0,156,-70,Severe
18,0,216,M,71,10,3,123,-93,Severe
10,0,120,M,66,9,9,117,-3,Mild
14,3,171,M,49,8,2,98,-73,Severe
7,3,87,F,106,13,10,166,79,Well
11,7,139,F,99,13,1,157,18,Well
18,4,220,M,100,13,3,159,-61,Severe
8,3,99,F,69,10,1,121,22,Well
16,3,195,F,30,6,9,81,-114,Severe
8,10,106,M,58,9,0,108,2,Good
14,9,177,F,76,10,10,130,-47,Severe
7,9,93,F,58,9,0,108,15,Well
10,5,125,F,2,5,3,63,-62,Severe
7,1,85,M,66,9,9,117,32,Well
13,0,156,M,94,12,7,151,-5,Mild
11,6,138,F,8,5,6,66,-72,Severe
10,11,131,M,33,6,11,83,-48,Severe
14,2,170,F,56,8,9,105,-65,Severe
18,1,217,M,49,8,2,98,-119,Severe
8,3,99,F,68,10,0,120,21,Well
17,2,206,F,109,14,1,169,-37,Severe
5,0,60,M,110,14,3,171,111,Well
8,1,97,F,31,6,9,81,-16,Severe
12,6,150,F,21,6,2,74,-76,Severe
14,3,171,M,57,8,10,106,-65,Severe
9,7,115,F,16,5,11,71,-44,Severe
6,11,83,M,93,12,6,150,67,Well
6,0,72,M,47,8,0,96,24,Well
10,1,121,M,53,8,6,102,-19,Severe
6,11,83,M,104,13,7,163,80,Well
9,3,111,F,95,12,9,153,42,Well
9,4,112,M,91,12,4,148,36,Well
15,5,185,F,11,5,8,68,-117,Severe
5,7,67,F,83,11,6,138,71,Well
8,2,98,F,41,7,6,90,-8,Severe
13,2,158,M,98,13,0,156,-2,Mild
8,2,98,F,21,6,2,74,-24,Severe
16,8,200,M,58,9,0,108,-92,Severe
9,1,109,M,32,6,10,82,-27,Severe
15,8,188,M,81,11,4,136,-52,Severe
15,10,190,M,109,14,1,169,-21,Severe
12,1,145,M,30,6,9,81,-64,Severe
17,7,211,F,106,13,10,166,-45,Severe
15,7,187,F,2,5,3,63,-124,Severe
11,10,142,M,2,5,3,63,-79,Severe
15,0,180,M,36,7,2,86,-94,Severe
10,7,127,F,28,6,8,80,-47,Severe
11,3,135,F,79,11,1,133,-2,Mild
5,3,63,F,35,7,1,85,22,Well
7,3,87,M,11,5,8,68,-19,Severe
11,1,133,M,5,5,5,65,-68,Severe
6,3,75,M,86,11,10,142,67,Well
11,2,134,F,105,13,9,165,31,Well
12,4,148,F,25,6,5,77,-71,Severe
15,11,191,M,83,11,6,138,-53,Severe
17,0,204,F,70,10,2,122,-82,Severe
6,10,82,M,71,10,3,123,41,Well
9,1,109,F,22,6,3,75,-34,Severe
7,0,84,M,100,13,3,159,75,Well
12,6,150,M,80,11,3,135,-15,Severe
14,8,176,F,83,11,6,138,-38,Severe
13,4,160,F,52,8,5,101,-59,Severe
11,1,133,F,28,6,8,80,-53,Severe
9,10,118,M,57,8,10,106,-12,Severe
5,7,67,F,12,5,9,69,2,Good
6,0,72,M,33,6,11,83,11,Well
6,5,77,F,40,7,5,89,12,Well
15,3,183,F,47,8,0,96,-87,Severe
14,1,169,F,97,12,11,155,-14,Severe
7,6,90,M,38,7,4,88,-2,Mild
17,7,211,F,7,5,6,66,-145,Severe
7,3,87,M,23,6,4,76,-11,Severe
13,10,166,F,55,8,8,104,-62,Severe
13,3,159,M,25,6,5,77,-82,Severe
5,1,61,M,39,7,5,89,28,Well
9,9,117,F,77,10,11,131,14,Well
11,0,132,F,54,8,7,103,-29,Severe
12,2,146,F,72,10,4,124,-22,Severe
13,6,162,M,50,8,3,99,-63,Severe
10,3,123,F,92,12,5,149,26,Well
7,5,89,M,7,5,6,66,-23,Severe
16,9,201,M,28,6,8,80,-121,Severe
9,3,111,M,67,9,10,118,7,Well
11,8,140,F,68,10,0,120,-20,Severe
6,4,76,F,80,11,3,135,59,Well
8,3,99,F,67,9,10,118,19,Well
11,9,141,F,40,7,5,89,-52,Severe
16,11,203,M,77,10,11,131,-72,Severe
8,10,106,F,92,12,5,149,43,Well
15,9,189,F,61,9,3,111,-78,Severe
8,8,104,M,72,10,4,124,20,Well
10,1,121,M,88,12,0,144,23,Well
5,10,70,M,91,12,4,148,78,Well
11,1,133,F,14,5,10,70,-63,Severe
9,10,118,M,71,10,3,123,5,Good
5,6,66,F,12,5,9,69,3,Good
12,4,148,F,50,8,3,99,-49,Severe
5,10,70,F,14,5,10,70,0,Neutral
14,3,171,F,84,11,7,139,-32,Severe
17,3,207,M,74,10,7,127,-80,Severe
8,9,105,F,14,5,10,70,-35,Severe
7,3,87,F,20,6,2,74,-13,Severe
5,8,68,M,69,10,1,121,53,Well
6,8,80,F,25,6,5,77,-3,Mild
14,9,177,M,56,8,9,105,-72,Severe
9,0,108,F,11,5,8,68,-40,Severe
12,11,155,F,104,13,7,163,8,Well
6,3,75,F,98,13,0,156,81,Well
13,7,163,M,3,5,3,63,-100,Severe
8,9,105,F,71,10,3,123,18,Well
18,10,226,M,29,6,8,80,-146,Severe
7,5,89,M,45,7,10,94,5,Good
16,2,194,M,23,6,4,76,-118,Severe
15,11,191,M,102,13,6,162,-29,Severe
14,7,175,F,5,5,5,65,-110,Severe
8,3,99,F,67,9,10,118,19,Well
14,6,174,F,74,10,7,127,-47,Severe
18,4,220,F,74,10,7,127,-93,Severe
18,2,218,M,99,13,1,157,-61,Severe
13,0,156,F,86,11,10,142,-14,Severe
6,7,79,F,57,8,10,106,27,Well
10,10,130,M,58,9,0,108,-22,Severe
15,9,189,F,81,11,4,136,-53,Severe
13,9,165,F,81,11,4,136,-29,Severe
9,10,118,F,88,12,0,144,26,Well
8,0,96,M,9,5,7,67,-29,Severe
6,2,74,F,38,7,4,88,14,Well
7,9,93,F,52,8,5,101,8,Well
16,8,200,F,35,7,1,85,-115,Severe
11,5,137,F,17,6,0,72,-65,Severe
14,3,171,F,43,7,8,92,-79,Severe
5,6,66,F,94,12,7,151,85,Well
18,4,220,F,87,11,11,143,-77,Severe
12,0,144,F,62,9,4,112,-32,Severe
10,3,123,F,4,5,4,64,-59,Severe
10,5,125,M,4,5,4,64,-61,Severe
5,7,67,F,51,8,4,100,33,Well
14,9,177,F,108,14,0,168,-9,Severe
11,1,133,F,45,7,10,94,-39,Severe
7,4,88,F,44,7,9,93,5,Good
9,0,108,M,32,6,10,82,-26,Severe
7,2,86,M,76,10,10,130,44,Well
16,11,203,F,69,10,1,121,-82,Severe
15,3,183,M,6,5,5,65,-118,Severe
9,2,110,F,5,5,5,65,-45,Severe
8,2,98,M,78,11,0,132,34,Well
5,0,60,M,24,6,5,77,17,Well
9,6,114,F,17,6,0,72,-42,Severe
18,4,220,M,13,5,9,69,-151,Severe
12,3,147,M,40,7,5,89,-58,Severe
7,3,87,M,88,12,0,144,57,Well
10,8,128,F,30,6,9,81,-47,Severe
11,2,134,F,53,8,6,102,-32,Severe
5,3,63,M,28,6,8,80,17,Well
9,9,117,F,10,5,7,67,-50,Severe
11,1,133,F,102,13,6,162,29,Well
17,11,215,F,22,6,3,75,-140,Severe
13,7,163,F,64,9,7,115,-48,Severe
17,7,211,M,108,14,0,168,-43,Severe
16,2,194,M,48,8,1,97,-97,Severe
8,9,105,M,36,7,2,86,-19,Severe
18,2,218,M,73,10,6,126,-92,Severe
7,4,88,M,94,12,7,151,63,Well
15,3,183,F,93,12,6,150,-33,Severe
18,11,227,F,82,11,5,137,-90,Severe
16,0,192,M,46,7,11,95,-97,Severe
9,10,118,M,68,10,0,120,2,Good
5,0,60,M,35,7,1,85,25,Well
7,8,92,F,70,10,2,122,30,Well
10,4,124,M,26,6,6,78,-46,Severe
6,3,75,M,22,6,3,75,0,Neutral
18,3,219,M,62,9,4,112,-107,Severe
11,7,139,F,40,7,5,89,-50,Severe
11,2,134,F,99,13,1,157,23,Well
7,3,87,M,79,11,1,133,46,Well
7,2,86,M,37,7,3,87,1,Good
8,9,105,F,90,12,3,147,42,Well
9,3,111,M,37,7,3,87,-24,Severe
17,4,208,M,5,5,5,65,-143,Severe
12,1,145,F,30,6,9,81,-64,Severe
6,3,75,M,108,14,0,168,93,Well
17,4,208,M,73,10,6,126,-82,Severe
7,3,87,M,51,8,4,100,13,Well
5,9,69,M,44,7,9,93,24,Well
5,5,65,F,68,10,0,120,55,Well
5,3,63,F,104,13,7,163,100,Well
9,3,111,M,7,5,6,66,-45,Severe
5,3,63,F,20,6,2,74,11,Well
13,6,162,M,100,13,3,159,-3,Mild
11,4,136,M,53,8,6,102,-34,Severe
9,2,110,M,98,13,0,156,46,Well
6,1,73,F,29,6,8,80,7,Well
15,10,190,M,33,6,11,83,-107,Severe
9,1,109,F,79,11,1,133,24,Well
12,4,148,M,83,11,6,138,-10,Severe
12,6,150,F,63,9,6,114,-36,Severe
7,11,95,M,84,11,7,139,44,Well
11,3,135,F,82,11,5,137,2,Good
17,3,207,F,62,9,4,112,-95,Severe
14,11,179,F,68,10,0,120,-59,Severe
14,4,172,M,69,10,1,121,-51,Severe
10,7,127,F,48,8,1,97,-30,Severe
7,3,87,F,40,7,5,89,2,Good
9,3,111,M,105,13,9,165,54,Well
5,2,62,M,31,6,9,81,19,Well
14,1,169,M,57,8,10,106,-63,Severe
5,5,65,F,91,12,4,148,83,Well
15,7,187,M,16,5,11,71,-116,Severe
18,3,219,M,37,7,3,87,-132,Severe
14,9,177,M,92,12,5,149,-28,Severe
7,10,94,F,15,5,11,71,-23,Severe
8,3,99,M,18,6,1,73,-26,Severe
10,11,131,M,110,14,3,171,40,Well
15,11,191,M,40,7,5,89,-102,Severe
15,4,184,F,10,5,7,67,-117,Severe
11,10,142,M,28,6,8,80,-62,Severe
16,3,195,F,80,11,3,135,-60,Severe
6,7,79,F,99,13,1,157,78,Well
8,2,98,F,10,5,7,67,-31,Severe
13,2,158,M,109,14,1,169,11,Well
13,1,157,F,95,12,9,153,-4,Mild
11,6,138,M,75,10,9,129,-9,Severe
10,1,121,M,78,11,0,132,11,Well
13,9,165,F,110,14,3,171,6,Well
8,0,96,M,110,14,3,171,75,Well
7,1,85,M,36,7,2,86,1,Good
10,6,126,M,44,7,9,93,-33,Severe
7,0,84,F,40,7,5,89,5,Good
12,5,149,F,17,6,0,72,-77,Severe
18,4,220,M,63,9,6,114,-106,Severe
5,8,68,M,71,10,3,123,55,Well
11,7,139,M,28,6,8,80,-59,Severe
10,3,123,M,42,7,7,91,-32,Severe
14,7,175,F,52,8,5,101,-74,Severe
11,1,133,M,8,5,6,66,-67,Severe
8,6,102,M,96,12,10,154,52,Well
7,2,86,F,12,5,9,69,-17,Severe
10,8,128,M,26,6,6,78,-50,Severe
14,2,170,M,99,13,1,157,-13,Severe
9,7,115,M,97,12,11,155,40,Well
16,0,192,F,74,10,7,127,-65,Severe
6,2,74,M,58,9,0,108,34,Well
14,1,169,F,28,6,8,80,-89,Severe
6,6,78,M,87,11,11,143,65,Well
17,0,204,M,36,7,2,86,-118,Severe
16,4,196,M,4,5,4,64,-132,Severe
10,9,129,M,104,13,7,163,34,Well
12,4,148,M,95,12,9,153,5,Good
11,8,140,M,22,6,3,75,-65,Severe
6,2,74,M,87,11,11,143,69,Well
8,8,104,F,7,5,6,66,-38,Severe
6,6,78,M,10,5,7,67,-11,Severe
11,4,136,F,60,9,2,110,-26,Severe
9,4,112,M,41,7,6,90,-22,Severe
13,3,159,M,38,7,4,88,-71,Severe
17,1,205,M,22,6,3,75,-130,Severe
10,8,128,F,39,7,5,89,-39,Severe
16,1,193,F,65,9,8,116,-77,Severe
12,4,148,M,96,12,10,154,6,Well
13,11,167,M,60,9,2,110,-57,Severe
8,9,105,M,110,14,3,171,66,Well
7,3,87,F,3,5,3,63,-24,Severe
11,9,141,F,99,13,1,157,16,Well
13,6,162,M,45,7,10,94,-68,Severe
15,5,185,F,57,8,10,106,-79,Severe
16,8,200,M,5,5,5,65,-135,Severe
13,1,157,M,99,13,1,157,0,Neutral
18,6,222,M,55,8,8,104,-118,Severe
15,10,190,M,21,6,2,74,-116,Severe
8,3,99,F,17,6,0,72,-27,Severe
11,11,143,F,20,6,2,74,-69,Severe
10,5,125,M,87,11,11,143,18,Well
5,4,64,F,44,7,9,93,29,Well
7,10,94,F,26,6,6,78,-16,Severe
15,8,188,M,3,5,3,63,-125,Severe
12,9,153,F,5,5,5,65,-88,Severe
15,5,185,M,73,10,6,126,-59,Severe
7,0,84,M,95,12,9,153,69,Well
17,6,210,F,20,6,2,74,-136,Severe
15,4,184,M,53,8,6,102,-82,Severe
7,10,94,F,41,7,6,90,-4,Mild
16,3,195,M,3,5,3,63,-132,Severe
17,2,206,M,54,8,7,103,-103,Severe
17,7,211,F,100,13,3,159,-52,Severe
7,3,87,M,60,9,2,110,23,Well
8,1,97,M,95,12,9,153,56,Well
5,7,67,M,22,6,3,75,8,Well
14,10,178,M,91,12,4,148,-30,Severe
8,1,97,M,98,13,0,156,59,Well
13,6,162,F,34,7,0,84,-78,Severe
8,2,98,M,71,10,3,123,25,Well
11,1,133,M,104,13,7,163,30,Well
7,9,93,F,17,6,0,72,-21,Severe
18,5,221,M,67,9,10,118,-103,Severe
7,10,94,M,108,14,0,168,74,Well
16,8,200,F,108,14,0,168,-32,Severe
17,1,205,M,27,6,7,79,-126,Severe
17,8,212,M,108,14,0,168,-44,Severe
6,3,75,M,14,5,10,70,-5,Mild
10,7,127,F,89,12,1,145,18,Well
7,7,91,F,34,7,0,84,-7,Severe
6,9,81,M,96,12,10,154,73,Well
16,3,195,M,14,5,10,70,-125,Severe
13,11,167,M,61,9,3,111,-56,Severe
15,0,180,M,69,10,1,121,-59,Severe
11,3,135,F,32,6,10,82,-53,Severe
14,11,179,M,23,6,4,76,-103,Severe
15,10,190,F,6,5,5,65,-125,Severe
6,1,73,M,95,12,9,153,80,Well
5,8,68,M,75,10,9,129,61,Well
11,4,136,F,103,13,6,162,26,Well
15,3,183,M,3,5,3,63,-120,Severe
5,0,60,M,100,13,3,159,99,Well
5,5,65,M,67,9,10,118,53,Well
9,6,114,M,89,12,1,145,31,Well
15,4,184,M,9,5,7,67,-117,Severe
9,6,114,M,31,6,9,81,-33,Severe
10,5,125,M,21,6,2,74,-51,Severe
15,7,187,F,91,12,4,148,-39,Severe
11,3,135,F,64,9,7,115,-20,Severe
18,0,216,M,52,8,5,101,-115,Severe
5,3,63,F,21,6,2,74,11,Well
13,10,166,M,2,5,3,63,-103,Severe
17,2,206,F,3,5,3,63,-143,Severe
17,2,206,F,84,11,7,139,-67,Severe
9,9,117,M,52,8,5,101,-16,Severe
15,6,186,F,91,12,4,148,-38,Severe
17,10,214,M,70,10,2,122,-92,Severe
5,1,61,F,20,6,2,74,13,Well
14,3,171,F,82,11,5,137,-34,Severe
11,11,143,F,64,9,7,115,-28,Severe
13,9,165,M,104,13,7,163,-2,Mild
15,3,183,M,97,12,11,155,-28,Severe
14,6,174,F,34,7,0,84,-90,Severe
12,2,146,M,49,8,2,98,-48,Severe
16,1,193,F,50,8,3,99,-94,Severe
11,5,137,F,9,5,7,67,-70,Severe
6,9,81,F,22,6,3,75,-6,Severe
6,3,75,F,49,8,2,98,23,Well
11,5,137,F,89,12,1,145,8,Well
18,9,225,M,7,5,6,66,-159,Severe
10,2,122,F,7,5,6,66,-56,Severe
10,4,124,M,4,5,4,64,-60,Severe
18,8,224,F,60,9,2,110,-114,Severe
17,3,207,F,100,13,3,159,-48,Severe
5,2,62,F,31,6,9,81,19,Well
6,1,73,M,34,7,0,84,11,Well
5,3,63,F,102,13,6,162,99,Well
6,3,75,F,57,8,10,106,31,Well
15,3,183,F,39,7,5,89,-94,Severe
6,6,78,M,9,5,7,67,-11,Severe
17,10,214,M,46,7,11,95,-119,Severe
10,6,126,M,58,9,0,108,-18,Severe
15,3,183,M,99,13,1,157,-26,Severe
18,7,223,M,107,13,11,167,-56,Severe
11,11,143,M,110,14,3,171,28,Well
8,1,97,M,72,10,4,124,27,Well
10,8,128,M,25,6,5,77,-51,Severe
7,9,93,M,109,14,1,169,76,Well
16,10,202,M,60,9,2,110,-92,Severe
10,9,129,M,65,9,8,116,-13,Severe
6,8,80,F,39,7,5,89,9,Well
7,8,92,M,44,7,9,93,1,Good
12,0,144,M,51,8,4,100,-44,Severe
12,8,152,M,18,6,1,73,-79,Severe
9,3,111,F,25,6,5,77,-34,Severe
14,7,175,F,91,12,4,148,-27,Severe
12,10,154,M,94,12,7,151,-3,Mild
6,0,72,F,43,7,8,92,20,Well
13,10,166,M,47,8,0,96,-70,Severe
13,11,167,F,93,12,6,150,-17,Severe
11,2,134,M,103,13,6,162,28,Well
11,4,136,M,20,6,2,74,-62,Severe
11,0,132,M,17,6,0,72,-60,Severe
16,11,203,M,96,12,10,154,-49,Severe
5,10,70,M,30,6,9,81,11,Well
18,7,223,M,87,11,11,143,-80,Severe
12,10,154,M,59,9,1,109,-45,Severe
11,3,135,M,5,5,5,65,-70,Severe
13,9,165,M,45,7,10,94,-71,Severe
17,10,214,M,31,6,9,81,-133,Severe
12,10,154,M,101,13,4,160,6,Well
12,5,149,F,57,8,10,106,-43,Severe
5,5,65,F,51,8,4,100,35,Well
15,3,183,F,19,6,1,73,-110,Severe
10,5,125,F,48,8,1,97,-28,Severe
6,5,77,F,70,10,2,122,45,Well
7,0,84,F,105,13,9,165,81,Well
7,9,93,M,43,7,8,92,-1,Mild
14,3,171,F,6,5,5,65,-106,Severe
6,5,77,M,14,5,10,70,-7,Severe
17,0,204,M,19,6,1,73,-131,Severe
17,5,209,F,91,12,4,148,-61,Severe
18,2,218,M,43,7,8,92,-126,Severe
12,10,154,F,15,5,11,71,-83,Severe
10,6,126,F,37,7,3,87,-39,Severe
7,6,90,F,68,10,0,120,30,Well
7,3,87,F,96,12,10,154,67,Well
10,3,123,F,37,7,3,87,-36,Severe
12,8,152,F,61,9,3,111,-41,Severe
7,10,94,M,3,5,3,63,-31,Severe
14,9,177,F,5,5,5,65,-112,Severe
10,3,123,F,83,11,6,138,15,Well
10,4,124,F,28,6,8,80,-44,Severe
6,4,76,M,51,8,4,100,24,Well
18,6,222,F,24,6,5,77,-145,Severe
8,0,96,M,80,11,3,135,39,Well
15,11,191,M,80,11,3,135,-56,Severe
8,10,106,F,74,10,7,127,21,Well
11,8,140,M,86,11,10,142,2,Good
18,1,217,M,54,8,7,103,-114,Severe
18,4,220,M,76,10,10,130,-90,Severe
14,4,172,F,109,14,1,169,-3,Mild
9,9,117,F,85,11,9,141,24,Well
12,3,147,M,99,13,1,157,10,Well
15,8,188,F,105,13,9,165,-23,Severe
8,11,107,M,16,5,11,71,-36,Severe
13,10,166,F,49,8,2,98,-68,Severe
9,4,112,F,96,12,10,154,42,Well
9,8,116,M,23,6,4,76,-40,Severe
5,11,71,M,69,10,1,121,50,Well
10,8,128,M,3,5,3,63,-65,Severe
5,4,64,M,33,6,11,83,19,Well
10,3,123,F,57,8,10,106,-17,Severe
9,7,115,F,59,9,1,109,-6,Severe
8,0,96,M,74,10,7,127,31,Well
5,7,67,M,29,6,8,80,13,Well
7,3,87,M,52,8,5,101,14,Well
15,7,187,F,110,14,3,171,-16,Severe
6,2,74,M,49,8,2,98,24,Well
14,9,177,F,74,10,7,127,-50,Severe
18,8,224,M,8,5,6,66,-158,Severe
9,7,115,F,49,8,2,98,-17,Severe
9,3,111,M,23,6,4,76,-35,Severe
15,11,191,M,35,7,1,85,-106,Severe
16,2,194,M,8,5,6,66,-128,Severe
9,4,112,M,5,5,5,65,-47,Severe
11,11,143,F,28,6,8,80,-63,Severe
15,8,188,F,14,5,10,70,-118,Severe
16,9,201,M,61,9,3,111,-90,Severe
9,4,112,F,51,8,4,100,-12,Severe
15,0,180,M,82,11,5,137,-43,Severe
18,4,220,F,83,11,6,138,-82,Severe
7,10,94,F,59,9,1,109,15,Well
13,11,167,F,76,10,10,130,-37,Severe
12,8,152,M,70,10,2,122,-30,Severe
15,6,186,M,6,5,5,65,-121,Severe
11,4,136,F,33,6,11,83,-53,Severe
12,3,147,F,9,5,7,67,-80,Severe
15,7,187,M,96,12,10,154,-33,Severe
9,10,118,M,98,13,0,156,38,Well
16,3,195,M,56,8,9,105,-90,Severe
10,9,129,M,12,5,9,69,-60,Severe
13,10,166,F,64,9,7,115,-51,Severe
12,0,144,F,100,13,3,159,15,Well
18,0,216,M,59,9,1,109,-107,Severe
13,8,164,M,12,5,9,69,-95,Severe
12,8,152,F,3,5,3,63,-89,Severe
18,1,217,F,4,5,4,64,-153,Severe
6,3,75,F,26,6,6,78,3,Good
6,5,77,F,74,10,7,127,50,Well
10,3,123,M,88,12,0,144,21,Well
12,2,146,M,25,6,5,77,-69,Severe
18,1,217,F,31,6,9,81,-136,Severe
14,2,170,M,62,9,4,112,-58,Severe
7,8,92,F,39,7,5,89,-3,Mild
14,2,170,M,110,14,3,171,1,Good
15,10,190,F,85,11,9,141,-49,Severe
10,3,123,F,82,11,5,137,14,Well
16,10,202,M,38,7,4,88,-114,Severe
5,10,70,F,51,8,4,100,30,Well
14,0,168,F,39,7,5,89,-79,Severe
17,3,207,M,10,5,7,67,-140,Severe
10,3,123,F,52,8,5,101,-22,Severe
12,3,147,F,79,11,1,133,-14,Severe
5,11,71,M,24,6,5,77,6,Well
12,9,153,M,100,13,3,159,6,Well
11,10,142,M,93,12,6,150,8,Well
5,6,66,M,44,7,9,93,27,Well
10,2,122,M,14,5,10,70,-52,Severe
9,2,110,F,68,10,0,120,10,Well
6,0,72,M,16,5,11,71,-1,Mild
15,2,182,M,97,12,11,155,-27,Severe
11,2,134,M,3,5,3,63,-71,Severe
10,5,125,M,28,6,8,80,-45,Severe
10,10,130,F,49,8,2,98,-32,Severe
5,1,61,M,48,8,1,97,36,Well
18,4,220,M,38,7,4,88,-132,Severe
10,3,123,F,86,11,10,142,19,Well
13,2,158,M,86,11,10,142,-16,Severe
7,4,88,F,20,6,2,74,-14,Severe
17,3,207,F,2,5,3,63,-144,Severe
14,4,172,M,24,6,5,77,-95,Severe
7,7,91,F,62,9,4,112,21,Well
5,4,64,F,26,6,6,78,14,Well
16,9,201,F,57,8,10,106,-95,Severe
7,8,92,F,55,8,8,104,12,Well
17,4,208,M,98,13,0,156,-52,Severe
7,2,86,M,41,7,6,90,4,Good
12,3,147,M,97,12,11,155,8,Well
15,2,182,M,2,5,3,63,-119,Severe
12,8,152,M,93,12,6,150,-2,Mild
16,1,193,F,102,13,6,162,-31,Severe
17,7,211,M,109,14,1,169,-42,Severe
5,10,70,M,5,5,5,65,-5,Mild
5,7,67,M,8,5,6,66,-1,Mild
6,0,72,M,104,13,7,163,91,Well
14,5,173,F,82,11,5,137,-36,Severe
15,1,181,M,66,9,9,117,-64,Severe
9,8,116,F,72,10,4,124,8,Well
14,0,168,F,95,12,9,153,-15,Severe
10,4,124,F,85,11,9,141,17,Well
5,8,68,F,16,5,11,71,3,Good
5,1,61,M,8,5,6,66,5,Good
12,3,147,M,31,6,9,81,-66,Severe
17,11,215,M,64,9,7,115,-100,Severe
7,2,86,F,46,7,11,95,9,Well
6,3,75,M,42,7,7,91,16,Well
18,7,223,M,67,9,10,118,-105,Severe
7,3,87,M,48,8,1,97,10,Well
8,8,104,M,96,12,10,154,50,Well
14,8,176,F,42,7,7,91,-85,Severe
16,2,194,F,105,13,9,165,-29,Severe
17,3,207,F,85,11,9,141,-66,Severe
14,11,179,M,83,11,6,138,-41,Severe
6,7,79,M,90,12,3,147,68,Well
8,11,107,M,39,7,5,89,-18,Severe
18,9,225,M,26,6,6,78,-147,Severe
7,8,92,F,103,13,6,162,70,Well
11,8,140,F,59,9,1,109,-31,Severe
7,2,86,M,28,6,8,80,-6,Severe
7,9,93,F,93,12,6,150,57,Well
9,10,118,F,82,11,5,137,19,Well
9,4,112,M,83,11,6,138,26,Well
17,7,211,M,13,5,9,69,-142,Severe
17,0,204,F,86,11,10,142,-62,Severe
9,0,108,M,26,6,6,78,-30,Severe
7,3,87,M,18,6,1,73,-14,Severe
7,9,93,F,5,5,5,65,-28,Severe
16,1,193,M,53,8,6,102,-91,Severe
5,6,66,F,61,9,3,111,45,Well
7,3,87,M,20,6,2,74,-13,Severe
11,5,137,F,64,9,7,115,-22,Severe
10,1,121,F,61,9,3,111,-10,Severe
11,9,141,M,68,10,0,120,-21,Severe
5,8,68,F,73,10,6,126,58,Well
12,3,147,M,64,9,7,115,-32,Severe
14,1,169,M,46,7,11,95,-74,Severe
13,8,164,F,50,8,3,99,-65,Severe
6,6,78,F,52,8,5,101,23,Well
10,6,126,F,96,12,10,154,28,Well
18,10,226,M,91,12,4,148,-78,Severe
16,0,192,M,80,11,3,135,-57,Severe
15,6,186,M,11,5,8,68,-118,Severe
17,3,207,M,64,9,7,115,-92,Severe
13,8,164,M,5,5,5,65,-99,Severe
15,4,184,F,22,6,3,75,-109,Severe
11,0,132,M,76,10,10,130,-2,Mild
10,8,128,F,14,5,10,70,-58,Severe
15,8,188,M,92,12,5,149,-39,Severe
10,3,123,M,46,7,11,95,-28,Severe
12,8,152,F,39,7,5,89,-63,Severe
7,1,85,F,29,6,8,80,-5,Mild
11,10,142,M,108,14,0,168,26,Well
12,7,151,F,75,10,9,129,-22,Severe
14,10,178,F,30,6,9,81,-97,Severe
16,4,196,M,86,11,10,142,-54,Severe
9,2,110,M,64,9,7,115,5,Good
9,0,108,F,53,8,6,102,-6,Severe
10,6,126,F,51,8,4,100,-26,Severe
15,0,180,F,55,8,8,104,-76,Severe
8,5,101,F,26,6,6,78,-23,Severe
10,1,121,F,49,8,2,98,-23,Severe
15,6,186,F,39,7,5,89,-97,Severe
7,1,85,M,7,5,6,66,-19,Severe
5,9,69,F,4,5,4,64,-5,Mild
17,3,207,M,99,13,1,157,-50,Severe
8,3,99,M,14,5,10,70,-29,Severe
14,9,177,M,11,5,8,68,-109,Severe
18,3,219,F,15,5,11,71,-148,Severe
8,11,107,F,13,5,9,69,-38,Severe
14,4,172,F,110,14,3,171,-1,Mild
18,7,223,F,105,13,9,165,-58,Severe
12,2,146,M,13,5,9,69,-77,Severe
17,3,207,M,14,5,10,70,-137,Severe
10,3,123,M,63,9,6,114,-9,Severe
9,6,114,F,31,6,9,81,-33,Severe
8,9,105,F,46,7,11,95,-10,Severe
8,5,101,M,57,8,10,106,5,Good
8,6,102,M,4,5,4,64,-38,Severe
13,9,165,F,87,11,11,143,-22,Severe
5,8,68,F,85,11,9,141,73,Well
9,4,112,M,107,13,11,167,55,Well
10,6,126,M,37,7,3,87,-39,Severe
8,7,103,M,85,11,9,141,38,Well
13,3,159,F,26,6,6,78,-81,Severe
9,6,114,F,79,11,1,133,19,Well
13,6,162,F,83,11,6,138,-24,Severe
12,11,155,F,52,8,5,101,-54,Severe
9,9,117,F,52,8,5,101,-16,Severe
18,9,225,M,86,11,10,142,-83,Severe
17,6,210,F,42,7,7,91,-119,Severe
16,3,195,M,46,7,11,95,-100,Severe
6,5,77,M,99,13,1,157,80,Well
8,3,99,F,40,7,5,89,-10,Severe
15,4,184,F,79,11,1,133,-51,Severe
16,3,195,M,92,12,5,149,-46,Severe
7,2,86,M,55,8,8,104,18,Well
16,2,194,F,54,8,7,103,-91,Severe
11,7,139,F,88,12,0,144,5,Good
5,3,63,F,70,10,2,122,59,Well
11,9,141,M,96,12,10,154,13,Well
12,6,150,M,77,10,11,131,-19,Severe
11,5,137,M,47,8,0,96,-41,Severe
7,3,87,F,108,14,0,168,81,Well
11,9,141,F,100,13,3,159,18,Well
13,1,157,F,93,12,6,150,-7,Severe
10,4,124,M,36,7,2,86,-38,Severe
14,3,171,F,31,6,9,81,-90,Severe
13,11,167,F,15,5,11,71,-96,Severe
14,9,177,M,106,13,10,166,-11,Severe
6,7,79,M,93,12,6,150,71,Well
6,7,79,M,101,13,4,160,81,Well
10,11,131,F,16,5,11,71,-60,Severe
10,5,125,F,54,8,7,103,-22,Severe
12,11,155,F,109,14,1,169,14,Well
10,9,129,F,22,6,3,75,-54,Severe
13,7,163,M,87,11,11,143,-20,Severe
17,1,205,F,55,8,8,104,-101,Severe
9,3,111,M,11,5,8,68,-43,Severe
12,2,146,F,85,11,9,141,-5,Mild
9,2,110,F,35,7,1,85,-25,Severe
8,3,99,F,29,6,8,80,-19,Severe
17,0,204,M,93,12,6,150,-54,Severe
16,1,193,F,27,6,7,79,-114,Severe
18,7,223,M,63,9,6,114,-109,Severe
13,4,160,F,7,5,6,66,-94,Severe
7,6,90,F,88,12,0,144,54,Well
16,9,201,F,61,9,3,111,-90,Severe
15,6,186,F,3,5,3,63,-123,Severe
12,5,149,M,48,8,1,97,-52,Severe
14,11,179,M,58,9,0,108,-71,Severe
16,11,203,M,3,5,3,63,-140,Severe
17,5,209,M,32,6,10,82,-127,Severe
11,3,135,F,68,10,0,120,-15,Severe
8,3,99,M,26,6,6,78,-21,Severe
5,5,65,M,63,9,6,114,49,Well
18,7,223,M,3,5,3,63,-160,Severe
7,10,94,M,53,8,6,102,8,Well
18,2,218,F,97,12,11,155,-63,Severe
6,8,80,M,91,12,4,148,68,Well
12,3,147,F,91,12,4,148,1,Good
9,8,116,F,41,7,6,90,-26,Severe
14,11,179,F,110,14,3,171,-8,Severe
6,11,83,F,53,8,6,102,19,Well
16,3,195,F,53,8,6,102,-93,Severe
11,3,135,M,105,13,9,165,30,Well
15,4,184,F,66,9,9,117,-67,Severe
15,4,184,M,58,9,0,108,-76,Severe
16,3,195,F,8,5,6,66,-129,Severe
13,5,161,F,51,8,4,100,-61,Severe
10,5,125,M,54,8,7,103,-22,Severe
5,2,62,M,65,9,8,116,54,Well
13,6,162,M,62,9,4,112,-50,Severe
10,6,126,M,17,6,0,72,-54,Severe
18,3,219,M,106,13,10,166,-53,Severe
7,10,94,F,36,7,2,86,-8,Severe
18,6,222,F,81,11,4,136,-86,Severe
18,1,217,M,100,13,3,159,-58,Severe
17,0,204,F,108,14,0,168,-36,Severe
16,11,203,F,105,13,9,165,-38,Severe
11,0,132,F,69,10,1,121,-11,Severe
12,2,146,F,102,13,6,162,16,Well
16,5,197,F,104,13,7,163,-34,Severe
7,0,84,F,94,12,7,151,67,Well
12,0,144,F,110,14,3,171,27,Well
11,2,134,F,93,12,6,150,16,Well
14,5,173,F,93,12,6,150,-23,Severe
8,10,106,F,102,13,6,162,56,Well
6,3,75,M,74,10,7,127,52,Well
8,3,99,M,16,5,11,71,-28,Severe
16,3,195,M,73,10,6,126,-69,Severe
11,5,137,F,108,14,0,168,31,Well
9,11,119,F,14,5,10,70,-49,Severe
14,3,171,F,85,11,9,141,-30,Severe
17,9,213,F,28,6,8,80,-133,Severe
14,3,171,F,35,7,1,85,-86,Severe
8,2,98,M,81,11,4,136,38,Well
18,5,221,F,72,10,4,124,-97,Severe
6,5,77,F,85,11,9,141,64,Well
10,11,131,M,102,13,6,162,31,Well
13,6,162,F,24,6,5,77,-85,Severe
12,4,148,M,34,7,0,84,-64,Severe
18,11,227,F,48,8,1,97,-130,Severe
7,8,92,F,27,6,7,79,-13,Severe
11,1,133,F,7,5,6,66,-67,Severe
7,1,85,F,95,12,9,153,68,Well
8,10,106,F,6,5,5,65,-41,Severe
16,4,196,M,22,6,3,75,-121,Severe
18,5,221,F,65,9,8,116,-105,Severe
11,10,142,M,26,6,6,78,-64,Severe
13,0,156,M,80,11,3,135,-21,Severe
17,9,213,F,32,6,10,82,-131,Severe
17,4,208,F,38,7,4,88,-120,Severe
9,3,111,M,53,8,6,102,-9,Severe
14,9,177,M,24,6,5,77,-100,Severe
17,9,213,F,4,5,4,64,-149,Severe
15,2,182,F,97,12,11,155,-27,Severe
11,9,141,M,36,7,2,86,-55,Severe
15,6,186,M,66,9,9,117,-69,Severe
18,1,217,F,103,13,6,162,-55,Severe
17,0,204,M,66,9,9,117,-87,Severe
12,5,149,F,89,12,1,145,-4,Mild
17,11,215,F,47,8,0,96,-119,Severe
8,6,102,F,89,12,1,145,43,Well
7,3,87,F,27,6,7,79,-8,Severe
11,8,140,M,17,6,0,72,-68,Severe
14,9,177,F,80,11,3,135,-42,Severe
6,9,81,F,101,13,4,160,79,Well
15,8,188,F,67,9,10,118,-70,Severe
18,3,219,M,24,6,5,77,-142,Severe
16,7,199,M,42,7,7,91,-108,Severe
18,10,226,M,57,8,10,106,-120,Severe
14,1,169,M,73,10,6,126,-43,Severe
11,3,135,M,31,6,9,81,-54,Severe
16,3,195,F,41,7,6,90,-105,Severe
12,10,154,F,21,6,2,74,-80,Severe
13,3,159,F,24,6,5,77,-82,Severe
16,7,199,M,61,9,3,111,-88,Severe
14,5,173,M,60,9,2,110,-63,Severe
14,4,172,M,25,6,5,77,-95,Severe
8,8,104,F,40,7,5,89,-15,Severe
11,0,132,F,97,12,11,155,23,Well
9,9,117,M,14,5,10,70,-47,Severe
14,1,169,F,77,10,11,131,-38,Severe
5,7,67,M,61,9,3,111,44,Well
18,3,219,M,109,14,1,169,-50,Severe
11,5,137,F,23,6,4,76,-61,Severe
11,10,142,M,66,9,9,117,-25,Severe
7,0,84,M,55,8,8,104,20,Well
9,6,114,M,20,6,2,74,-40,Severe
8,3,99,F,59,9,1,109,10,Well
10,5,125,F,38,7,4,88,-37,Severe
8,1,97,M,100,13,3,159,62,Well
16,1,193,F,19,6,1,73,-120,Severe
14,5,173,F,95,12,9,153,-20,Severe
18,3,219,F,39,7,5,89,-130,Severe
5,5,65,M,80,11,3,135,70,Well
12,3,147,F,70,10,2,122,-25,Severe
12,3,147,M,80,11,3,135,-12,Severe
15,4,184,F,54,8,7,103,-81,Severe
8,11,107,M,58,9,0,108,1,Good
10,3,123,F,33,6,11,83,-40,Severe
5,3,63,M,105,13,9,165,102,Well
7,11,95,F,39,7,5,89,-6,Severe
9,7,115,F,14,5,10,70,-45,Severe
16,1,193,F,16,5,11,71,-122,Severe
9,0,108,F,102,13,6,162,54,Well
8,4,100,M,11,5,8,68,-32,Severe
10,5,125,M,51,8,4,100,-25,Severe
11,6,138,F,35,7,1,85,-53,Severe
7,1,85,F,58,9,0,108,23,Well
16,11,203,F,66,9,9,117,-86,Severe
9,9,117,F,9,5,7,67,-50,Severe
8,7,103,M,44,7,9,93,-10,Severe
12,2,146,F,98,13,0,156,10,Well
18,3,219,F,16,5,11,71,-148,Severe
8,9,105,F,34,7,0,84,-21,Severe
10,9,129,F,101,13,4,160,31,Well
7,7,91,M,92,12,5,149,58,Well
16,2,194,M,98,13,0,156,-38,Severe
14,1,169,F,5,5,5,65,-104,Severe
7,1,85,M,67,9,10,118,33,Well
7,11,95,M,12,5,9,69,-26,Severe
6,10,82,F,52,8,5,101,19,Well
16,0,192,F,68,10,0,120,-72,Severe
15,4,184,M,11,5,8,68,-116,Severe
7,11,95,F,14,5,10,70,-25,Severe
16,10,202,F,69,10,1,121,-81,Severe
17,11,215,M,60,9,2,110,-105,Severe
18,6,222,F,31,6,9,81,-141,Severe
6,10,82,M,73,10,6,126,44,Well
14,4,172,F,88,12,0,144,-28,Severe
6,2,74,M,33,6,11,83,9,Well
11,0,132,M,97,12,11,155,23,Well
9,3,111,M,76,10,10,130,19,Well
11,1,133,M,65,9,8,116,-17,Severe
7,3,87,F,86,11,10,142,55,Well
18,1,217,F,75,10,9,129,-88,Severe
9,11,119,F,50,8,3,99,-20,Severe
17,8,212,F,36,7,2,86,-126,Severe
12,11,155,F,43,7,8,92,-63,Severe
8,7,103,M,21,6,2,74,-29,Severe
15,9,189,F,32,6,10,82,-107,Severe
6,10,82,F,48,8,1,97,15,Well
7,2,86,F,64,9,7,115,29,Well
16,5,197,F,85,11,9,141,-56,Severe
16,3,195,M,18,6,1,73,-122,Severe
8,1,97,M,99,13,1,157,60,Well
7,7,91,F,69,10,1,121,30,Well
14,5,173,F,35,7,1,85,-88,Severe
14,1,169,M,107,13,11,167,-2,Mild
16,2,194,M,97,12,11,155,-39,Severe
11,0,132,M,27,6,7,79,-53,Severe
10,9,129,M,90,12,3,147,18,Well
13,1,157,F,7,5,6,66,-91,Severe
15,3,183,M,60,9,2,110,-73,Severe
17,7,211,M,62,9,4,112,-99,Severe
13,10,166,M,78,11,0,132,-34,Severe
8,10,106,M,82,11,5,137,31,Well
9,9,117,M,31,6,9,81,-36,Severe
9,8,116,F,80,11,3,135,19,Well
16,2,194,M,85,11,9,141,-53,Severe
9,10,118,M,59,9,1,109,-9,Severe
10,6,126,M,102,13,6,162,36,Well
6,6,78,F,41,7,6,90,12,Well
15,5,185,M,3,5,3,63,-122,Severe
12,1,145,M,73,10,6,126,-19,Severe
15,5,185,M,24,6,5,77,-108,Severe
5,3,63,M,109,14,1,169,106,Well
11,1,133,M,60,9,2,110,-23,Severe
11,5,137,F,26,6,6,78,-59,Severe
17,3,207,F,102,13,6,162,-45,Severe
9,6,114,F,43,7,8,92,-22,Severe
5,3,63,F,54,8,7,103,40,Well
12,11,155,M,18,6,1,73,-82,Severe
5,3,63,M,58,9,0,108,45,Well
16,11,203,F,58,9,0,108,-95,Severe
18,6,222,M,2,5,3,63,-159,Severe
9,0,108,F,48,8,1,97,-11,Severe
17,0,204,M,81,11,4,136,-68,Severe
9,3,111,F,39,7,5,89,-22,Severe
15,4,184,M,88,12,0,144,-40,Severe
10,10,130,M,88,12,0,144,14,Well
8,6,102,F,28,6,8,80,-22,Severe
12,5,149,M,73,10,6,126,-23,Severe
12,6,150,F,33,6,11,83,-67,Severe
13,2,158,F,72,10,4,124,-34,Severe
8,4,100,F,8,5,6,66,-34,Severe
8,9,105,M,11,5,8,68,-37,Severe
10,3,123,F,11,5,8,68,-55,Severe
6,3,75,M,54,8,7,103,28,Well
17,7,211,F,104,13,7,163,-48,Severe
15,9,189,F,50,8,3,99,-90,Severe
17,1,205,M,48,8,1,97,-108,Severe
17,10,214,F,22,6,3,75,-139,Severe
14,8,176,F,36,7,2,86,-90,Severe
9,10,118,F,75,10,9,129,11,Well
11,2,134,M,23,6,4,76,-58,Severe
5,8,68,M,92,12,5,149,81,Well
16,9,201,M,69,10,1,121,-80,Severe
14,11,179,F,22,6,3,75,-104,Severe
7,7,91,F,40,7,5,89,-2,Mild
8,8,104,M,109,14,1,169,65,Well
15,6,186,M,33,6,11,83,-103,Severe
17,1,205,F,76,10,10,130,-75,Severe
6,3,75,F,98,13,0,156,81,Well
14,6,174,F,60,9,2,110,-64,Severe
6,6,78,M,38,7,4,88,10,Well
10,0,120,F,71,10,3,123,3,Good
5,11,71,M,23,6,4,76,5,Good
9,9,117,F,72,10,4,124,7,Well
7,3,87,F,109,14,1,169,82,Well
5,9,69,M,8,5,6,66,-3,Mild
10,2,122,F,103,13,6,162,40,Well
6,0,72,M,38,7,4,88,16,Well
16,6,198,F,21,6,2,74,-124,Severe
9,1,109,M,89,12,1,145,36,Well
16,3,195,M,55,8,8,104,-91,Severe
11,7,139,F,23,6,4,76,-63,Severe
17,5,209,F,57,8,10,106,-103,Severe
6,7,79,M,77,10,11,131,52,Well
5,4,64,F,65,9,8,116,52,Well
5,0,60,M,67,9,10,118,58,Well
15,1,181,M,21,6,2,74,-107,Severe
9,0,108,F,6,5,5,65,-43,Severe
17,10,214,M,36,7,2,86,-128,Severe
14,7,175,M,108,14,0,168,-7,Severe
12,5,149,M,60,9,2,110,-39,Severe
16,9,201,M,64,9,7,115,-86,Severe
15,4,184,M,22,6,3,75,-109,Severe
11,4,136,M,2,5,3,63,-73,Severe
11,5,137,M,17,6,0,72,-65,Severe
10,1,121,M,18,6,1,73,-48,Severe
16,9,201,M,49,8,2,98,-103,Severe
14,3,171,M,45,7,10,94,-77,Severe
11,0,132,M,89,12,1,145,13,Well
9,9,117,F,23,6,4,76,-41,Severe
14,1,169,M,67,9,10,118,-51,Severe
5,4,64,F,31,6,9,81,17,Well
13,8,164,M,37,7,3,87,-77,Severe
18,10,226,M,64,9,7,115,-111,Severe
6,5,77,M,77,10,11,131,54,Well
12,0,144,M,110,14,3,171,27,Well
10,7,127,F,45,7,10,94,-33,Severe
8,9,105,F,43,7,8,92,-13,Severe
8,2,98,F,63,9,6,114,16,Well
17,3,207,M,38,7,4,88,-119,Severe
9,1,109,F,89,12,1,145,36,Well
14,0,168,F,44,7,9,93,-75,Severe
15,0,180,F,56,8,9,105,-75,Severe
11,0,132,M,69,10,1,121,-11,Severe
16,2,194,F,110,14,3,171,-23,Severe
10,3,123,M,32,6,10,82,-41,Severe
7,9,93,F,76,10,10,130,37,Well
14,0,168,M,47,8,0,96,-72,Severe
17,8,212,M,85,11,9,141,-71,Severe
8,10,106,M,52,8,5,101,-5,Mild
11,6,138,M,18,6,1,73,-65,Severe
8,4,100,F,86,11,10,142,42,Well
7,8,92,M,90,12,3,147,55,Well
12,4,148,F,6,5,5,65,-83,Severe
10,7,127,M,69,10,1,121,-6,Severe
10,3,123,F,19,6,1,73,-50,Severe
18,3,219,M,84,11,7,139,-80,Severe
11,5,137,M,83,11,6,138,1,Good
12,1,145,F,48,8,1,97,-48,Severe
16,6,198,M,92,12,5,149,-49,Severe
8,8,104,F,23,6,4,76,-28,Severe
9,9,117,F,93,12,6,150,33,Well
11,3,135,F,27,6,7,79,-56,Severe
6,9,81,F,104,13,7,163,82,Well
8,6,102,F,62,9,4,112,10,Well
6,1,73,M,76,10,10,130,57,Well
12,8,152,M,77,10,11,131,-21,Severe
5,3,63,F,80,11,3,135,72,Well
5,0,60,F,59,9,1,109,49,Well
18,2,218,M,39,7,5,89,-129,Severe
14,3,171,M,91,12,4,148,-23,Severe
15,2,182,F,37,7,3,87,-95,Severe
17,2,206,M,100,13,3,159,-47,Severe
6,9,81,F,25,6,5,77,-4,Mild
5,11,71,M,106,13,10,166,95,Well
11,9,141,M,7,5,6,66,-75,Severe
17,8,212,M,6,5,5,65,-147,Severe
13,7,163,F,12,5,9,69,-94,Severe
12,7,151,F,14,5,10,70,-81,Severe
18,1,217,F,56,8,9,105,-112,Severe
9,5,113,F,36,7,2,86,-27,Severe
7,4,88,M,69,10,1,121,33,Well
17,2,206,F,10,5,7,67,-139,Severe
9,1,109,M,29,6,8,80,-29,Severe
16,3,195,F,10,5,7,67,-128,Severe
14,10,178,M,102,13,6,162,-16,Severe
8,10,106,F,4,5,4,64,-42,Severe
10,3,123,F,100,13,3,159,36,Well
9,9,117,F,53,8,6,102,-15,Severe
18,3,219,M,78,11,0,132,-87,Severe
9,11,119,F,31,6,9,81,-38,Severe
5,3,63,M,27,6,7,79,16,Well
10,3,123,M,73,10,6,126,3,Good
10,11,131,F,95,12,9,153,22,Well
5,7,67,F,96,12,10,154,87,Well
15,9,189,M,17,6,0,72,-117,Severe
11,4,136,M,18,6,1,73,-63,Severe
14,2,170,F,75,10,9,129,-41,Severe
12,3,147,M,97,12,11,155,8,Well
17,7,211,F,97,12,11,155,-56,Severe
17,0,204,F,65,9,8,116,-88,Severe
8,8,104,F,3,5,3,63,-41,Severe
5,8,68,M,94,12,7,151,83,Well
11,5,137,F,46,7,11,95,-42,Severe
8,8,104,F,73,10,6,126,22,Well
16,10,202,M,5,5,5,65,-137,Severe
15,3,183,F,57,8,10,106,-77,Severe
8,4,100,F,102,13,6,162,62,Well
8,5,101,M,77,10,11,131,30,Well
9,8,116,F,7,5,6,66,-50,Severe
15,7,187,M,15,5,11,71,-116,Severe
9,1,109,M,96,12,10,154,45,Well
10,3,123,M,33,6,11,83,-40,Severe
18,10,226,M,22,6,3,75,-151,Severe
16,8,200,M,71,10,3,123,-77,Severe
18,9,225,F,22,6,3,75,-150,Severe
6,3,75,F,22,6,3,75,0,Neutral
10,3,123,F,15,5,11,71,-52,Severe
10,1,121,F,53,8,6,102,-19,Severe
8,10,106,M,17,6,0,72,-34,Severe
5,3,63,F,83,11,6,138,75,Well
17,6,210,F,2,5,3,63,-147,Severe
12,10,154,M,30,6,9,81,-73,Severe
5,3,63,F,90,12,3,147,84,Well
6,8,80,F,18,6,1,73,-7,Severe
6,2,74,M,102,13,6,162,88,Well
18,4,220,M,23,6,4,76,-144,Severe
8,8,104,F,2,5,3,63,-41,Severe
5,8,68,M,82,11,5,137,69,Well
12,9,153,M,31,6,9,81,-72,Severe
5,0,60,F,21,6,2,74,14,Well
16,4,196,F,24,6,5,77,-119,Severe
8,11,107,F,24,6,5,77,-30,Severe
8,5,101,F,65,9,8,116,15,Well
6,0,72,F,53,8,6,102,30,Well
9,1,109,F,45,7,10,94,-15,Severe
11,11,143,M,44,7,9,93,-50,Severe
16,4,196,F,28,6,8,80,-116,Severe
5,7,67,F,11,5,8,68,1,Good
11,2,134,M,91,12,4,148,14,Well
17,2,206,F,49,8,2,98,-108,Severe
14,1,169,M,43,7,8,92,-77,Severe
6,6,78,F,71,10,3,123,45,Well
11,10,142,M,75,10,9,129,-13,Severe
6,5,77,F,15,5,11,71,-6,Severe
12,4,148,M,47,8,0,96,-52,Severe
10,10,130,F,53,8,6,102,-28,Severe
10,9,129,M,5,5,5,65,-64,Severe
14,3,171,F,51,8,4,100,-71,Severe
16,11,203,M,33,6,11,83,-120,Severe
5,7,67,F,41,7,6,90,23,Well
16,3,195,F,12,5,9,69,-126,Severe
12,3,147,M,69,10,1,121,-26,Severe
10,3,123,F,31,6,9,81,-42,Severe
6,1,73,F,30,6,9,81,8,Well
14,7,175,F,65,9,8,116,-59,Severe
8,1,97,F,48,8,1,97,0,Neutral
9,6,114,F,3,5,3,63,-51,Severe
15,5,185,M,7,5,6,66,-119,Severe
8,5,101,F,58,9,0,108,7,Well
18,6,222,F,67,9,10,118,-104,Severe
9,11,119,F,104,13,7,163,44,Well
6,9,81,F,95,12,9,153,72,Well
11,10,142,F,14,5,10,70,-72,Severe
12,11,155,F,19,6,1,73,-82,Severe
14,8,176,F,70,10,2,122,-54,Severe
12,6,150,M,56,8,9,105,-45,Severe
9,8,116,M,103,13,6,162,46,Well
6,7,79,M,23,6,4,76,-3,Mild
18,0,216,M,46,7,11,95,-121,Severe
14,3,171,M,104,13,7,163,-8,Severe
10,0,120,F,18,6,1,73,-47,Severe
16,2,194,F,81,11,4,136,-58,Severe
17,0,204,F,8,5,6,66,-138,Severe
15,3,183,F,106,13,10,166,-17,Severe
13,8,164,M,63,9,6,114,-50,Severe
15,8,188,F,28,6,8,80,-108,Severe
11,2,134,M,88,12,0,144,10,Well
12,7,151,M,56,8,9,105,-46,Severe
17,1,205,F,83,11,6,138,-67,Severe
18,8,224,F,97,12,11,155,-69,Severe
16,9,201,F,6,5,5,65,-136,Severe
12,6,150,F,45,7,10,94,-56,Severe
16,6,198,F,20,6,2,74,-124,Severe
15,3,183,F,78,11,0,132,-51,Severe
11,1,133,M,40,7,5,89,-44,Severe
16,8,200,M,38,7,4,88,-112,Severe
5,2,62,M,5,5,5,65,3,Good
9,3,111,M,65,9,8,116,5,Good
13,2,158,F,107,13,11,167,9,Well
6,8,80,M,3,5,3,63,-17,Severe
18,4,220,M,2,5,3,63,-157,Severe
9,11,119,M,75,10,9,129,10,Well
12,1,145,M,86,11,10,142,-3,Mild
7,6,90,F,53,8,6,102,12,Well
15,0,180,M,9,5,7,67,-113,Severe
7,0,84,F,108,14,0,168,84,Well
5,4,64,M,102,13,6,162,98,Well
17,7,211,F,16,5,11,71,-140,Severe
14,4,172,M,45,7,10,94,-78,Severe
13,3,159,F,92,12,5,149,-10,Severe
15,10,190,M,20,6,2,74,-116,Severe
8,7,103,M,89,12,1,145,42,Well
12,11,155,M,91,12,4,148,-7,Severe
12,9,153,F,10,5,7,67,-86,Severe
17,3,207,F,66,9,9,117,-90,Severe
13,4,160,F,48,8,1,97,-63,Severe
11,3,135,F,54,8,7,103,-32,Severe
5,5,65,F,5,5,5,65,0,Neutral
7,6,90,M,79,11,1,133,43,Well
17,3,207,M,35,7,1,85,-122,Severe
10,3,123,M,65,9,8,116,-7,Severe
15,3,183,F,39,7,5,89,-94,Severe
12,8,152,F,59,9,1,109,-43,Severe
18,10,226,F,66,9,9,117,-109,Severe
15,10,190,M,83,11,6,138,-52,Severe
11,1,133,M,88,12,0,144,11,Well
12,7,151,F,25,6,5,77,-74,Severe
17,11,215,M,31,6,9,81,-134,Severe
6,1,73,F,109,14,1,169,96,Well
16,6,198,M,15,5,11,71,-127,Severe
6,2,74,F,50,8,3,99,25,Well
8,8,104,F,64,9,7,115,11,Well
9,7,115,M,3,5,3,63,-52,Severe
14,11,179,M,64,9,7,115,-64,Severe
17,7,211,M,65,9,8,116,-95,Severe
6,3,75,F,69,10,1,121,46,Well
10,11,131,M,46,7,11,95,-36,Severe
10,4,124,M,85,11,9,141,17,Well
10,6,126,F,35,7,1,85,-41,Severe
17,7,211,M,30,6,9,81,-130,Severe
10,4,124,M,14,5,10,70,-54,Severe
6,8,80,F,57,8,10,106,26,Well
11,7,139,F,27,6,7,79,-60,Severe
5,1,61,M,105,13,9,165,104,Well
6,7,79,F,40,7,5,89,10,Well
14,9,177,F,18,6,1,73,-104,Severe
17,7,211,F,30,6,9,81,-130,Severe
9,6,114,M,108,14,0,168,54,Well
8,5,101,M,93,12,6,150,49,Well
5,5,65,M,10,5,7,67,2,Good
5,3,63,F,101,13,4,160,97,Well
16,5,197,M,110,14,3,171,-26,Severe
10,7,127,F,104,13,7,163,36,Well
18,2,218,M,62,9,4,112,-106,Severe
6,3,75,M,106,13,10,166,91,Well
18,6,222,M,45,7,10,94,-128,Severe
10,3,123,M,22,6,3,75,-48,Severe
11,11,143,M,23,6,4,76,-67,Severe
13,4,160,M,35,7,1,85,-75,Severe
5,7,67,M,23,6,4,76,9,Well
18,3,219,F,79,11,1,133,-86,Severe
14,10,178,M,38,7,4,88,-90,Severe
9,9,117,F,40,7,5,89,-28,Severe
7,1,85,M,68,10,0,120,35,Well
13,6,162,M,70,10,2,122,-40,Severe
14,0,168,F,89,12,1,145,-23,Severe
6,5,77,M,15,5,11,71,-6,Severe
6,9,81,M,6,5,5,65,-16,Severe
12,11,155,M,5,5,5,65,-90,Severe
11,3,135,F,15,5,11,71,-64,Severe
9,5,113,M,94,12,7,151,38,Well
6,9,81,M,97,12,11,155,74,Well
6,6,78,F,48,8,1,97,19,Well
10,4,124,M,69,10,1,121,-3,Mild
10,11,131,F,14,5,10,70,-61,Severe
15,6,186,M,83,11,6,138,-48,Severe
16,9,201,M,6,5,5,65,-136,Severe
8,11,107,M,6,5,5,65,-42,Severe
14,7,175,F,63,9,6,114,-61,Severe
13,3,159,M,3,5,3,63,-96,Severe
7,11,95,M,48,8,1,97,2,Good
13,4,160,M,83,11,6,138,-22,Severe
15,7,187,M,56,8,9,105,-82,Severe
16,4,196,M,13,5,9,69,-127,Severe
12,3,147,M,71,10,3,123,-24,Severe
18,11,227,M,63,9,6,114,-113,Severe
6,4,76,M,108,14,0,168,92,Well
16,3,195,F,104,13,7,163,-32,Severe
10,4,124,M,30,6,9,81,-43,Severe
9,8,116,M,16,5,11,71,-45,Severe
11,5,137,F,36,7,2,86,-51,Severe
13,8,164,F,56,8,9,105,-59,Severe
15,9,189,F,87,11,11,143,-46,Severe
11,2,134,F,17,6,0,72,-62,Severe
5,1,61,M,22,6,3,75,14,Well
14,3,171,F,78,11,0,132,-39,Severe
10,7,127,F,58,9,0,108,-19,Severe
9,2,110,F,18,6,1,73,-37,Severe
16,8,200,M,70,10,2,122,-78,Severe
9,7,115,F,93,12,6,150,35,Well
8,10,106,F,82,11,5,137,31,Well
14,3,171,F,45,7,10,94,-77,Severe
18,1,217,M,17,6,0,72,-145,Severe
9,6,114,F,27,6,7,79,-35,Severe
10,2,122,F,104,13,7,163,41,Well
17,6,210,F,12,5,9,69,-141,Severe
15,7,187,M,78,11,0,132,-55,Severe
7,10,94,F,108,14,0,168,74,Well
13,10,166,F,29,6,8,80,-86,Severe
9,2,110,M,36,7,2,86,-24,Severe
14,3,171,F,40,7,5,89,-82,Severe
18,10,226,M,104,13,7,163,-63,Severe
17,1,205,M,36,7,2,86,-119,Severe
16,2,194,M,91,12,4,148,-46,Severe
12,3,147,F,37,7,3,87,-60,Severe
6,3,75,M,78,11,0,132,57,Well
13,9,165,M,47,8,0,96,-69,Severe
14,3,171,F,15,5,11,71,-100,Severe
11,3,135,F,103,13,6,162,27,Well
8,5,101,M,101,13,4,160,59,Well
16,5,197,M,45,7,10,94,-103,Severe
6,9,81,F,45,7,10,94,13,Well
13,6,162,M,82,11,5,137,-25,Severe
17,0,204,M,68,10,0,120,-84,Severe
11,3,135,M,35,7,1,85,-50,Severe
5,10,70,M,15,5,11,71,1,Good
17,4,208,M,78,11,0,132,-76,Severe
15,8,188,F,45,7,10,94,-94,Severe
11,7,139,M,94,12,7,151,12,Well
17,1,205,M,67,9,10,118,-87,Severe
16,2,194,F,92,12,5,149,-45,Severe
18,9,225,F,31,6,9,81,-144,Severe
6,6,78,M,47,8,0,96,18,Well
10,1,121,M,38,7,4,88,-33,Severe
14,5,173,F,40,7,5,89,-84,Severe
13,4,160,M,85,11,9,141,-19,Severe
12,2,146,M,72,10,4,124,-22,Severe
7,10,94,M,13,5,9,69,-25,Severe
14,8,176,F,31,6,9,81,-95,Severe
17,3,207,M,30,6,9,81,-126,Severe
7,10,94,M,73,10,6,126,32,Well
6,1,73,F,36,7,2,86,13,Well
14,6,174,M,89,12,1,145,-29,Severe
6,5,77,F,14,5,10,70,-7,Severe
9,0,108,F,24,6,5,77,-31,Severe
11,10,142,M,52,8,5,101,-41,Severe
10,0,120,M,26,6,6,78,-42,Severe
12,11,155,M,41,7,6,90,-65,Severe
17,0,204,M,104,13,7,163,-41,Severe
12,4,148,F,61,9,3,111,-37,Severe
11,8,140,M,45,7,10,94,-46,Severe
18,11,227,M,86,11,10,142,-85,Severe
18,6,222,M,65,9,8,116,-106,Severe
11,1,133,F,29,6,8,80,-53,Severe
12,9,153,M,102,13,6,162,9,Well
17,6,210,F,15,5,11,71,-139,Severe
14,1,169,F,96,12,10,154,-15,Severe
9,7,115,M,57,8,10,106,-9,Severe
5,0,60,F,32,6,10,82,22,Well
13,4,160,M,103,13,6,162,2,Good
6,11,83,F,16,5,11,71,-12,Severe
10,2,122,M,38,7,4,88,-34,Severe
14,8,176,F,96,12,10,154,-22,Severe
16,3,195,F,109,14,1,169,-26,Severe
6,7,79,M,60,9,2,110,31,Well
8,3,99,M,4,5,4,64,-35,Severe
16,10,202,F,81,11,4,136,-66,Severe
15,6,186,F,105,13,9,165,-21,Severe
10,1,121,M,22,6,3,75,-46,Severe
8,8,104,F,19,6,1,73,-31,Severe
8,3,99,M,69,10,1,121,22,Well
15,10,190,F,40,7,5,89,-101,Severe
5,8,68,M,104,13,7,163,95,Well
17,10,214,M,62,9,4,112,-102,Severe
12,0,144,M,2,5,3,63,-81,Severe
13,10,166,M,25,6,5,77,-89,Severe
7,7,91,M,99,13,1,157,66,Well
11,3,135,F,35,7,1,85,-50,Severe
8,7,103,F,76,10,10,130,27,Well
17,11,215,F,106,13,10,166,-49,Severe
18,3,219,F,2,5,3,63,-156,Severe
17,2,206,M,103,13,6,162,-44,Severe
18,3,219,F,66,9,9,117,-102,Severe
16,4,196,F,57,8,10,106,-90,Severe
11,7,139,F,35,7,1,85,-54,Severe
15,0,180,M,61,9,3,111,-69,Severe
13,5,161,F,82,11,5,137,-24,Severe
10,0,120,M,105,13,9,165,45,Well
15,3,183,M,69,10,1,121,-62,Severe
5,1,61,F,60,9,2,110,49,Well
7,2,86,M,93,12,6,150,64,Well
7,7,91,F,80,11,3,135,44,Well
10,5,125,M,78,11,0,132,7,Well
17,0,204,M,47,8,0,96,-108,Severe
15,3,183,F,29,6,8,80,-103,Severe
9,1,109,F,44,7,9,93,-16,Severe
6,10,82,F,108,14,0,168,86,Well
16,2,194,M,57,8,10,106,-88,Severe
16,10,202,F,107,13,11,167,-35,Severe
16,4,196,M,49,8,2,98,-98,Severe
11,3,135,F,110,14,3,171,36,Well
9,3,111,M,86,11,10,142,31,Well
8,3,99,F,98,13,0,156,57,Well
13,7,163,M,34,7,0,84,-79,Severe
8,0,96,M,65,9,8,116,20,Well
16,0,192,F,10,5,7,67,-125,Severe
12,10,154,F,22,6,3,75,-79,Severe
7,5,89,M,103,13,6,162,73,Well
14,8,176,F,108,14,0,168,-8,Severe
17,1,205,F,54,8,7,103,-102,Severe
17,8,212,M,68,10,0,120,-92,Severe
12,9,153,M,59,9,1,109,-44,Severe
9,11,119,F,87,11,11,143,24,Well
8,1,97,M,88,12,0,144,47,Well
18,2,218,F,7,5,6,66,-152,Severe
11,3,135,M,62,9,4,112,-23,Severe
16,1,193,M,55,8,8,104,-89,Severe
13,4,160,M,53,8,6,102,-58,Severe
12,3,147,M,74,10,7,127,-20,Severe
13,7,163,F,16,5,11,71,-92,Severe
14,9,177,M,38,7,4,88,-89,Severe
11,9,141,F,51,8,4,100,-41,Severe
5,3,63,M,88,12,0,144,81,Well
5,2,62,M,47,8,0,96,34,Well
15,9,189,M,41,7,6,90,-99,Severe
10,3,123,M,87,11,11,143,20,Well
5,7,67,M,3,5,3,63,-4,Mild
5,7,67,M,84,11,7,139,72,Well
9,5,113,M,67,9,10,118,5,Good
7,8,92,F,94,12,7,151,59,Well
9,4,112,M,18,6,1,73,-39,Severe
10,8,128,M,27,6,7,79,-49,Severe
9,8,116,M,49,8,2,98,-18,Severe
5,4,64,F,78,11,0,132,68,Well
16,6,198,F,28,6,8,80,-118,Severe
14,4,172,F,100,13,3,159,-13,Severe
10,7,127,M,98,13,0,156,29,Well
18,3,219,M,33,6,11,83,-136,Severe
9,5,113,M,68,10,0,120,7,Well
14,3,171,F,38,7,4,88,-83,Severe
6,7,79,M,27,6,7,79,0,Neutral
7,11,95,F,62,9,4,112,17,Well
15,10,190,F,27,6,7,79,-111,Severe
13,1,157,F,29,6,8,80,-77,Severe
16,3,195,F,23,6,4,76,-119,Severe
10,5,125,M,60,9,2,110,-15,Severe
13,6,162,F,49,8,2,98,-64,Severe
11,7,139,F,21,6,2,74,-65,Severe
10,3,123,F,62,9,4,112,-11,Severe
16,8,200,M,7,5,6,66,-134,Severe
14,3,171,M,56,8,9,105,-66,Severe
14,11,179,F,43,7,8,92,-87,Severe
13,0,156,F,58,9,0,108,-48,Severe
17,4,208,M,3,5,3,63,-145,Severe
16,3,195,F,28,6,8,80,-115,Severe
6,9,81,F,64,9,7,115,34,Well
7,2,86,M,100,13,3,159,73,Well
7,8,92,M,62,9,4,112,20,Well
7,6,90,F,66,9,9,117,27,Well
5,3,63,F,55,8,8,104,41,Well
9,0,108,M,46,7,11,95,-13,Severe
8,8,104,F,75,10,9,129,25,Well
9,1,109,M,25,6,5,77,-32,Severe
17,9,213,F,37,7,3,87,-126,Severe
12,5,149,M,8,5,6,66,-83,Severe
6,4,76,F,103,13,6,162,86,Well
14,8,176,F,26,6,6,78,-98,Severe
15,10,190,M,92,12,5,149,-41,Severe
7,6,90,M,104,13,7,163,73,Well
8,11,107,M,35,7,1,85,-22,Severe
15,0,180,M,15,5,11,71,-109,Severe
14,0,168,F,57,8,10,106,-62,Severe
16,9,201,F,21,6,2,74,-127,Severe
12,3,147,F,62,9,4,112,-35,Severe
7,1,85,M,89,12,1,145,60,Well
14,1,169,M,11,5,8,68,-101,Severe
14,8,176,F,82,11,5,137,-39,Severe
10,0,120,F,59,9,1,109,-11,Severe
17,11,215,M,21,6,2,74,-141,Severe
15,5,185,M,71,10,3,123,-62,Severe
12,11,155,M,67,9,10,118,-37,Severe
11,8,140,F,77,10,11,131,-9,Severe
10,7,127,F,50,8,3,99,-28,Severe
11,10,142,M,32,6,10,82,-60,Severe
8,9,105,F,73,10,6,126,21,Well
8,2,98,F,35,7,1,85,-13,Severe
15,3,183,M,26,6,6,78,-105,Severe
12,8,152,F,53,8,6,102,-50,Severe
18,3,219,M,11,5,8,68,-151,Severe
9,0,108,M,88,12,0,144,36,Well
16,10,202,F,58,9,0,108,-94,Severe
12,2,146,M,31,6,9,81,-65,Severe
11,3,135,M,66,9,9,117,-18,Severe
18,3,219,F,68,10,0,120,-99,Severe
5,7,67,M,56,8,9,105,38,Well
7,3,87,F,9,5,7,67,-20,Severe
11,10,142,M,39,7,5,89,-53,Severe
16,2,194,F,90,12,3,147,-47,Severe
10,9,129,F,19,6,1,73,-56,Severe
6,10,82,M,59,9,1,109,27,Well
10,3,123,F,27,6,7,79,-44,Severe
14,3,171,F,55,8,8,104,-67,Severe
9,8,116,F,5,5,5,65,-51,Severe
12,4,148,M,36,7,2,86,-62,Severe
13,3,159,F,70,10,2,122,-37,Severe
14,0,168,M,86,11,10,142,-26,Severe
7,1,85,M,21,6,2,74,-11,Severe
16,7,199,F,100,13,3,159,-40,Severe
7,1,85,M,22,6,3,75,-10,Severe
13,1,157,F,27,6,7,79,-78,Severe
12,0,144,M,80,11,3,135,-9,Severe
12,4,148,F,103,13,6,162,14,Well
7,1,85,F,99,13,1,157,72,Well
17,2,206,M,39,7,5,89,-117,Severe
11,6,138,M,100,13,3,159,21,Well
10,8,128,M,11,5,8,68,-60,Severe
17,2,206,F,108,14,0,168,-38,Severe
12,1,145,M,65,9,8,116,-29,Severe
5,10,70,M,35,7,1,85,15,Well
18,0,216,M,84,11,7,139,-77,Severe
15,2,182,F,88,12,0,144,-38,Severe
18,10,226,M,95,12,9,153,-73,Severe
6,11,83,M,29,6,8,80,-3,Mild
14,0,168,M,88,12,0,144,-24,Severe
10,3,123,M,109,14,1,169,46,Well
9,2,110,F,100,13,3,159,49,Well
15,11,191,M,61,9,3,111,-80,Severe
6,3,75,M,38,7,4,88,13,Well
15,3,183,F,21,6,2,74,-109,Severe
17,3,207,F,18,6,1,73,-134,Severe
18,0,216,F,68,10,0,120,-96,Severe
13,4,160,F,32,6,10,82,-78,Severe
16,10,202,F,9,5,7,67,-135,Severe
16,10,202,F,43,7,8,92,-110,Severe
12,8,152,M,107,13,11,167,15,Well
13,1,157,F,42,7,7,91,-66,Severe
17,2,206,M,98,13,0,156,-50,Severe
13,8,164,F,17,6,0,72,-92,Severe
7,10,94,F,42,7,7,91,-3,Mild
11,11,143,M,81,11,4,136,-7,Severe
14,3,171,F,13,5,9,69,-102,Severe
7,4,88,F,101,13,4,160,72,Well
11,5,137,F,5,5,5,65,-72,Severe
12,8,152,M,63,9,6,114,-38,Severe
8,3,99,F,38,7,4,88,-11,Severe
5,3,63,F,71,10,3,123,60,Well
5,6,66,M,80,11,3,135,69,Well
17,8,212,F,103,13,6,162,-50,Severe
11,10,142,F,96,12,10,154,12,Well
12,3,147,F,35,7,1,85,-62,Severe
7,5,89,M,57,8,10,106,17,Well
17,3,207,F,44,7,9,93,-114,Severe
6,9,81,M,8,5,6,66,-15,Severe
17,1,205,M,44,7,9,93,-112,Severe
13,2,158,F,84,11,7,139,-19,Severe
12,10,154,F,20,6,2,74,-80,Severe
14,6,174,F,4,5,4,64,-110,Severe
10,1,121,F,105,13,9,165,44,Well
14,3,171,F,83,11,6,138,-33,Severe
17,0,204,M,96,12,10,154,-50,Severe
14,5,173,F,103,13,6,162,-11,Severe
8,8,104,M,15,5,11,71,-33,Severe
11,6,138,M,84,11,7,139,1,Good
9,2,110,F,106,13,10,166,56,Well
14,5,173,M,22,6,3,75,-98,Severe
6,8,80,F,92,12,5,149,69,Well
18,3,219,F,5,5,5,65,-154,Severe
12,9,153,F,49,8,2,98,-55,Severe
13,5,161,F,57,8,10,106,-55,Severe
9,7,115,F,108,14,0,168,53,Well
8,3,99,M,81,11,4,136,37,Well
14,5,173,M,23,6,4,76,-97,Severe
12,11,155,M,75,10,9,129,-26,Severe
8,11,107,F,82,11,5,137,30,Well
16,5,197,M,5,5,5,65,-132,Severe
5,4,64,F,68,10,0,120,56,Well
10,10,130,M,46,7,11,95,-35,Severe
7,11,95,F,52,8,5,101,6,Well
16,6,198,F,55,8,8,104,-94,Severe
17,2,206,M,35,7,1,85,-121,Severe
8,1,97,F,34,7,0,84,-13,Severe
17,4,208,M,20,6,2,74,-134,Severe
5,9,69,M,82,11,5,137,68,Well
7,1,85,M,11,5,8,68,-17,Severe
11,8,140,F,60,9,2,110,-30,Severe
12,0,144,M,34,7,0,84,-60,Severe
18,0,216,M,27,6,7,79,-137,Severe
15,7,187,F,61,9,3,111,-76,Severe
7,10,94,M,97,12,11,155,61,Well
10,4,124,F,23,6,4,76,-48,Severe
16,1,193,M,109,14,1,169,-24,Severe
9,7,115,F,27,6,7,79,-36,Severe
6,0,72,M,65,9,8,116,44,Well
6,3,75,M,90,12,3,147,72,Well
14,5,173,F,47,8,0,96,-77,Severe
12,3,147,M,104,13,7,163,16,Well
12,11,155,M,74,10,7,127,-28,Severe
5,10,70,F,101,13,4,160,90,Well
9,3,111,M,50,8,3,99,-12,Severe
9,1,109,M,109,14,1,169,60,Well
10,2,122,M,75,10,9,129,7,Well
11,4,136,M,109,14,1,169,33,Well
18,4,220,F,58,9,0,108,-112,Severe
6,0,72,F,85,11,9,141,69,Well
12,5,149,M,81,11,4,136,-13,Severe
18,9,225,M,37,7,3,87,-138,Severe
13,9,165,F,107,13,11,167,2,Good
5,2,62,F,43,7,8,92,30,Well
9,10,118,F,38,7,4,88,-30,Severe
5,0,60,F,6,5,5,65,5,Good
8,5,101,F,56,8,9,105,4,Good
7,0,84,M,77,10,11,131,47,Well
9,3,111,F,77,10,11,131,20,Well
12,9,153,F,80,11,3,135,-18,Severe
16,3,195,F,18,6,1,73,-122,Severe
8,9,105,M,14,5,10,70,-35,Severe
13,9,165,F,12,5,9,69,-96,Severe
7,10,94,F,35,7,1,85,-9,Severe
7,9,93,F,53,8,6,102,9,Well
16,5,197,F,98,13,0,156,-41,Severe
18,3,219,F,85,11,9,141,-78,Severe
14,9,177,F,98,13,0,156,-21,Severe
11,0,132,M,26,6,6,78,-54,Severe
16,7,199,M,20,6,2,74,-125,Severe
12,8,152,F,86,11,10,142,-10,Severe
7,9,93,M,88,12,0,144,51,Well
10,2,122,F,69,10,1,121,-1,Mild
13,3,159,F,25,6,5,77,-82,Severe
11,10,142,F,59,9,1,109,-33,Severe
14,4,172,M,26,6,6,78,-94,Severe
15,6,186,M,39,7,5,89,-97,Severe
7,2,86,F,55,8,8,104,18,Well
14,0,168,M,34,7,0,84,-84,Severe
5,6,66,M,85,11,9,141,75,Well
13,3,159,F,55,8,8,104,-55,Severe
12,2,146,M,81,11,4,136,-10,Severe
12,6,150,F,80,11,3,135,-15,Severe
11,7,139,F,65,9,8,116,-23,Severe
13,0,156,F,64,9,7,115,-41,Severe
8,2,98,M,46,7,11,95,-3,Mild
17,10,214,M,101,13,4,160,-54,Severe
14,5,173,M,84,11,7,139,-34,Severe
12,0,144,M,31,6,9,81,-63,Severe
10,4,124,F,9,5,7,67,-57,Severe
17,3,207,M,23,6,4,76,-131,Severe
10,3,123,F,19,6,1,73,-50,Severe
13,10,166,M,41,7,6,90,-76,Severe
11,11,143,M,80,11,3,135,-8,Severe
6,6,78,M,51,8,4,100,22,Well
9,5,113,F,29,6,8,80,-33,Severe
10,0,120,M,70,10,2,122,2,Good
18,9,225,F,55,8,8,104,-121,Severe
9,11,119,F,68,10,0,120,1,Good
16,2,194,M,106,13,10,166,-28,Severe
16,8,200,M,76,10,10,130,-70,Severe
5,0,60,M,108,14,0,168,108,Well
13,5,161,M,105,13,9,165,4,Good
13,3,159,F,10,5,7,67,-92,Severe
7,0,84,M,34,7,0,84,0,Neutral
5,7,67,M,24,6,5,77,10,Well
11,1,133,F,64,9,7,115,-18,Severe
13,9,165,F,58,9,0,108,-57,Severe
9,10,118,F,105,13,9,165,47,Well
11,3,135,F,74,10,7,127,-8,Severe
18,9,225,F,21,6,2,74,-151,Severe
7,0,84,M,24,6,5,77,-7,Severe
7,7,91,F,96,12,10,154,63,Well
18,8,224,F,107,13,11,167,-57,Severe
5,11,71,F,69,10,1,121,50,Well
16,8,200,F,42,7,7,91,-109,Severe
14,0,168,M,77,10,11,131,-37,Severe
18,4,220,F,20,6,2,74,-146,Severe
15,3,183,F,12,5,9,69,-114,Severe
6,11,83,M,46,7,11,95,12,Well
9,5,113,F,21,6,2,74,-39,Severe
12,5,149,M,47,8,0,96,-53,Severe
12,0,144,M,77,10,11,131,-13,Severe
10,2,122,M,61,9,3,111,-11,Severe
16,9,201,M,39,7,5,89,-112,Severe
18,7,223,F,101,13,4,160,-63,Severe
6,9,81,M,13,5,9,69,-12,Severe
17,3,207,F,57,8,10,106,-101,Severe
17,0,204,M,69,10,1,121,-83,Severe
6,6,78,M,101,13,4,160,82,Well
11,5,137,F,63,9,6,114,-23,Severe
11,6,138,M,29,6,8,80,-58,Severe
18,4,220,F,49,8,2,98,-122,Severe
10,4,124,F,79,11,1,133,9,Well
6,10,82,M,62,9,4,112,30,Well
18,5,221,M,2,5,3,63,-158,Severe
15,7,187,M,9,5,7,67,-120,Severe
17,11,215,F,5,5,5,65,-150,Severe
17,4,208,F,78,11,0,132,-76,Severe
13,3,159,F,72,10,4,124,-35,Severe
18,7,223,F,60,9,2,110,-113,Severe
12,10,154,F,40,7,5,89,-65,Severe
7,9,93,M,31,6,9,81,-12,Severe
17,6,210,F,49,8,2,98,-112,Severe
16,3,195,F,109,14,1,169,-26,Severe
13,10,166,F,27,6,7,79,-87,Severe
17,10,214,M,54,8,7,103,-111,Severe
10,11,131,F,40,7,5,89,-42,Severe
12,0,144,M,19,6,1,73,-71,Severe
17,3,207,F,93,12,6,150,-57,Severe
10,10,130,M,53,8,6,102,-28,Severe
7,0,84,M,20,6,2,74,-10,Severe
9,7,115,F,28,6,8,80,-35,Severe
6,2,74,M,10,5,7,67,-7,Severe
9,5,113,M,10,5,7,67,-46,Severe
13,10,166,F,60,9,2,110,-56,Severe
13,8,164,F,81,11,4,136,-28,Severe
12,10,154,F,106,13,10,166,12,Well
9,5,113,M,15,5,11,71,-42,Severe
15,2,182,M,33,6,11,83,-99,Severe
18,9,225,M,20,6,2,74,-151,Severe
5,0,60,M,69,10,1,121,61,Well
18,3,219,F,77,10,11,131,-88,Severe
10,10,130,M,86,11,10,142,12,Well
9,1,109,M,76,10,10,130,21,Well
11,8,140,F,56,8,9,105,-35,Severe
10,1,121,M,91,12,4,148,27,Well
18,6,222,F,102,13,6,162,-60,Severe
17,3,207,F,80,11,3,135,-72,Severe
13,9,165,M,101,13,4,160,-5,Mild
16,5,197,F,67,9,10,118,-79,Severe
18,6,222,M,63,9,6,114,-108,Severe
16,5,197,F,12,5,9,69,-128,Severe
11,3,135,M,41,7,6,90,-45,Severe
13,11,167,M,73,10,6,126,-41,Severe
8,5,101,M,41,7,6,90,-11,Severe
13,10,166,M,22,6,3,75,-91,Severe
6,3,75,F,53,8,6,102,27,Well
10,5,125,M,17,6,0,72,-53,Severe
8,4,100,F,104,13,7,163,63,Well
17,8,212,F,97,12,11,155,-57,Severe
6,3,75,F,94,12,7,151,76,Well
5,3,63,F,6,5,5,65,2,Good
15,3,183,F,58,9,0,108,-75,Severe
11,3,135,M,53,8,6,102,-33,Severe
10,9,129,F,94,12,7,151,22,Well
6,11,83,M,84,11,7,139,56,Well
6,0,72,F,6,5,5,65,-7,Severe
15,7,187,M,6,5,5,65,-122,Severe
6,6,78,F,47,8,0,96,18,Well
6,1,73,M,45,7,10,94,21,Well
9,1,109,F,63,9,6,114,5,Good
13,11,167,M,5,5,5,65,-102,Severe
6,10,82,M,105,13,9,165,83,Well
12,3,147,F,16,5,11,71,-76,Severe
13,2,158,M,19,6,1,73,-85,Severe
14,2,170,F,68,10,0,120,-50,Severe
6,7,79,M,62,9,4,112,33,Well
5,8,68,F,101,13,4,160,92,Well
6,8,80,M,5,5,5,65,-15,Severe
17,8,212,M,13,5,9,69,-143,Severe
13,3,159,M,73,10,6,126,-33,Severe
16,10,202,M,53,8,6,102,-100,Severe
14,11,179,M,49,8,2,98,-81,Severe
7,6,90,F,76,10,10,130,40,Well
17,7,211,F,25,6,5,77,-134,Severe
10,4,124,M,73,10,6,126,2,Good
12,2,146,F,33,6,11,83,-63,Severe
9,7,115,M,56,8,9,105,-10,Severe
17,11,215,M,63,9,6,114,-101,Severe
13,0,156,M,45,7,10,94,-62,Severe
12,11,155,M,46,7,11,95,-60,Severe
14,6,174,F,41,7,6,90,-84,Severe
18,4,220,M,109,14,1,169,-51,Severe
12,2,146,M,39,7,5,89,-57,Severe
16,8,200,M,18,6,1,73,-127,Severe
12,11,155,M,64,9,7,115,-40,Severe
8,10,106,M,4,5,4,64,-42,Severe
16,8,200,M,33,6,11,83,-117,Severe
13,9,165,M,89,12,1,145,-20,Severe
18,5,221,F,10,5,7,67,-154,Severe
8,7,103,M,19,6,1,73,-30,Severe
12,6,150,M,104,13,7,163,13,Well
8,6,102,F,79,11,1,133,31,Well
5,10,70,M,109,14,1,169,99,Well
11,4,136,M,48,8,1,97,-39,Severe
16,1,193,M,105,13,9,165,-28,Severe
13,3,159,F,46,7,11,95,-64,Severe
9,3,111,M,42,7,7,91,-20,Severe
16,6,198,M,52,8,5,101,-97,Severe
18,6,222,M,19,6,1,73,-149,Severe
10,3,123,F,63,9,6,114,-9,Severe
18,8,224,M,41,7,6,90,-134,Severe
16,6,198,M,72,10,4,124,-74,Severe
15,8,188,M,52,8,5,101,-87,Severe
13,7,163,F,56,8,9,105,-58,Severe
16,3,195,F,13,5,9,69,-126,Severe
14,10,178,F,55,8,8,104,-74,Severe
15,3,183,F,77,10,11,131,-52,Severe
13,10,166,M,21,6,2,74,-92,Severe
7,11,95,F,38,7,4,88,-7,Severe
17,4,208,M,9,5,7,67,-141,Severe
13,6,162,M,110,14,3,171,9,Well
7,10,94,F,23,6,4,76,-18,Severe
8,7,103,F,46,7,11,95,-8,Severe
16,4,196,M,5,5,5,65,-131,Severe
10,10,130,F,26,6,6,78,-52,Severe
8,3,99,M,79,11,1,133,34,Well
5,9,69,F,75,10,9,129,60,Well
15,0,180,M,95,12,9,153,-27,Severe
14,5,173,F,80,11,3,135,-38,Severe
16,1,193,F,2,5,3,63,-130,Severe
6,3,75,M,56,8,9,105,30,Well
15,4,184,F,90,12,3,147,-37,Severe
9,8,116,F,16,5,11,71,-45,Severe
5,0,60,M,40,7,5,89,29,Well
8,6,102,F,73,10,6,126,24,Well
6,8,80,F,53,8,6,102,22,Well
8,0,96,M,99,13,1,157,61,Well
17,8,212,M,36,7,2,86,-126,Severe
18,7,223,M,84,11,7,139,-84,Severe
18,10,226,M,12,5,9,69,-157,Severe
14,2,170,F,63,9,6,114,-56,Severe
8,4,100,M,97,12,11,155,55,Well
12,9,153,F,89,12,1,145,-8,Severe
13,3,159,M,95,12,9,153,-6,Severe
10,11,131,M,39,7,5,89,-42,Severe
9,1,109,M,43,7,8,92,-17,Severe
11,7,139,F,14,5,10,70,-69,Severe
13,9,165,M,38,7,4,88,-77,Severe
5,0,60,F,101,13,4,160,100,Well
10,6,126,M,91,12,4,148,22,Well
14,3,171,M,22,6,3,75,-96,Severe
8,8,104,F,60,9,2,110,6,Well
17,2,206,F,85,11,9,141,-65,Severe
13,7,163,F,25,6,5,77,-86,Severe
16,10,202,F,60,9,2,110,-92,Severe
14,9,177,F,100,13,3,159,-18,Severe
12,11,155,F,63,9,6,114,-41,Severe
8,5,101,F,72,10,4,124,23,Well
13,11,167,M,57,8,10,106,-61,Severe
8,3,99,M,59,9,1,109,10,Well
18,1,217,F,74,10,7,127,-90,Severe
13,4,160,M,8,5,6,66,-94,Severe
5,2,62,F,59,9,1,109,47,Well
16,6,198,F,17,6,0,72,-126,Severe
18,1,217,M,43,7,8,92,-125,Severe
8,6,102,F,38,7,4,88,-14,Severe
8,0,96,F,92,12,5,149,53,Well
18,5,221,M,27,6,7,79,-142,Severe
13,6,162,M,40,7,5,89,-73,Severe
11,3,135,M,3,5,3,63,-72,Severe
16,11,203,F,10,5,7,67,-136,Severe
17,3,207,F,13,5,9,69,-138,Severe
16,11,203,F,49,8,2,98,-105,Severe
5,3,63,M,42,7,7,91,28,Well
16,9,201,M,100,13,3,159,-42,Severe
8,1,97,F,80,11,3,135,38,Well
18,8,224,F,39,7,5,89,-135,Severe
18,9,225,M,95,12,9,153,-72,Severe
5,3,63,M,95,12,9,153,90,Well
6,5,77,F,105,13,9,165,88,Well
15,1,181,M,73,10,6,126,-55,Severe
16,5,197,F,109,14,1,169,-28,Severe
15,10,190,M,76,10,10,130,-60,Severe
11,1,133,F,57,8,10,106,-27,Severe
16,2,194,M,77,10,11,131,-63,Severe
16,11,203,M,102,13,6,162,-41,Severe
13,8,164,F,7,5,6,66,-98,Severe
6,3,75,M,110,14,3,171,96,Well
18,6,222,M,29,6,8,80,-142,Severe
7,3,87,F,16,5,11,71,-16,Severe
16,7,199,F,66,9,9,117,-82,Severe
15,5,185,F,80,11,3,135,-50,Severe
6,11,83,F,3,5,3,63,-20,Severe
10,2,122,M,6,5,5,65,-57,Severe
15,3,183,F,9,5,7,67,-116,Severe
9,5,113,M,79,11,1,133,20,Well
9,0,108,M,39,7,5,89,-19,Severe
9,1,109,F,56,8,9,105,-4,Mild
11,5,137,F,52,8,5,101,-36,Severe
10,5,125,M,41,7,6,90,-35,Severe
9,11,119,M,10,5,7,67,-52,Severe
13,0,156,M,52,8,5,101,-55,Severe
11,3,135,F,8,5,6,66,-69,Severe
8,1,97,F,10,5,7,67,-30,Severe
10,9,129,F,99,13,1,157,28,Well
7,10,94,M,18,6,1,73,-21,Severe
12,7,151,F,84,11,7,139,-12,Severe
15,0,180,M,71,10,3,123,-57,Severe
15,1,181,F,51,8,4,100,-81,Severe
14,6,174,M,93,12,6,150,-24,Severe
18,0,216,F,87,11,11,143,-73,Severe
9,9,117,M,13,5,9,69,-48,Severe
17,6,210,M,23,6,4,76,-134,Severe
10,3,123,F,93,12,6,150,27,Well
17,0,204,F,34,7,0,84,-120,Severe
10,0,120,F,61,9,3,111,-9,Severe
11,10,142,M,59,9,1,109,-33,Severe
6,8,80,F,100,13,3,159,79,Well
12,3,147,M,17,6,0,72,-75,Severe
15,9,189,F,39,7,5,89,-100,Severe
6,7,79,F,85,11,9,141,62,Well
10,10,130,M,106,13,10,166,36,Well
14,5,173,F,51,8,4,100,-73,Severe
12,1,145,M,100,13,3,159,14,Well
14,0,168,F,7,5,6,66,-102,Severe
15,8,188,M,18,6,1,73,-115,Severe
5,2,62,F,83,11,6,138,76,Well
18,11,227,F,64,9,7,115,-112,Severe
6,6,78,M,63,9,6,114,36,Well
12,7,151,M,58,9,0,108,-43,Severe
16,9,201,F,22,6,3,75,-126,Severe
12,5,149,M,93,12,6,150,1,Good
7,1,85,F,22,6,3,75,-10,Severe
14,0,168,F,53,8,6,102,-66,Severe
12,1,145,F,28,6,8,80,-65,Severe
17,6,210,M,72,10,4,124,-86,Severe
5,5,65,F,66,9,9,117,52,Well
11,7,139,F,48,8,1,97,-42,Severe
5,6,66,F,8,5,6,66,0,Neutral
14,10,178,F,98,13,0,156,-22,Severe
5,1,61,F,28,6,8,80,19,Well
17,2,206,F,46,7,11,95,-111,Severe
7,0,84,F,69,10,1,121,37,Well
17,2,206,F,13,5,9,69,-137,Severe
8,4,100,M,26,6,6,78,-22,Severe
6,5,77,M,58,9,0,108,31,Well
15,2,182,F,87,11,11,143,-39,Severe
14,3,171,M,108,14,0,168,-3,Mild
16,1,193,F,56,8,9,105,-88,Severe
5,5,65,F,70,10,2,122,57,Well
5,9,69,M,14,5,10,70,1,Good
12,10,154,F,16,5,11,71,-83,Severe
18,6,222,F,43,7,8,92,-130,Severe
8,7,103,F,30,6,9,81,-22,Severe
7,8,92,F,10,5,7,67,-25,Severe
14,3,171,M,40,7,5,89,-82,Severe
15,6,186,F,54,8,7,103,-83,Severe
16,11,203,F,3,5,3,63,-140,Severe
8,4,100,F,56,8,9,105,5,Good
12,8,152,F,110,14,3,171,19,Well
6,4,76,M,30,6,9,81,5,Good
18,4,220,M,105,13,9,165,-55,Severe
9,3,111,M,17,6,0,72,-39,Severe
15,10,190,F,54,8,7,103,-87,Severe
8,2,98,F,108,14,0,168,70,Well
9,11,119,M,12,5,9,69,-50,Severe
8,8,104,F,42,7,7,91,-13,Severe
8,0,96,F,41,7,6,90,-6,Severe
17,8,212,F,58,9,0,108,-104,Severe
18,4,220,M,43,7,8,92,-128,Severe
18,9,225,F,3,5,3,63,-162,Severe
16,9,201,M,4,5,4,64,-137,Severe
10,6,126,M,52,8,5,101,-25,Severe
10,1,121,F,31,6,9,81,-40,Severe
11,3,135,F,58,9,0,108,-27,Severe
17,7,211,F,86,11,10,142,-69,Severe
14,8,176,F,30,6,9,81,-95,Severe
6,4,76,F,32,6,10,82,6,Well
7,9,93,M,23,6,4,76,-17,Severe
10,6,126,M,35,7,1,85,-41,Severe
15,10,190,M,75,10,9,129,-61,Severe
10,2,122,F,55,8,8,104,-18,Severe
16,2,194,M,53,8,6,102,-92,Severe
5,5,65,M,99,13,1,157,92,Well
10,2,122,F,82,11,5,137,15,Well
8,5,101,F,88,12,0,144,43,Well
17,10,214,M,26,6,6,78,-136,Severe
10,8,128,M,2,5,3,63,-65,Severe
11,3,135,M,28,6,8,80,-55,Severe
17,1,205,M,14,5,10,70,-135,Severe
16,9,201,M,2,5,3,63,-138,Severe
12,3,147,M,3,5,3,63,-84,Severe
18,10,226,M,31,6,9,81,-145,Severe
6,3,75,M,18,6,1,73,-2,Mild
6,1,73,F,88,12,0,144,71,Well
5,0,60,M,5,5,5,65,5,Good
18,9,225,M,55,8,8,104,-121,Severe
6,9,81,F,82,11,5,137,56,Well
10,3,123,F,42,7,7,91,-32,Severe
6,2,74,M,34,7,0,84,10,Well
11,5,137,F,65,9,8,116,-21,Severe
13,8,164,F,13,5,9,69,-95,Severe
17,4,208,F,35,7,1,85,-123,Severe
6,9,81,M,53,8,6,102,21,Well
7,11,95,M,61,9,3,111,16,Well
10,9,129,F,50,8,3,99,-30,Severe
10,5,125,M,9,5,7,67,-58,Severe
16,11,203,M,43,7,8,92,-111,Severe
10,10,130,F,37,7,3,87,-43,Severe
14,10,178,M,9,5,7,67,-111,Severe
6,1,73,M,15,5,11,71,-2,Mild
6,5,77,M,74,10,7,127,50,Well
14,3,171,M,10,5,7,67,-104,Severe
11,6,138,F,77,10,11,131,-7,Severe
18,1,217,F,9,5,7,67,-150,Severe
14,3,171,M,98,13,0,156,-15,Severe
7,5,89,M,104,13,7,163,74,Well
12,11,155,M,106,13,10,166,11,Well
9,9,117,F,2,5,3,63,-54,Severe
7,4,88,M,23,6,4,76,-12,Severe
5,3,63,F,32,6,10,82,19,Well
8,5,101,F,96,12,10,154,53,Well
15,10,190,M,49,8,2,98,-92,Severe
10,11,131,M,84,11,7,139,8,Well
17,9,213,F,11,5,8,68,-145,Severe
16,1,193,F,13,5,9,69,-124,Severe
13,0,156,F,25,6,5,77,-79,Severe
8,3,99,F,32,6,10,82,-17,Severe
12,3,147,M,27,6,7,79,-68,Severe
15,9,189,M,109,14,1,169,-20,Severe
18,9,225,F,89,12,1,145,-80,Severe
11,8,140,F,22,6,3,75,-65,Severe
12,10,154,M,12,5,9,69,-85,Severe
14,4,172,M,106,13,10,166,-6,Severe
15,8,188,M,75,10,9,129,-59,Severe
13,3,159,F,80,11,3,135,-24,Severe
8,9,105,M,31,6,9,81,-24,Severe
9,5,113,F,45,7,10,94,-19,Severe
8,1,97,F,4,5,4,64,-33,Severe
18,4,220,M,16,5,11,71,-149,Severe
13,6,162,M,24,6,5,77,-85,Severe
6,11,83,F,63,9,6,114,31,Well
14,3,171,M,79,11,1,133,-38,Severe
14,6,174,M,14,5,10,70,-104,Severe
11,1,133,M,4,5,4,64,-69,Severe
10,3,123,M,59,9,1,109,-14,Severe
16,1,193,F,47,8,0,96,-97,Severe
10,11,131,M,93,12,6,150,19,Well
9,7,115,M,96,12,10,154,39,Well
6,11,83,M,38,7,4,88,5,Good
14,10,178,M,103,13,6,162,-16,Severe
15,3,183,M,93,12,6,150,-33,Severe
5,5,65,F,45,7,10,94,29,Well
8,5,101,M,33,6,11,83,-18,Severe
11,5,137,F,4,5,4,64,-73,Severe
9,10,118,F,18,6,1,73,-45,Severe
13,7,163,M,35,7,1,85,-78,Severe
15,9,189,F,17,6,0,72,-117,Severe
12,4,148,F,38,7,4,88,-60,Severe
10,7,127,F,23,6,4,76,-51,Severe
10,1,121,M,104,13,7,163,42,Well
6,2,74,M,83,11,6,138,64,Well
18,4,220,M,94,12,7,151,-69,Severe
18,9,225,M,28,6,8,80,-145,Severe
11,7,139,F,19,6,1,73,-66,Severe
9,8,116,F,42,7,7,91,-25,Severe
7,4,88,M,89,12,1,145,57,Well
11,7,139,F,43,7,8,92,-47,Severe
12,7,151,F,47,8,0,96,-55,Severe
18,1,217,F,25,6,5,77,-140,Severe
13,8,164,M,39,7,5,89,-75,Severe
13,8,164,M,32,6,10,82,-82,Severe
16,9,201,M,26,6,6,78,-123,Severe
18,3,219,M,104,13,7,163,-56,Severe
17,5,209,M,78,11,0,132,-77,Severe
16,1,193,M,4,5,4,64,-129,Severe
14,4,172,F,48,8,1,97,-75,Severe
15,10,190,M,104,13,7,163,-27,Severe
18,7,223,F,69,10,1,121,-102,Severe
15,3,183,F,89,12,1,145,-38,Severe
10,3,123,M,42,7,7,91,-32,Severe
7,4,88,M,104,13,7,163,75,Well
15,2,182,F,2,5,3,63,-119,Severe
8,2,98,M,73,10,6,126,28,Well
11,4,136,M,34,7,0,84,-52,Severe
11,6,138,F,85,11,9,141,3,Good
5,3,63,F,39,7,5,89,26,Well
12,3,147,M,39,7,5,89,-58,Severe
9,2,110,M,14,5,10,70,-40,Severe
9,6,114,M,110,14,3,171,57,Well
7,4,88,M,92,12,5,149,61,Well
8,3,99,M,68,10,0,120,21,Well
12,10,154,F,91,12,4,148,-6,Severe
10,11,131,F,24,6,5,77,-54,Severe
14,0,168,F,23,6,4,76,-92,Severe
15,3,183,F,20,6,2,74,-109,Severe
11,8,140,M,107,13,11,167,27,Well
10,4,124,M,24,6,5,77,-47,Severe
15,1,181,F,37,7,3,87,-94,Severe
14,5,173,M,79,11,1,133,-40,Severe
8,8,104,M,46,7,11,95,-9,Severe
15,3,183,M,45,7,10,94,-89,Severe
15,8,188,M,48,8,1,97,-91,Severe
12,11,155,M,108,14,0,168,13,Well
11,1,133,M,110,14,3,171,38,Well
13,4,160,F,17,6,0,72,-88,Severe
10,9,129,F,42,7,7,91,-38,Severe
15,11,191,F,45,7,10,94,-97,Severe
5,8,68,F,93,12,6,150,82,Well
12,1,145,F,99,13,1,157,12,Well
5,10,70,F,70,10,2,122,52,Well
17,0,204,F,74,10,7,127,-77,Severe
9,3,111,F,13,5,9,69,-42,Severe
8,10,106,M,19,6,1,73,-33,Severe
10,8,128,M,66,9,9,117,-11,Severe
18,3,219,M,41,7,6,90,-129,Severe
13,10,166,M,70,10,2,122,-44,Severe
14,5,173,M,2,5,3,63,-110,Severe
11,7,139,M,95,12,9,153,14,Well
6,9,81,M,94,12,7,151,70,Well
10,5,125,F,13,5,9,69,-56,Severe
5,9,69,M,100,13,3,159,90,Well
15,6,186,M,16,5,11,71,-115,Severe
14,5,173,F,7,5,6,66,-107,Severe
5,3,63,F,107,13,11,167,104,Well
14,1,169,F,83,11,6,138,-31,Severe
6,0,72,F,56,8,9,105,33,Well
14,10,178,F,82,11,5,137,-41,Severe
14,11,179,M,42,7,7,91,-88,Severe
17,11,215,M,48,8,1,97,-118,Severe
8,9,105,F,99,13,1,157,52,Well
6,1,73,M,8,5,6,66,-7,Severe
8,9,105,M,37,7,3,87,-18,Severe
11,4,136,F,24,6,5,77,-59,Severe
16,6,198,F,91,12,4,148,-50,Severe
7,9,93,M,86,11,10,142,49,Well
10,0,120,M,81,11,4,136,16,Well
16,10,202,M,58,9,0,108,-94,Severe
10,5,125,F,4,5,4,64,-61,Severe
17,0,204,F,80,11,3,135,-69,Severe
5,9,69,F,38,7,4,88,19,Well
11,0,132,F,35,7,1,85,-47,Severe
16,2,194,F,63,9,6,114,-80,Severe
15,10,190,F,17,6,0,72,-118,Severe
11,10,142,M,41,7,6,90,-52,Severe
14,9,177,M,68,10,0,120,-57,Severe
10,3,123,M,6,5,5,65,-58,Severe
11,9,141,M,46,7,11,95,-46,Severe
18,10,226,F,62,9,4,112,-114,Severe
13,3,159,F,95,12,9,153,-6,Severe
16,5,197,F,19,6,1,73,-124,Severe
14,3,171,M,61,9,3,111,-60,Severe
18,0,216,F,26,6,6,78,-138,Severe
12,11,155,F,57,8,10,106,-49,Severe
7,7,91,F,89,12,1,145,54,Well
12,6,150,F,109,14,1,169,19,Well
13,0,156,F,17,6,0,72,-84,Severe
10,4,124,F,38,7,4,88,-36,Severe
13,7,163,F,83,11,6,138,-25,Severe
15,2,182,M,31,6,9,81,-101,Severe
13,4,160,M,49,8,2,98,-62,Severe
11,6,138,F,88,12,0,144,6,Well
12,8,152,M,57,8,10,106,-46,Severe
16,11,203,F,72,10,4,124,-79,Severe
7,1,85,F,31,6,9,81,-4,Mild
9,3,111,F,30,6,9,81,-30,Severe
9,9,117,M,57,8,10,106,-11,Severe
15,11,191,F,4,5,4,64,-127,Severe
7,1,85,M,79,11,1,133,48,Well
17,1,205,F,104,13,7,163,-42,Severe
13,6,162,M,28,6,8,80,-82,Severe
14,11,179,M,16,5,11,71,-108,Severe
14,4,172,F,61,9,3,111,-61,Severe
14,5,173,M,11,5,8,68,-105,Severe
18,4,220,F,7,5,6,66,-154,Severe
14,8,176,M,5,5,5,65,-111,Severe
11,3,135,F,106,13,10,166,31,Well
8,4,100,M,110,14,3,171,71,Well
14,6,174,M,92,12,5,149,-25,Severe
7,4,88,F,54,8,7,103,15,Well
14,2,170,F,86,11,10,142,-28,Severe
10,3,123,M,45,7,10,94,-29,Severe
15,0,180,F,54,8,7,103,-77,Severe
12,2,146,F,77,10,11,131,-15,Severe
7,9,93,F,105,13,9,165,72,Well
8,6,102,M,65,9,8,116,14,Well
15,5,185,F,62,9,4,112,-73,Severe
15,7,187,F,50,8,3,99,-88,Severe
14,0,168,M,22,6,3,75,-93,Severe
12,9,153,M,92,12,5,149,-4,Mild
8,3,99,F,25,6,5,77,-22,Severe
6,5,77,F,92,12,5,149,72,Well
15,10,190,F,81,11,4,136,-54,Severe
17,9,213,M,42,7,7,91,-122,Severe
9,3,111,M,99,13,1,157,46,Well
8,11,107,M,51,8,4,100,-7,Severe
10,7,127,M,87,11,11,143,16,Well
8,4,100,M,24,6,5,77,-23,Severe
18,2,218,M,17,6,0,72,-146,Severe
13,3,159,M,75,10,9,129,-30,Severe
16,1,193,F,67,9,10,118,-75,Severe
11,3,135,F,71,10,3,123,-12,Severe
18,9,225,F,33,6,11,83,-142,Severe
6,9,81,F,79,11,1,133,52,Well
17,1,205,M,59,9,1,109,-96,Severe
7,2,86,F,74,10,7,127,41,Well
14,8,176,M,38,7,4,88,-88,Severe
8,1,97,F,88,12,0,144,47,Well
15,1,181,F,99,13,1,157,-24,Severe
12,9,153,F,51,8,4,100,-53,Severe
14,11,179,M,8,5,6,66,-113,Severe
8,8,104,F,90,12,3,147,43,Well
10,11,131,F,88,12,0,144,13,Well
11,2,134,M,84,11,7,139,5,Good
14,11,179,F,70,10,2,122,-57,Severe
17,11,215,M,17,6,0,72,-143,Severe
14,8,176,M,100,13,3,159,-17,Severe
17,1,205,F,12,5,9,69,-136,Severe
11,9,141,F,41,7,6,90,-51,Severe
15,11,191,M,84,11,7,139,-52,Severe
15,11,191,M,105,13,9,165,-26,Severe
17,11,215,F,18,6,1,73,-142,Severe
11,4,136,F,6,5,5,65,-71,Severe
14,9,177,M,32,6,10,82,-95,Severe
9,0,108,F,17,6,0,72,-36,Severe
6,7,79,F,56,8,9,105,26,Well
16,3,195,F,110,14,3,171,-24,Severe
16,9,201,M,63,9,6,114,-87,Severe
9,7,115,F,75,10,9,129,14,Well
5,10,70,F,48,8,1,97,27,Well
7,3,87,M,80,11,3,135,48,Well
11,10,142,M,73,10,6,126,-16,Severe
6,1,73,M,26,6,6,78,5,Good
13,0,156,M,56,8,9,105,-51,Severe
17,0,204,M,63,9,6,114,-90,Severe
13,2,158,F,38,7,4,88,-70,Severe
9,3,111,M,59,9,1,109,-2,Mild
7,8,92,M,8,5,6,66,-26,Severe
16,4,196,F,107,13,11,167,-29,Severe
18,6,222,F,73,10,6,126,-96,Severe
9,10,118,M,37,7,3,87,-31,Severe
13,3,159,F,107,13,11,167,8,Well
11,9,141,F,66,9,9,117,-24,Severe
18,3,219,F,83,11,6,138,-81,Severe
13,6,162,F,19,6,1,73,-89,Severe
15,5,185,M,101,13,4,160,-25,Severe
13,5,161,M,93,12,6,150,-11,Severe
11,3,135,F,70,10,2,122,-13,Severe
5,3,63,F,67,9,10,118,55,Well
16,2,194,M,108,14,0,168,-26,Severe
13,2,158,M,76,10,10,130,-28,Severe
9,10,118,M,5,5,5,65,-53,Severe
18,3,219,F,4,5,4,64,-155,Severe
8,8,104,F,58,9,0,108,4,Good
11,1,133,F,34,7,0,84,-49,Severe
12,6,150,M,94,12,7,151,1,Good
5,2,62,F,48,8,1,97,35,Well
16,6,198,F,78,11,0,132,-66,Severe
5,3,63,F,91,12,4,148,85,Well
18,1,217,F,67,9,10,118,-99,Severe
18,3,219,F,22,6,3,75,-144,Severe
18,3,219,F,88,12,0,144,-75,Severe
7,3,87,M,84,11,7,139,52,Well
11,8,140,F,110,14,3,171,31,Well
10,10,130,M,54,8,7,103,-27,Severe
16,2,194,F,49,8,2,98,-96,Severe
18,1,217,M,55,8,8,104,-113,Severe
8,8,104,M,16,5,11,71,-33,Severe
17,11,215,F,33,6,11,83,-132,Severe
9,7,115,M,105,13,9,165,50,Well
14,2,170,M,82,11,5,137,-33,Severe
7,8,92,M,110,14,3,171,79,Well
5,2,62,M,22,6,3,75,13,Well
8,2,98,F,104,13,7,163,65,Well
15,5,185,F,60,9,2,110,-75,Severe
15,6,186,M,67,9,10,118,-68,Severe
13,5,161,F,76,10,10,130,-31,Severe
12,11,155,F,8,5,6,66,-89,Severe
6,2,74,M,69,10,1,121,47,Well
10,0,120,M,93,12,6,150,30,Well
13,0,156,M,31,6,9,81,-75,Severe
11,8,140,M,63,9,6,114,-26,Severe
5,11,71,M,83,11,6,138,67,Well
18,10,226,F,109,14,1,169,-57,Severe
9,11,119,F,88,12,0,144,25,Well
7,7,91,F,38,7,4,88,-3,Mild
18,4,220,F,57,8,10,106,-114,Severe
5,1,61,M,15,5,11,71,10,Well
8,11,107,F,36,7,2,86,-21,Severe
17,0,204,M,84,11,7,139,-65,Severe
12,4,148,M,61,9,3,111,-37,Severe
10,3,123,F,32,6,10,82,-41,Severe
6,9,81,M,65,9,8,116,35,Well
13,0,156,F,102,13,6,162,6,Well
17,7,211,M,16,5,11,71,-140,Severe
10,3,123,F,108,14,0,168,45,Well
9,8,116,F,32,6,10,82,-34,Severe
12,4,148,F,39,7,5,89,-59,Severe
16,5,197,M,69,10,1,121,-76,Severe
8,10,106,F,23,6,4,76,-30,Severe
9,1,109,M,64,9,7,115,6,Well
9,11,119,M,42,7,7,91,-28,Severe
12,4,148,M,74,10,7,127,-21,Severe
5,9,69,M,35,7,1,85,16,Well
17,8,212,M,59,9,1,109,-103,Severe
6,0,72,F,39,7,5,89,17,Well
8,11,107,F,10,5,7,67,-40,Severe
16,4,196,M,41,7,6,90,-106,Severe
18,3,219,F,36,7,2,86,-133,Severe
15,8,188,F,64,9,7,115,-73,Severe
8,2,98,F,75,10,9,129,31,Well
15,3,183,M,5,5,5,65,-118,Severe
10,0,120,M,64,9,7,115,-5,Mild
9,3,111,F,38,7,4,88,-23,Severe
17,7,211,M,52,8,5,101,-110,Severe
9,5,113,M,54,8,7,103,-10,Severe
7,6,90,F,71,10,3,123,33,Well
11,6,138,M,21,6,2,74,-64,Severe
14,8,176,F,71,10,3,123,-53,Severe
15,8,188,F,23,6,4,76,-112,Severe
13,5,161,F,16,5,11,71,-90,Severe
8,11,107,M,9,5,7,67,-40,Severe
18,7,223,F,59,9,1,109,-114,Severe
11,4,136,M,104,13,7,163,27,Well
16,4,196,M,30,6,9,81,-115,Severe
10,3,123,M,7,5,6,66,-57,Severe
6,1,73,M,20,6,2,74,1,Good
8,2,98,F,87,11,11,143,45,Well
14,3,171,F,76,10,10,130,-41,Severe
9,8,116,M,48,8,1,97,-19,Severe
12,8,152,F,5,5,5,65,-87,Severe
15,11,191,F,26,6,6,78,-113,Severe
11,8,140,M,91,12,4,148,8,Well
17,7,211,M,24,6,5,77,-134,Severe
9,10,118,F,93,12,6,150,32,Well
8,8,104,F,91,12,4,148,44,Well
18,1,217,M,105,13,9,165,-52,Severe
10,5,125,M,72,10,4,124,-1,Mild
6,5,77,M,34,7,0,84,7,Well
6,10,82,F,94,12,7,151,69,Well
13,8,164,F,62,9,4,112,-52,Severe
14,0,168,M,11,5,8,68,-100,Severe
7,1,85,F,30,6,9,81,-4,Mild
8,4,100,M,34,7,0,84,-16,Severe
13,3,159,F,14,5,10,70,-89,Severe
10,8,128,M,48,8,1,97,-31,Severe
16,3,195,M,99,13,1,157,-38,Severe
14,1,169,F,101,13,4,160,-9,Severe
11,5,137,F,58,9,0,108,-29,Severe
17,3,207,M,79,11,1,133,-74,Severe
5,1,61,F,44,7,9,93,32,Well
11,0,132,M,70,10,2,122,-10,Severe
8,4,100,F,60,9,2,110,10,Well
7,3,87,F,21,6,2,74,-13,Severe
5,10,70,M,10,5,7,67,-3,Mild
14,1,169,M,17,6,0,72,-97,Severe
11,3,135,M,95,12,9,153,18,Well
17,4,208,M,85,11,9,141,-67,Severe
5,3,63,F,109,14,1,169,106,Well
10,6,126,F,102,13,6,162,36,Well
17,4,208,M,28,6,8,80,-128,Severe
8,7,103,M,104,13,7,163,60,Well
9,3,111,F,103,13,6,162,51,Well
9,4,112,F,32,6,10,82,-30,Severe
17,8,212,M,100,13,3,159,-53,Severe
14,3,171,F,32,6,10,82,-89,Severe
14,2,170,F,40,7,5,89,-81,Severe
5,1,61,F,55,8,8,104,43,Well
13,7,163,F,15,5,11,71,-92,Severe
11,1,133,M,103,13,6,162,29,Well
11,7,139,F,80,11,3,135,-4,Mild
5,9,69,F,13,5,9,69,0,Neutral
11,4,136,M,50,8,3,99,-37,Severe
10,8,128,M,65,9,8,116,-12,Severe
18,7,223,F,103,13,6,162,-61,Severe
16,7,199,M,16,5,11,71,-128,Severe
12,6,150,F,19,6,1,73,-77,Severe
14,10,178,M,80,11,3,135,-43,Severe
8,6,102,M,40,7,5,89,-13,Severe
6,5,77,F,63,9,6,114,37,Well
6,11,83,M,96,12,10,154,71,Well
6,9,81,M,81,11,4,136,55,Well
14,4,172,F,37,7,3,87,-85,Severe
11,2,134,M,62,9,4,112,-22,Severe
17,3,207,F,41,7,6,90,-117,Severe
9,1,109,M,63,9,6,114,5,Good
17,7,211,M,18,6,1,73,-138,Severe
9,4,112,F,15,5,11,71,-41,Severe
13,8,164,M,7,5,6,66,-98,Severe
5,9,69,F,19,6,1,73,4,Good
13,3,159,M,40,7,5,89,-70,Severe
9,2,110,M,92,12,5,149,39,Well
11,11,143,F,19,6,1,73,-70,Severe
14,1,169,F,109,14,1,169,0,Neutral
16,0,192,F,101,13,4,160,-32,Severe
9,8,116,F,39,7,5,89,-27,Severe
11,10,142,M,82,11,5,137,-5,Mild
15,8,188,F,101,13,4,160,-28,Severe
5,0,60,M,86,11,10,142,82,Well
12,2,146,M,58,9,0,108,-38,Severe
17,10,214,M,93,12,6,150,-64,Severe
16,7,199,M,96,12,10,154,-45,Severe
15,2,182,F,25,6,5,77,-105,Severe
15,3,183,F,2,5,3,63,-120,Severe
5,2,62,M,23,6,4,76,14,Well
16,8,200,F,65,9,8,116,-84,Severe
16,7,199,F,48,8,1,97,-102,Severe
5,0,60,M,76,10,10,130,70,Well
8,11,107,M,89,12,1,145,38,Well
8,7,103,F,51,8,4,100,-3,Mild
12,4,148,F,98,13,0,156,8,Well
14,1,169,M,88,12,0,144,-25,Severe
15,3,183,F,41,7,6,90,-93,Severe
12,5,149,F,92,12,5,149,0,Neutral
12,5,149,M,40,7,5,89,-60,Severe
6,8,80,M,96,12,10,154,74,Well
5,5,65,M,14,5,10,70,5,Good
17,10,214,M,53,8,6,102,-112,Severe
14,7,175,F,27,6,7,79,-96,Severe
16,7,199,M,54,8,7,103,-96,Severe
7,7,91,M,43,7,8,92,1,Good
15,3,183,F,11,5,8,68,-115,Severe
13,3,159,M,107,13,11,167,8,Well
10,7,127,F,107,13,11,167,40,Well
10,8,128,F,70,10,2,122,-6,Severe
18,11,227,M,90,12,3,147,-80,Severe
8,3,99,M,45,7,10,94,-5,Mild
8,3,99,F,44,7,9,93,-6,Severe
8,3,99,F,103,13,6,162,63,Well
11,2,134,F,90,12,3,147,13,Well
18,11,227,F,42,7,7,91,-136,Severe
14,5,173,M,37,7,3,87,-86,Severe
13,6,162,F,95,12,9,153,-9,Severe
12,7,151,M,40,7,5,89,-62,Severe
13,1,157,M,61,9,3,111,-46,Severe
7,6,90,M,55,8,8,104,14,Well
10,3,123,M,78,11,0,132,9,Well
18,7,223,M,56,8,9,105,-118,Severe
16,5,197,F,110,14,3,171,-26,Severe
18,2,218,M,29,6,8,80,-138,Severe
5,4,64,M,34,7,0,84,20,Well
15,0,180,F,36,7,2,86,-94,Severe
11,3,135,M,41,7,6,90,-45,Severe
8,1,97,F,36,7,2,86,-11,Severe
11,1,133,F,42,7,7,91,-42,Severe
7,0,84,F,85,11,9,141,57,Well
8,6,102,M,91,12,4,148,46,Well
15,11,191,F,86,11,10,142,-49,Severe
16,0,192,M,59,9,1,109,-83,Severe
15,7,187,F,81,11,4,136,-51,Severe
8,11,107,F,33,6,11,83,-24,Severe
17,6,210,F,16,5,11,71,-139,Severe
13,2,158,M,56,8,9,105,-53,Severe
8,8,104,F,85,11,9,141,37,Well
5,10,70,M,64,9,7,115,45,Well
14,4,172,M,110,14,3,171,-1,Mild
13,3,159,M,54,8,7,103,-56,Severe
8,7,103,F,92,12,5,149,46,Well
11,5,137,F,86,11,10,142,5,Good
17,2,206,M,60,9,2,110,-96,Severe
16,4,196,F,62,9,4,112,-84,Severe
10,10,130,F,41,7,6,90,-40,Severe
12,4,148,M,12,5,9,69,-79,Severe
6,9,81,M,88,12,0,144,63,Well
15,10,190,M,68,10,0,120,-70,Severe
14,6,174,F,54,8,7,103,-71,Severe
11,0,132,F,48,8,1,97,-35,Severe
15,4,184,F,96,12,10,154,-30,Severe
11,2,134,M,101,13,4,160,26,Well
15,11,191,M,95,12,9,153,-38,Severe
13,1,157,M,63,9,6,114,-43,Severe
5,6,66,F,92,12,5,149,83,Well
7,1,85,M,46,7,11,95,10,Well
16,6,198,F,93,12,6,150,-48,Severe
6,10,82,F,56,8,9,105,23,Well
14,10,178,M,109,14,1,169,-9,Severe
17,2,206,M,22,6,3,75,-131,Severe
16,9,201,F,105,13,9,165,-36,Severe
6,2,74,F,84,11,7,139,65,Well
17,3,207,M,105,13,9,165,-42,Severe
5,3,63,M,25,6,5,77,14,Well
13,4,160,F,106,13,10,166,6,Well
5,10,70,F,37,7,3,87,17,Well
12,8,152,F,96,12,10,154,2,Good
16,3,195,M,104,13,7,163,-32,Severe
9,5,113,F,88,12,0,144,31,Well
5,11,71,F,78,11,0,132,61,Well
7,3,87,M,61,9,3,111,24,Well
10,3,123,M,21,6,2,74,-49,Severe
7,4,88,M,35,7,1,85,-3,Mild
12,4,148,M,89,12,1,145,-3,Mild
10,3,123,F,14,5,10,70,-53,Severe
14,8,176,M,70,10,2,122,-54,Severe
8,4,100,F,41,7,6,90,-10,Severe
5,5,65,F,62,9,4,112,47,Well
6,3,75,F,26,6,6,78,3,Good
8,10,106,M,33,6,11,83,-23,Severe
16,11,203,F,78,11,0,132,-71,Severe
5,7,67,F,9,5,7,67,0,Neutral
14,9,177,M,26,6,6,78,-99,Severe
16,3,195,M,28,6,8,80,-115,Severe
7,6,90,F,94,12,7,151,61,Well
14,8,176,M,98,13,0,156,-20,Severe
13,0,156,F,11,5,8,68,-88,Severe
13,4,160,M,51,8,4,100,-60,Severe
14,6,174,M,102,13,6,162,-12,Severe
18,1,217,M,46,7,11,95,-122,Severe
5,4,64,M,27,6,7,79,15,Well
13,11,167,M,33,6,11,83,-84,Severe
9,9,117,F,99,13,1,157,40,Well
15,6,186,M,34,7,0,84,-102,Severe
10,4,124,F,91,12,4,148,24,Well
12,2,146,M,34,7,0,84,-62,Severe
11,0,132,M,93,12,6,150,18,Well
8,6,102,F,104,13,7,163,61,Well
6,11,83,F,76,10,10,130,47,Well
17,3,207,F,101,13,4,160,-47,Severe
6,3,75,M,43,7,8,92,17,Well
5,6,66,F,7,5,6,66,0,Neutral
18,4,220,M,36,7,2,86,-134,Severe
14,3,171,M,77,10,11,131,-40,Severe
13,11,167,F,28,6,8,80,-87,Severe
15,8,188,M,42,7,7,91,-97,Severe
10,5,125,F,96,12,10,154,29,Well
13,3,159,F,27,6,7,79,-80,Severe
11,2,134,M,44,7,9,93,-41,Severe
5,7,67,F,71,10,3,123,56,Well
5,3,63,M,17,6,0,72,9,Well
15,7,187,M,95,12,9,153,-34,Severe
13,10,166,M,39,7,5,89,-77,Severe
16,3,195,F,98,13,0,156,-39,Severe
18,11,227,F,16,5,11,71,-156,Severe
15,2,182,M,6,5,5,65,-117,Severe
18,9,225,F,5,5,5,65,-160,Severe
16,2,194,M,102,13,6,162,-32,Severe
11,11,143,F,66,9,9,117,-26,Severe
8,10,106,M,6,5,5,65,-41,Severe
16,9,201,F,74,10,7,127,-74,Severe
18,3,219,F,102,13,6,162,-57,Severe
11,2,134,F,34,7,0,84,-50,Severe
6,5,77,M,53,8,6,102,25,Well
15,0,180,F,57,8,10,106,-74,Severe
5,10,70,F,69,10,1,121,51,Well
15,9,189,F,80,11,3,135,-54,Severe
15,4,184,F,99,13,1,157,-27,Severe
9,5,113,F,61,9,3,111,-2,Mild
15,3,183,M,101,13,4,160,-23,Severe
9,9,117,M,36,7,2,86,-31,Severe
14,2,170,M,49,8,2,98,-72,Severe
7,3,87,F,92,12,5,149,62,Well
14,7,175,F,55,8,8,104,-71,Severe
14,9,177,M,4,5,4,64,-113,Severe
13,3,159,M,6,5,5,65,-94,Severe
6,7,79,F,66,9,9,117,38,Well
8,7,103,F,108,14,0,168,65,Well
9,0,108,M,64,9,7,115,7,Well
12,11,155,F,84,11,7,139,-16,Severe
7,3,87,M,58,9,0,108,21,Well
14,7,175,M,44,7,9,93,-82,Severe
11,0,132,F,2,5,3,63,-69,Severe
9,0,108,M,15,5,11,71,-37,Severe
13,2,158,F,30,6,9,81,-77,Severe
10,5,125,F,55,8,8,104,-21,Severe
17,9,213,M,43,7,8,92,-121,Severe
5,3,63,F,41,7,6,90,27,Well
11,9,141,M,39,7,5,89,-52,Severe
5,1,61,M,54,8,7,103,42,Well
16,3,195,M,61,9,3,111,-84,Severe
5,10,70,M,7,5,6,66,-4,Mild
18,8,224,M,56,8,9,105,-119,Severe
16,8,200,M,106,13,10,166,-34,Severe
9,5,113,M,65,9,8,116,3,Good
5,8,68,M,47,8,0,96,28,Well
5,3,63,M,20,6,2,74,11,Well
13,4,160,F,42,7,7,91,-69,Severe
15,8,188,M,41,7,6,90,-98,Severe
14,3,171,F,13,5,9,69,-102,Severe
13,3,159,F,93,12,6,150,-9,Severe
18,3,219,F,51,8,4,100,-119,Severe
11,7,139,F,72,10,4,124,-15,Severe
11,2,134,M,31,6,9,81,-53,Severe
13,2,158,F,3,5,3,63,-95,Severe
7,5,89,M,76,10,10,130,41,Well
13,10,166,F,93,12,6,150,-16,Severe
16,2,194,M,69,10,1,121,-73,Severe
16,0,192,M,72,10,4,124,-68,Severe
14,11,179,F,89,12,1,145,-34,Severe
17,9,213,F,94,12,7,151,-62,Severe
8,11,107,M,64,9,7,115,8,Well
12,7,151,F,77,10,11,131,-20,Severe
12,8,152,F,95,12,9,153,1,Good
13,2,158,F,79,11,1,133,-25,Severe
18,4,220,M,3,5,3,63,-157,Severe
13,9,165,F,73,10,6,126,-39,Severe
9,8,116,M,87,11,11,143,27,Well
6,3,75,M,15,5,11,71,-4,Mild
15,5,185,F,68,10,0,120,-65,Severe
10,6,126,F,14,5,10,70,-56,Severe
18,9,225,F,45,7,10,94,-131,Severe
5,1,61,M,86,11,10,142,81,Well
9,4,112,M,65,9,8,116,4,Good
16,0,192,F,35,7,1,85,-107,Severe
14,8,176,M,33,6,11,83,-93,Severe
18,2,218,M,45,7,10,94,-124,Severe
12,7,151,M,90,12,3,147,-4,Mild
15,1,181,M,92,12,5,149,-32,Severe
15,3,183,M,27,6,7,79,-104,Severe
13,2,158,F,86,11,10,142,-16,Severe
12,3,147,F,33,6,11,83,-64,Severe
9,7,115,F,85,11,9,141,26,Well
14,8,176,M,53,8,6,102,-74,Severe
18,3,219,M,109,14,1,169,-50,Severe
14,6,174,F,24,6,5,77,-97,Severe
11,6,138,M,7,5,6,66,-72,Severe
6,6,78,M,44,7,9,93,15,Well
15,2,182,M,34,7,0,84,-98,Severe
18,9,225,F,65,9,8,116,-109,Severe
12,3,147,M,24,6,5,77,-70,Severe
6,8,80,F,108,14,0,168,88,Well
11,7,139,M,31,6,9,81,-58,Severe
15,10,190,F,94,12,7,151,-39,Severe
13,6,162,F,20,6,2,74,-88,Severe
15,3,183,M,94,12,7,151,-32,Severe
14,7,175,F,53,8,6,102,-73,Severe
16,11,203,M,94,12,7,151,-52,Severe
7,8,92,F,105,13,9,165,73,Well
13,8,164,F,71,10,3,123,-41,Severe
6,10,82,M,92,12,5,149,67,Well
6,4,76,F,73,10,6,126,50,Well
17,5,209,M,83,11,6,138,-71,Severe
7,7,91,M,80,11,3,135,44,Well
7,8,92,M,55,8,8,104,12,Well
16,9,201,M,95,12,9,153,-48,Severe
14,2,170,M,85,11,9,141,-29,Severe
10,1,121,M,44,7,9,93,-28,Severe
16,6,198,F,81,11,4,136,-62,Severe
7,7,91,M,37,7,3,87,-4,Mild
10,10,130,F,52,8,5,101,-29,Severe
15,7,187,M,46,7,11,95,-92,Severe
10,10,130,M,84,11,7,139,9,Well
17,1,205,M,37,7,3,87,-118,Severe
16,1,193,M,83,11,6,138,-55,Severe
12,5,149,F,41,7,6,90,-59,Severe
16,5,197,F,14,5,10,70,-127,Severe
8,0,96,M,57,8,10,106,10,Well
9,5,113,M,103,13,6,162,49,Well
16,0,192,M,81,11,4,136,-56,Severe
9,1,109,M,54,8,7,103,-6,Severe
13,1,157,F,43,7,8,92,-65,Severe
14,11,179,F,44,7,9,93,-86,Severe
18,0,216,F,110,14,3,171,-45,Severe
5,6,66,M,92,12,5,149,83,Well
8,6,102,M,29,6,8,80,-22,Severe
17,2,206,F,43,7,8,92,-114,Severe
13,6,162,M,23,6,4,76,-86,Severe
11,5,137,M,33,6,11,83,-54,Severe
14,4,172,M,88,12,0,144,-28,Severe
16,11,203,F,99,13,1,157,-46,Severe
12,10,154,F,61,9,3,111,-43,Severe
6,11,83,M,23,6,4,76,-7,Severe
6,3,75,F,3,5,3,63,-12,Severe
8,6,102,M,66,9,9,117,15,Well
15,2,182,F,70,10,2,122,-60,Severe
8,4,100,F,14,5,10,70,-30,Severe
17,11,215,M,22,6,3,75,-140,Severe
16,11,203,F,92,12,5,149,-54,Severe
6,5,77,F,75,10,9,129,52,Well
6,11,83,F,100,13,3,159,76,Well
11,0,132,F,55,8,8,104,-28,Severe
9,1,109,M,27,6,7,79,-30,Severe
16,11,203,F,51,8,4,100,-103,Severe
10,5,125,F,6,5,5,65,-60,Severe
10,8,128,M,79,11,1,133,5,Good
12,0,144,F,51,8,4,100,-44,Severe
9,9,117,M,51,8,4,100,-17,Severe
15,8,188,F,81,11,4,136,-52,Severe
10,1,121,F,25,6,5,77,-44,Severe
15,9,189,M,3,5,3,63,-126,Severe
14,10,178,M,14,5,10,70,-108,Severe
14,7,175,M,61,9,3,111,-64,Severe
18,2,218,M,92,12,5,149,-69,Severe
15,5,185,M,68,10,0,120,-65,Severe
14,1,169,M,105,13,9,165,-4,Mild
13,5,161,F,69,10,1,121,-40,Severe
7,5,89,F,61,9,3,111,22,Well
16,3,195,F,62,9,4,112,-83,Severe
16,9,201,M,16,5,11,71,-130,Severe
17,1,205,M,72,10,4,124,-81,Severe
6,10,82,M,54,8,7,103,21,Well
10,2,122,F,54,8,7,103,-19,Severe
18,2,218,F,26,6,6,78,-140,Severe
5,9,69,F,48,8,1,97,28,Well
18,6,222,M,93,12,6,150,-72,Severe
17,9,213,M,102,13,6,162,-51,Severe
11,3,135,M,62,9,4,112,-23,Severe
14,9,177,F,104,13,7,163,-14,Severe
6,4,76,M,90,12,3,147,71,Well
12,3,147,M,23,6,4,76,-71,Severe
9,9,117,F,43,7,8,92,-25,Severe
9,6,114,M,87,11,11,143,29,Well
14,3,171,F,68,10,0,120,-51,Severe
10,8,128,M,32,6,10,82,-46,Severe
15,4,184,M,70,10,2,122,-62,Severe
16,3,195,M,70,10,2,122,-73,Severe
13,4,160,F,85,11,9,141,-19,Severe
8,5,101,F,59,9,1,109,8,Well
11,10,142,F,69,10,1,121,-21,Severe
5,4,64,M,38,7,4,88,24,Well
15,6,186,F,53,8,6,102,-84,Severe
11,5,137,F,73,10,6,126,-11,Severe
12,10,154,F,4,5,4,64,-90,Severe
13,3,159,M,60,9,2,110,-49,Severe
15,1,181,M,3,5,3,63,-118,Severe
6,10,82,F,88,12,0,144,62,Well
6,9,81,F,27,6,7,79,-2,Mild
8,4,100,M,48,8,1,97,-3,Mild
7,3,87,M,58,9,0,108,21,Well
6,7,79,F,43,7,8,92,13,Well
5,6,66,M,27,6,7,79,13,Well
13,0,156,M,8,5,6,66,-90,Severe
14,1,169,M,14,5,10,70,-99,Severe
7,8,92,F,72,10,4,124,32,Well
15,3,183,F,83,11,6,138,-45,Severe
12,10,154,F,27,6,7,79,-75,Severe
5,2,62,F,16,5,11,71,9,Well
14,5,173,F,67,9,10,118,-55,Severe
14,3,171,F,50,8,3,99,-72,Severe
17,9,213,F,104,13,7,163,-50,Severe
10,4,124,F,101,13,4,160,36,Well
9,1,109,M,94,12,7,151,42,Well
9,0,108,F,63,9,6,114,6,Well
11,2,134,M,72,10,4,124,-10,Severe
7,9,93,F,65,9,8,116,23,Well
17,1,205,F,79,11,1,133,-72,Severe
16,6,198,F,74,10,7,127,-71,Severe
7,6,90,M,6,5,5,65,-25,Severe
15,4,184,M,74,10,7,127,-57,Severe
8,9,105,M,72,10,4,124,19,Well
9,7,115,M,9,5,7,67,-48,Severe
9,0,108,M,86,11,10,142,34,Well
13,0,156,M,21,6,2,74,-82,Severe
17,6,210,M,108,14,0,168,-42,Severe
18,9,225,F,93,12,6,150,-75,Severe
16,5,197,F,103,13,6,162,-35,Severe
11,11,143,M,65,9,8,116,-27,Severe
18,2,218,M,44,7,9,93,-125,Severe
10,9,129,F,10,5,7,67,-62,Severe
17,10,214,F,101,13,4,160,-54,Severe
9,8,116,M,33,6,11,83,-33,Severe
11,3,135,F,31,6,9,81,-54,Severe
14,7,175,M,65,9,8,116,-59,Severe
18,9,225,F,27,6,7,79,-146,Severe
10,0,120,F,50,8,3,99,-21,Severe
8,9,105,M,50,8,3,99,-6,Severe
8,7,103,F,61,9,3,111,8,Well
10,2,122,M,9,5,7,67,-55,Severe
14,10,178,M,55,8,8,104,-74,Severe
9,6,114,F,16,5,11,71,-43,Severe
5,9,69,F,83,11,6,138,69,Well
18,6,222,F,103,13,6,162,-60,Severe
17,5,209,M,62,9,4,112,-97,Severe
14,5,173,F,38,7,4,88,-85,Severe
13,11,167,F,56,8,9,105,-62,Severe
13,10,166,M,93,12,6,150,-16,Severe
18,4,220,M,90,12,3,147,-73,Severe
10,9,129,F,57,8,10,106,-23,Severe
9,6,114,F,82,11,5,137,23,Well
8,11,107,M,96,12,10,154,47,Well
5,2,62,F,19,6,1,73,11,Well
14,3,171,F,52,8,5,101,-70,Severe
8,1,97,M,108,14,0,168,71,Well
9,3,111,F,73,10,6,126,15,Well
11,1,133,F,107,13,11,167,34,Well
9,4,112,F,93,12,6,150,38,Well
16,2,194,M,16,5,11,71,-123,Severe
18,11,227,F,75,10,9,129,-98,Severe
13,4,160,F,99,13,1,157,-3,Mild
18,1,217,F,105,13,9,165,-52,Severe
17,10,214,F,51,8,4,100,-114,Severe
11,0,132,F,10,5,7,67,-65,Severe
5,6,66,F,33,6,11,83,17,Well
17,4,208,F,13,5,9,69,-139,Severe
9,9,117,F,33,6,11,83,-34,Severe
5,7,67,M,47,8,0,96,29,Well
8,6,102,M,8,5,6,66,-36,Severe
18,7,223,F,16,5,11,71,-152,Severe
7,7,91,F,5,5,5,65,-26,Severe
11,11,143,M,11,5,8,68,-75,Severe
11,6,138,F,93,12,6,150,12,Well
15,2,182,M,94,12,7,151,-31,Severe
15,0,180,F,94,12,7,151,-29,Severe
12,10,154,F,107,13,11,167,13,Well
15,5,185,M,58,9,0,108,-77,Severe
11,1,133,M,87,11,11,143,10,Well
18,10,226,F,26,6,6,78,-148,Severe
9,11,119,F,62,9,4,112,-7,Severe
5,5,65,F,97,12,11,155,90,Well
8,0,96,M,42,7,7,91,-5,Mild
14,1,169,F,23,6,4,76,-93,Severe
15,5,185,M,9,5,7,67,-118,Severe
5,4,64,M,45,7,10,94,30,Well
14,5,173,F,59,9,1,109,-64,Severe
10,10,130,M,89,12,1,145,15,Well
18,7,223,M,19,6,1,73,-150,Severe
10,8,128,M,52,8,5,101,-27,Severe
15,11,191,F,67,9,10,118,-73,Severe
11,10,142,F,84,11,7,139,-3,Mild
18,3,219,F,109,14,1,169,-50,Severe
14,11,179,F,79,11,1,133,-46,Severe
12,2,146,M,20,6,2,74,-72,Severe
5,11,71,F,40,7,5,89,18,Well
12,2,146,M,16,5,11,71,-75,Severe
9,10,118,F,25,6,5,77,-41,Severe
7,11,95,F,17,6,0,72,-23,Severe
5,2,62,F,3,5,3,63,1,Good
12,7,151,F,29,6,8,80,-71,Severe
8,7,103,M,76,10,10,130,27,Well
10,2,122,M,81,11,4,136,14,Well
13,10,166,M,49,8,2,98,-68,Severe
6,10,82,M,96,12,10,154,72,Well
5,5,65,F,47,8,0,96,31,Well
14,8,176,F,85,11,9,141,-35,Severe
18,5,221,M,6,5,5,65,-156,Severe
10,4,124,F,100,13,3,159,35,Well
18,10,226,F,4,5,4,64,-162,Severe
10,6,126,M,31,6,9,81,-45,Severe
5,6,66,F,36,7,2,86,20,Well
11,6,138,M,108,14,0,168,30,Well
9,2,110,M,11,5,8,68,-42,Severe
16,4,196,F,58,9,0,108,-88,Severe
8,3,99,F,19,6,1,73,-26,Severe
14,5,173,F,81,11,4,136,-37,Severe
14,2,170,F,109,14,1,169,-1,Mild
13,6,162,M,57,8,10,106,-56,Severe
14,11,179,F,26,6,6,78,-101,Severe
5,9,69,F,51,8,4,100,31,Well
7,4,88,F,57,8,10,106,18,Well
17,8,212,M,43,7,8,92,-120,Severe
17,8,212,F,60,9,2,110,-102,Severe
14,8,176,M,74,10,7,127,-49,Severe
5,11,71,M,107,13,11,167,96,Well
12,8,152,F,50,8,3,99,-53,Severe
10,6,126,M,4,5,4,64,-62,Severe
9,3,111,M,34,7,0,84,-27,Severe
11,4,136,F,91,12,4,148,12,Well
10,3,123,M,106,13,10,166,43,Well
7,10,94,F,10,5,7,67,-27,Severe
16,0,192,M,30,6,9,81,-111,Severe
12,4,148,F,73,10,6,126,-22,Severe
18,2,218,F,34,7,0,84,-134,Severe
8,3,99,M,32,6,10,82,-17,Severe
10,2,122,F,29,6,8,80,-42,Severe
17,6,210,M,3,5,3,63,-147,Severe
14,4,172,M,48,8,1,97,-75,Severe
14,4,172,F,19,6,1,73,-99,Severe
11,6,138,M,109,14,1,169,31,Well
7,5,89,F,50,8,3,99,10,Well
12,11,155,F,105,13,9,165,10,Well
6,5,77,F,8,5,6,66,-11,Severe
12,3,147,F,9,5,7,67,-80,Severe
5,5,65,F,101,13,4,160,95,Well
8,3,99,F,34,7,0,84,-15,Severe
7,11,95,M,65,9,8,116,21,Well
6,6,78,F,5,5,5,65,-13,Severe
6,2,74,F,39,7,5,89,15,Well
18,6,222,F,95,12,9,153,-69,Severe
13,6,162,M,85,11,9,141,-21,Severe
8,2,98,F,62,9,4,112,14,Well
15,11,191,M,6,5,5,65,-126,Severe
9,11,119,M,30,6,9,81,-38,Severe
15,3,183,F,50,8,3,99,-84,Severe
15,0,180,F,8,5,6,66,-114,Severe
16,5,197,M,19,6,1,73,-124,Severe
6,0,72,F,17,6,0,72,0,Neutral
10,0,120,F,64,9,7,115,-5,Mild
13,8,164,F,70,10,2,122,-42,Severe
7,0,84,M,11,5,8,68,-16,Severe
6,3,75,M,93,12,6,150,75,Well
13,9,165,M,91,12,4,148,-17,Severe
9,1,109,F,18,6,1,73,-36,Severe
16,4,196,M,28,6,8,80,-116,Severe
11,6,138,M,92,12,5,149,11,Well
11,9,141,F,75,10,9,129,-12,Severe
16,5,197,F,56,8,9,105,-92,Severe
12,7,151,F,39,7,5,89,-62,Severe
5,11,71,M,34,7,0,84,13,Well
9,9,117,F,17,6,0,72,-45,Severe
10,8,128,M,37,7,3,87,-41,Severe
18,0,216,M,49,8,2,98,-118,Severe
5,8,68,F,21,6,2,74,6,Well
17,0,204,M,107,13,11,167,-37,Severe
8,11,107,F,89,12,1,145,38,Well
15,6,186,F,28,6,8,80,-106,Severe
14,1,169,F,63,9,6,114,-55,Severe
16,2,194,M,44,7,9,93,-101,Severe
5,9,69,F,25,6,5,77,8,Well
12,4,148,F,23,6,4,76,-72,Severe
6,1,73,M,82,11,5,137,64,Well
13,3,159,M,12,5,9,69,-90,Severe
14,6,174,F,92,12,5,149,-25,Severe
18,2,218,F,18,6,1,73,-145,Severe
11,11,143,M,39,7,5,89,-54,Severe
6,8,80,F,91,12,4,148,68,Well
5,10,70,F,33,6,11,83,13,Well
16,5,197,F,91,12,4,148,-49,Severe
18,11,227,F,50,8,3,99,-128,Severe
13,3,159,M,8,5,6,66,-93,Severe
5,6,66,F,101,13,4,160,94,Well
6,10,82,M,29,6,8,80,-2,Mild
17,2,206,F,23,6,4,76,-130,Severe
17,2,206,F,67,9,10,118,-88,Severe
7,3,87,F,2,5,3,63,-24,Severe
16,3,195,M,67,9,10,118,-77,Severe
13,5,161,M,88,12,0,144,-17,Severe
10,3,123,F,57,8,10,106,-17,Severe
11,6,138,F,64,9,7,115,-23,Severe
7,4,88,F,102,13,6,162,74,Well
9,9,117,F,49,8,2,98,-19,Severe
18,3,219,F,7,5,6,66,-153,Severe
11,4,136,M,73,10,6,126,-10,Severe
18,9,225,F,59,9,1,109,-116,Severe
18,3,219,M,103,13,6,162,-57,Severe
12,10,154,M,99,13,1,157,3,Good
6,0,72,F,101,13,4,160,88,Well
16,3,195,M,98,13,0,156,-39,Severe
9,4,112,F,27,6,7,79,-33,Severe
6,4,76,M,75,10,9,129,53,Well
12,0,144,F,75,10,9,129,-15,Severe
5,10,70,M,101,13,4,160,90,Well
11,3,135,F,84,11,7,139,4,Good
10,0,120,M,55,8,8,104,-16,Severe
12,10,154,F,95,12,9,153,-1,Mild
15,11,191,F,11,5,8,68,-123,Severe
15,3,183,M,30,6,9,81,-102,Severe
5,8,68,M,15,5,11,71,3,Good
7,11,95,M,69,10,1,121,26,Well
17,1,205,F,14,5,10,70,-135,Severe
15,5,185,M,13,5,9,69,-116,Severe
10,0,120,F,52,8,5,101,-19,Severe
10,5,125,M,33,6,11,83,-42,Severe
18,3,219,M,83,11,6,138,-81,Severe
18,4,220,F,27,6,7,79,-141,Severe
14,11,179,F,8,5,6,66,-113,Severe
9,11,119,F,43,7,8,92,-27,Severe
5,8,68,M,40,7,5,89,21,Well
18,8,224,F,71,10,3,123,-101,Severe
8,6,102,F,8,5,6,66,-36,Severe
10,9,129,M,83,11,6,138,9,Well
7,2,86,M,60,9,2,110,24,Well
18,9,225,M,61,9,3,111,-114,Severe
14,2,170,F,18,6,1,73,-97,Severe
15,0,180,M,26,6,6,78,-102,Severe
6,4,76,F,60,9,2,110,34,Well
8,0,96,F,71,10,3,123,27,Well
12,9,153,M,55,8,8,104,-49,Severe
15,2,182,M,93,12,6,150,-32,Severe
13,3,159,M,109,14,1,169,10,Well
7,9,93,M,92,12,5,149,56,Well
13,8,164,F,15,5,11,71,-93,Severe
15,5,185,F,97,12,11,155,-30,Severe
8,9,105,F,60,9,2,110,5,Good
6,8,80,F,10,5,7,67,-13,Severe
8,11,107,F,34,7,0,84,-23,Severe
15,4,184,F,81,11,4,136,-48,Severe
11,3,135,F,32,6,10,82,-53,Severe
16,10,202,M,77,10,11,131,-71,Severe
11,4,136,F,65,9,8,116,-20,Severe
9,1,109,F,61,9,3,111,2,Good
11,2,134,F,12,5,9,69,-65,Severe
9,9,117,F,30,6,9,81,-36,Severe
8,5,101,M,66,9,9,117,16,Well
6,3,75,F,71,10,3,123,48,Well
5,0,60,M,36,7,2,86,26,Well
12,8,152,F,62,9,4,112,-40,Severe
17,1,205,F,72,10,4,124,-81,Severe
14,11,179,F,59,9,1,109,-70,Severe
8,3,99,M,109,14,1,169,70,Well
16,10,202,F,18,6,1,73,-129,Severe
16,6,198,F,22,6,3,75,-123,Severe
6,2,74,F,104,13,7,163,89,Well
11,6,138,M,47,8,0,96,-42,Severe
5,0,60,F,3,5,3,63,3,Good
17,5,209,M,63,9,6,114,-95,Severe
5,6,66,F,79,11,1,133,67,Well
15,6,186,F,95,12,9,153,-33,Severe
16,0,192,M,44,7,9,93,-99,Severe
14,11,179,M,37,7,3,87,-92,Severe
12,9,153,F,22,6,3,75,-78,Severe
14,5,173,M,95,12,9,153,-20,Severe
5,11,71,F,93,12,6,150,79,Well
12,6,150,F,84,11,7,139,-11,Severe
10,4,124,F,19,6,1,73,-51,Severe
15,3,183,M,25,6,5,77,-106,Severe
12,3,147,F,93,12,6,150,3,Good
8,5,101,M,95,12,9,153,52,Well
15,1,181,F,47,8,0,96,-85,Severe
11,11,143,F,29,6,8,80,-63,Severe
11,11,143,M,86,11,10,142,-1,Mild
18,10,226,M,89,12,1,145,-81,Severe
7,11,95,M,36,7,2,86,-9,Severe
18,3,219,M,97,12,11,155,-64,Severe
15,8,188,F,5,5,5,65,-123,Severe
6,1,73,M,40,7,5,89,16,Well
7,3,87,F,64,9,7,115,28,Well
13,3,159,M,39,7,5,89,-70,Severe
11,9,141,F,14,5,10,70,-71,Severe
18,3,219,F,97,12,11,155,-64,Severe
11,1,133,F,33,6,11,83,-50,Severe
7,11,95,F,93,12,6,150,55,Well
16,0,192,M,102,13,6,162,-30,Severe
10,5,125,M,48,8,1,97,-28,Severe
15,2,182,F,95,12,9,153,-29,Severe
11,3,135,F,37,7,3,87,-48,Severe
8,7,103,M,87,11,11,143,40,Well
12,3,147,F,4,5,4,64,-83,Severe
9,3,111,F,106,13,10,166,55,Well
7,3,87,M,109,14,1,169,82,Well
18,5,221,M,8,5,6,66,-155,Severe
10,3,123,F,102,13,6,162,39,Well
11,4,136,M,10,5,7,67,-69,Severe
9,3,111,F,61,9,3,111,0,Neutral
18,9,225,F,12,5,9,69,-156,Severe
5,3,63,F,32,6,10,82,19,Well
13,5,161,F,70,10,2,122,-39,Severe
6,9,81,M,75,10,9,129,48,Well
18,11,227,M,36,7,2,86,-141,Severe
6,10,82,F,81,11,4,136,54,Well
18,3,219,M,23,6,4,76,-143,Severe
13,1,157,F,77,10,11,131,-26,Severe
14,1,169,M,101,13,4,160,-9,Severe
11,7,139,M,25,6,5,77,-62,Severe
9,4,112,F,25,6,5,77,-35,Severe
16,8,200,F,16,5,11,71,-129,Severe
9,11,119,F,47,8,0,96,-23,Severe
6,10,82,M,80,11,3,135,53,Well
6,0,72,F,22,6,3,75,3,Good
7,8,92,M,15,5,11,71,-21,Severe
14,10,178,M,68,10,0,120,-58,Severe
12,0,144,F,82,11,5,137,-7,Severe
17,10,214,F,31,6,9,81,-133,Severe
7,9,93,M,73,10,6,126,33,Well
17,4,208,F,33,6,11,83,-125,Severe
9,0,108,F,3,5,3,63,-45,Severe
13,10,166,M,63,9,6,114,-52,Severe
17,2,206,M,99,13,1,157,-49,Severe
17,3,207,F,39,7,5,89,-118,Severe
15,8,188,M,68,10,0,120,-68,Severe
10,2,122,F,58,9,0,108,-14,Severe
7,9,93,M,6,5,5,65,-28,Severe
5,1,61,F,69,10,1,121,60,Well
18,11,227,F,98,13,0,156,-71,Severe
13,5,161,M,52,8,5,101,-60,Severe
8,7,103,M,40,7,5,89,-14,Severe
8,6,102,F,64,9,7,115,13,Well
6,2,74,M,60,9,2,110,36,Well
8,9,105,M,108,14,0,168,63,Well
16,11,203,F,88,12,0,144,-59,Severe
5,3,63,F,109,14,1,169,106,Well
5,8,68,M,34,7,0,84,16,Well
7,1,85,M,107,13,11,167,82,Well
14,3,171,M,33,6,11,83,-88,Severe
13,11,167,F,43,7,8,92,-75,Severe
9,8,116,M,88,12,0,144,28,Well
14,9,177,M,88,12,0,144,-33,Severe
13,2,158,M,71,10,3,123,-35,Severe
8,8,104,F,65,9,8,116,12,Well
6,10,82,F,60,9,2,110,28,Well
16,0,192,F,110,14,3,171,-21,Severe
9,3,111,M,44,7,9,93,-18,Severe
18,6,222,M,35,7,1,85,-137,Severe
18,9,225,M,65,9,8,116,-109,Severe
15,3,183,M,28,6,8,80,-103,Severe
11,3,135,M,57,8,10,106,-29,Severe
17,9,213,M,60,9,2,110,-103,Severe
5,3,63,F,12,5,9,69,6,Well
8,11,107,M,5,5,5,65,-42,Severe
8,3,99,M,42,7,7,91,-8,Severe
9,10,118,F,70,10,2,122,4,Good
11,3,135,M,86,11,10,142,7,Well
11,3,135,M,49,8,2,98,-37,Severe
15,4,184,M,67,9,10,118,-66,Severe
5,4,64,M,50,8,3,99,35,Well
8,8,104,F,59,9,1,109,5,Good
14,10,178,F,89,12,1,145,-33,Severe
11,8,140,F,4,5,4,64,-76,Severe
6,2,74,F,88,12,0,144,70,Well
9,3,111,F,99,13,1,157,46,Well
11,3,135,M,85,11,9,141,6,Well
15,6,186,F,24,6,5,77,-109,Severe
15,1,181,M,56,8,9,105,-76,Severe
8,8,104,F,49,8,2,98,-6,Severe
11,0,132,M,34,7,0,84,-48,Severe
8,3,99,F,106,13,10,166,67,Well
10,9,129,F,67,9,10,118,-11,Severe
7,3,87,M,103,13,6,162,75,Well
14,0,168,F,42,7,7,91,-77,Severe
6,7,79,M,82,11,5,137,58,Well
18,3,219,F,97,12,11,155,-64,Severe
12,11,155,F,14,5,10,70,-85,Severe
17,3,207,F,77,10,11,131,-76,Severe
17,3,207,M,30,6,9,81,-126,Severe
11,0,132,M,75,10,9,129,-3,Mild
16,8,200,M,32,6,10,82,-118,Severe
9,5,113,M,107,13,11,167,54,Well
9,4,112,F,42,7,7,91,-21,Severe
13,8,164,F,25,6,5,77,-87,Severe
7,2,86,F,39,7,5,89,3,Good
13,4,160,F,14,5,10,70,-90,Severe
5,1,61,M,100,13,3,159,98,Well
13,3,159,F,38,7,4,88,-71,Severe
5,5,65,F,18,6,1,73,8,Well
14,4,172,F,29,6,8,80,-92,Severe
16,7,199,F,70,10,2,122,-77,Severe
14,11,179,F,109,14,1,169,-10,Severe
16,3,195,F,108,14,0,168,-27,Severe
9,2,110,F,69,10,1,121,11,Well
7,1,85,M,92,12,5,149,64,Well
15,3,183,M,83,11,6,138,-45,Severe
9,7,115,M,106,13,10,166,51,Well
10,3,123,F,86,11,10,142,19,Well
12,3,147,F,51,8,4,100,-47,Severe
16,4,196,M,93,12,6,150,-46,Severe
5,4,64,F,93,12,6,150,86,Well
16,7,199,F,14,5,10,70,-129,Severe
8,10,106,M,81,11,4,136,30,Well
17,6,210,F,94,12,7,151,-59,Severe
6,10,82,F,13,5,9,69,-13,Severe
8,9,105,M,102,13,6,162,57,Well
15,2,182,F,76,10,10,130,-52,Severe
9,4,112,F,109,14,1,169,57,Well
7,1,85,F,35,7,1,85,0,Neutral
11,3,135,M,40,7,5,89,-46,Severe
16,1,193,M,60,9,2,110,-83,Severe
5,7,67,F,58,9,0,108,41,Well
7,8,92,F,23,6,4,76,-16,Severe
14,11,179,M,40,7,5,89,-90,Severe
9,3,111,F,39,7,5,89,-22,Severe
8,1,97,M,77,10,11,131,34,Well
5,9,69,M,34,7,0,84,15,Well
9,10,118,F,26,6,6,78,-40,Severe
7,0,84,F,50,8,3,99,15,Well
9,1,109,F,101,13,4,160,51,Well
12,10,154,F,3,5,3,63,-91,Severe
17,10,214,F,93,12,6,150,-64,Severe
11,3,135,M,43,7,8,92,-43,Severe
8,3,99,F,23,6,4,76,-23,Severe
13,6,162,F,52,8,5,101,-61,Severe
14,6,174,M,91,12,4,148,-26,Severe
5,11,71,M,31,6,9,81,10,Well
14,3,171,M,41,7,6,90,-81,Severe
7,10,94,M,83,11,6,138,44,Well
14,11,179,M,39,7,5,89,-90,Severe
16,10,202,M,46,7,11,95,-107,Severe
10,1,121,M,42,7,7,91,-30,Severe
6,1,73,M,42,7,7,91,18,Well
14,11,179,F,24,6,5,77,-102,Severe
14,9,177,F,94,12,7,151,-26,Severe
17,7,211,F,83,11,6,138,-73,Severe
10,11,131,M,89,12,1,145,14,Well
17,2,206,F,82,11,5,137,-69,Severe
11,7,139,F,11,5,8,68,-71,Severe
15,5,185,F,110,14,3,171,-14,Severe
6,7,79,F,65,9,8,116,37,Well
5,8,68,F,8,5,6,66,-2,Mild
11,0,132,F,110,14,3,171,39,Well
13,6,162,F,74,10,7,127,-35,Severe
6,11,83,F,9,5,7,67,-16,Severe
18,8,224,M,53,8,6,102,-122,Severe
18,3,219,M,45,7,10,94,-125,Severe
9,8,116,M,107,13,11,167,51,Well
15,6,186,M,64,9,7,115,-71,Severe
7,3,87,M,78,11,0,132,45,Well
10,3,123,M,72,10,4,124,1,Good
16,6,198,M,48,8,1,97,-101,Severe
8,4,100,F,27,6,7,79,-21,Severe
15,3,183,F,73,10,6,126,-57,Severe
18,3,219,M,22,6,3,75,-144,Severe
5,9,69,F,40,7,5,89,20,Well
9,5,113,M,69,10,1,121,8,Well
10,2,122,M,35,7,1,85,-37,Severe
18,7,223,M,4,5,4,64,-159,Severe
18,7,223,F,56,8,9,105,-118,Severe
13,11,167,M,35,7,1,85,-82,Severe
11,1,133,F,37,7,3,87,-46,Severe
14,1,169,F,72,10,4,124,-45,Severe
14,3,171,F,96,12,10,154,-17,Severe
8,8,104,M,87,11,11,143,39,Well
14,3,171,F,4,5,4,64,-107,Severe
16,2,194,M,29,6,8,80,-114,Severe
18,7,223,F,58,9,0,108,-115,Severe
11,7,139,F,16,5,11,71,-68,Severe
13,9,165,M,9,5,7,67,-98,Severe
18,7,223,M,68,10,0,120,-103,Severe
16,2,194,M,61,9,3,111,-83,Severe
8,6,102,M,11,5,8,68,-34,Severe
17,5,209,F,92,12,5,149,-60,Severe
7,6,90,F,23,6,4,76,-14,Severe
16,10,202,F,10,5,7,67,-135,Severe
8,2,98,F,70,10,2,122,24,Well
5,9,69,F,80,11,3,135,66,Well
15,11,191,M,21,6,2,74,-117,Severe
11,5,137,M,81,11,4,136,-1,Mild
7,11,95,F,48,8,1,97,2,Good
11,4,136,F,106,13,10,166,30,Well
11,8,140,F,2,5,3,63,-77,Severe
13,7,163,F,11,5,8,68,-95,Severe
5,10,70,F,68,10,0,120,50,Well
12,1,145,F,75,10,9,129,-16,Severe
8,3,99,F,89,12,1,145,46,Well
12,6,150,F,57,8,10,106,-44,Severe
6,11,83,M,57,8,10,106,23,Well
12,3,147,F,14,5,10,70,-77,Severe
16,6,198,F,103,13,6,162,-36,Severe
7,10,94,M,21,6,2,74,-20,Severe
13,1,157,F,102,13,6,162,5,Good
15,11,191,F,2,5,3,63,-128,Severe
11,3,135,F,51,8,4,100,-35,Severe
13,7,163,M,8,5,6,66,-97,Severe
5,3,63,F,17,6,0,72,9,Well
11,3,135,M,99,13,1,157,22,Well
12,5,149,M,16,5,11,71,-78,Severe
6,10,82,M,40,7,5,89,7,Well
14,11,179,F,92,12,5,149,-30,Severe
17,0,204,M,95,12,9,153,-51,Severe
12,2,146,F,48,8,1,97,-49,Severe
12,10,154,M,75,10,9,129,-25,Severe
12,5,149,M,29,6,8,80,-69,Severe
14,8,176,F,66,9,9,117,-59,Severe
16,2,194,F,73,10,6,126,-68,Severe
5,2,62,F,98,13,0,156,94,Well
7,9,93,M,14,5,10,70,-23,Severe
16,2,194,F,62,9,4,112,-82,Severe
15,8,188,F,103,13,6,162,-26,Severe
15,1,181,M,96,12,10,154,-27,Severe
7,0,84,M,62,9,4,112,28,Well
8,11,107,M,93,12,6,150,43,Well
9,2,110,M,70,10,2,122,12,Well
15,6,186,M,4,5,4,64,-122,Severe
13,9,165,F,86,11,10,142,-23,Severe
14,4,172,F,99,13,1,157,-15,Severe
11,10,142,F,104,13,7,163,21,Well
7,6,90,F,5,5,5,65,-25,Severe
6,7,79,F,93,12,6,150,71,Well
12,3,147,M,32,6,10,82,-65,Severe
16,3,195,F,21,6,2,74,-121,Severe
5,2,62,F,36,7,2,86,24,Well
11,8,140,F,7,5,6,66,-74,Severe
11,10,142,M,14,5,10,70,-72,Severe
5,0,60,F,74,10,7,127,67,Well
13,0,156,M,51,8,4,100,-56,Severe
12,10,154,F,84,11,7,139,-15,Severe
10,0,120,M,29,6,8,80,-40,Severe
12,4,148,M,46,7,11,95,-53,Severe
8,0,96,M,64,9,7,115,19,Well
13,3,159,M,57,8,10,106,-53,Severe
5,9,69,M,107,13,11,167,98,Well
5,10,70,M,43,7,8,92,22,Well
17,11,215,M,41,7,6,90,-125,Severe
11,8,140,F,83,11,6,138,-2,Mild
15,10,190,M,71,10,3,123,-67,Severe
10,6,126,F,55,8,8,104,-22,Severe
16,0,192,M,79,11,1,133,-59,Severe
8,10,106,F,86,11,10,142,36,Well
14,9,177,F,87,11,11,143,-34,Severe
16,3,195,M,80,11,3,135,-60,Severe
5,10,70,M,69,10,1,121,51,Well
6,6,78,M,54,8,7,103,25,Well
9,2,110,M,8,5,6,66,-44,Severe
14,1,169,M,96,12,10,154,-15,Severe
18,5,221,F,98,13,0,156,-65,Severe
14,3,171,F,110,14,3,171,0,Neutral
16,7,199,F,105,13,9,165,-34,Severe
6,3,75,F,103,13,6,162,87,Well
18,1,217,M,93,12,6,150,-67,Severe
12,7,151,M,96,12,10,154,3,Good
9,3,111,F,66,9,9,117,6,Well
11,5,137,F,28,6,8,80,-57,Severe
6,7,79,F,11,5,8,68,-11,Severe
8,5,101,M,78,11,0,132,31,Well
7,3,87,F,19,6,1,73,-14,Severe
14,7,175,F,35,7,1,85,-90,Severe
11,2,134,M,81,11,4,136,2,Good
18,2,218,M,36,7,2,86,-132,Severe
7,0,84,F,95,12,9,153,69,Well
10,3,123,M,89,12,1,145,22,Well
16,4,196,M,83,11,6,138,-58,Severe
16,3,195,M,42,7,7,91,-104,Severe
16,3,195,M,30,6,9,81,-114,Severe
14,8,176,M,10,5,7,67,-109,Severe
11,6,138,F,6,5,5,65,-73,Severe
8,8,104,F,25,6,5,77,-27,Severe
5,2,62,F,33,6,11,83,21,Well
13,3,159,F,75,10,9,129,-30,Severe
13,7,163,F,34,7,0,84,-79,Severe
17,8,212,F,22,6,3,75,-137,Severe
13,11,167,F,94,12,7,151,-16,Severe
6,4,76,M,97,12,11,155,79,Well
18,10,226,M,108,14,0,168,-58,Severe
11,10,142,F,70,10,2,122,-20,Severe
8,7,103,F,13,5,9,69,-34,Severe
17,7,211,M,89,12,1,145,-66,Severe
16,8,200,F,75,10,9,129,-71,Severe
16,3,195,F,84,11,7,139,-56,Severe
13,10,166,M,61,9,3,111,-55,Severe
8,1,97,F,60,9,2,110,13,Well
14,6,174,M,73,10,6,126,-48,Severe
5,3,63,F,97,12,11,155,92,Well
7,2,86,F,80,11,3,135,49,Well
16,4,196,F,46,7,11,95,-101,Severe
16,2,194,M,83,11,6,138,-56,Severe
17,11,215,M,54,8,7,103,-112,Severe
17,5,209,M,33,6,11,83,-126,Severe
8,8,104,F,18,6,1,73,-31,Severe
15,7,187,F,31,6,9,81,-106,Severe
16,9,201,M,77,10,11,131,-70,Severe
14,6,174,M,37,7,3,87,-87,Severe
13,1,157,F,20,6,2,74,-83,Severe
15,7,187,F,9,5,7,67,-120,Severe
12,1,145,F,57,8,10,106,-39,Severe
7,3,87,M,109,14,1,169,82,Well
7,11,95,M,32,6,10,82,-13,Severe
18,3,219,F,38,7,4,88,-131,Severe
6,10,82,F,11,5,8,68,-14,Severe
11,3,135,F,92,12,5,149,14,Well
7,8,92,F,91,12,4,148,56,Well
9,6,114,F,74,10,7,127,13,Well
11,11,143,M,27,6,7,79,-64,Severe
5,10,70,M,36,7,2,86,16,Well
12,11,155,F,74,10,7,127,-28,Severe
11,0,132,F,102,13,6,162,30,Well
5,1,61,M,107,13,11,167,106,Well
11,5,137,F,39,7,5,89,-48,Severe
7,7,91,M,9,5,7,67,-24,Severe
5,11,71,M,38,7,4,88,17,Well
8,10,106,F,56,8,9,105,-1,Mild
13,3,159,F,108,14,0,168,9,Well
14,9,177,F,21,6,2,74,-103,Severe
16,5,197,F,101,13,4,160,-37,Severe
9,4,112,M,7,5,6,66,-46,Severe
5,1,61,M,62,9,4,112,51,Well
18,2,218,F,48,8,1,97,-121,Severe
5,2,62,M,32,6,10,82,20,Well
9,1,109,M,38,7,4,88,-21,Severe
8,10,106,F,94,12,7,151,45,Well
8,11,107,M,23,6,4,76,-31,Severe
8,9,105,F,58,9,0,108,3,Good
15,7,187,M,110,14,3,171,-16,Severe
6,6,78,M,96,12,10,154,76,Well
11,3,135,F,20,6,2,74,-61,Severe
9,4,112,F,34,7,0,84,-28,Severe
9,3,111,F,53,8,6,102,-9,Severe
9,8,116,F,28,6,8,80,-36,Severe
15,9,189,F,66,9,9,117,-72,Severe
13,9,165,F,23,6,4,76,-89,Severe
17,2,206,M,51,8,4,100,-106,Severe
16,2,194,M,45,7,10,94,-100,Severe
18,11,227,M,82,11,5,137,-90,Severe
13,2,158,F,32,6,10,82,-76,Severe
5,7,67,M,57,8,10,106,39,Well
15,6,186,F,8,5,6,66,-120,Severe
13,3,159,M,18,6,1,73,-86,Severe
12,7,151,M,91,12,4,148,-3,Mild
7,4,88,F,59,9,1,109,21,Well
16,9,201,M,86,11,10,142,-59,Severe
17,3,207,M,67,9,10,118,-89,Severe
16,3,195,F,100,13,3,159,-36,Severe
8,3,99,M,62,9,4,112,13,Well
12,10,154,F,50,8,3,99,-55,Severe
10,8,128,F,34,7,0,84,-44,Severe
8,10,106,M,10,5,7,67,-39,Severe
8,2,98,M,5,5,5,65,-33,Severe
11,4,136,F,36,7,2,86,-50,Severe
16,3,195,F,25,6,5,77,-118,Severe
6,9,81,F,24,6,5,77,-4,Mild
14,3,171,M,55,8,8,104,-67,Severe
14,3,171,F,65,9,8,116,-55,Severe
5,3,63,M,8,5,6,66,3,Good
8,3,99,F,53,8,6,102,3,Good
15,5,185,M,64,9,7,115,-70,Severe
17,8,212,M,51,8,4,100,-112,Severe
5,2,62,M,21,6,2,74,12,Well
18,4,220,M,55,8,8,104,-116,Severe
6,3,75,F,6,5,5,65,-10,Severe
7,6,90,M,14,5,10,70,-20,Severe
5,11,71,M,103,13,6,162,91,Well
7,5,89,F,110,14,3,171,82,Well
18,11,227,M,66,9,9,117,-110,Severe
5,10,70,F,29,6,8,80,10,Well
13,3,159,F,9,5,7,67,-92,Severe
5,7,67,M,5,5,5,65,-2,Mild
9,9,117,F,24,6,5,77,-40,Severe
12,1,145,F,18,6,1,73,-72,Severe
15,8,188,F,97,12,11,155,-33,Severe
11,10,142,F,10,5,7,67,-75,Severe
17,5,209,M,20,6,2,74,-135,Severe
17,6,210,M,51,8,4,100,-110,Severe
6,8,80,F,43,7,8,92,12,Well
13,2,158,M,93,12,6,150,-8,Severe
12,10,154,M,8,5,6,66,-88,Severe
16,3,195,F,66,9,9,117,-78,Severe
18,0,216,F,106,13,10,166,-50,Severe
11,3,135,F,11,5,8,68,-67,Severe
13,9,165,F,5,5,5,65,-100,Severe
17,10,214,M,29,6,8,80,-134,Severe
17,2,206,M,9,5,7,67,-139,Severe
13,4,160,F,20,6,2,74,-86,Severe
5,11,71,M,105,13,9,165,94,Well
18,11,227,F,90,12,3,147,-80,Severe
8,2,98,M,94,12,7,151,53,Well
10,6,126,F,81,11,4,136,10,Well
13,0,156,F,107,13,11,167,11,Well
6,9,81,F,26,6,6,78,-3,Mild
11,6,138,F,24,6,5,77,-61,Severe
6,5,77,F,46,7,11,95,18,Well
10,5,125,M,39,7,5,89,-36,Severe
8,10,106,M,22,6,3,75,-31,Severe
16,2,194,F,89,12,1,145,-49,Severe
15,4,184,M,20,6,2,74,-110,Severe
14,2,170,M,10,5,7,67,-103,Severe
12,8,152,M,36,7,2,86,-66,Severe
13,3,159,F,88,12,0,144,-15,Severe
14,1,169,F,21,6,2,74,-95,Severe
10,6,126,F,33,6,11,83,-43,Severe
9,7,115,F,77,10,11,131,16,Well
13,1,157,F,54,8,7,103,-54,Severe
17,0,204,M,26,6,6,78,-126,Severe
15,2,182,M,23,6,4,76,-106,Severe
15,9,189,M,29,6,8,80,-109,Severe
10,8,128,M,46,7,11,95,-33,Severe
10,8,128,M,8,5,6,66,-62,Severe
16,0,192,M,6,5,5,65,-127,Severe
17,1,205,F,19,6,1,73,-132,Severe
9,3,111,F,37,7,3,87,-24,Severe
6,9,81,M,73,10,6,126,45,Well
15,4,184,F,110,14,3,171,-13,Severe
11,3,135,F,80,11,3,135,0,Neutral
10,9,129,M,28,6,8,80,-49,Severe
18,11,227,F,93,12,6,150,-77,Severe
9,11,119,F,66,9,9,117,-2,Mild
7,11,95,M,51,8,4,100,5,Good
14,10,178,F,87,11,11,143,-35,Severe
7,4,88,M,43,7,8,92,4,Good
14,9,177,F,109,14,1,169,-8,Severe
9,5,113,F,76,10,10,130,17,Well
6,6,78,F,84,11,7,139,61,Well
11,1,133,F,52,8,5,101,-32,Severe
13,6,162,F,76,10,10,130,-32,Severe
12,7,151,F,18,6,1,73,-78,Severe
18,10,226,M,20,6,2,74,-152,Severe
14,2,170,F,36,7,2,86,-84,Severe
6,3,75,M,47,8,0,96,21,Well
8,5,101,M,87,11,11,143,42,Well
7,0,84,M,44,7,9,93,9,Well
7,10,94,F,79,11,1,133,39,Well
14,1,169,F,100,13,3,159,-10,Severe
14,0,168,F,74,10,7,127,-41,Severe
11,5,137,M,27,6,7,79,-58,Severe
6,6,78,M,14,5,10,70,-8,Severe
7,1,85,M,93,12,6,150,65,Well
9,10,118,F,41,7,6,90,-28,Severe
8,0,96,M,71,10,3,123,27,Well
14,7,175,F,23,6,4,76,-99,Severe
5,5,65,F,71,10,3,123,58,Well
7,7,91,M,5,5,5,65,-26,Severe
12,6,150,F,85,11,9,141,-9,Severe
7,1,85,F,91,12,4,148,63,Well
15,5,185,F,27,6,7,79,-106,Severe
14,3,171,M,80,11,3,135,-36,Severe
12,1,145,F,94,12,7,151,6,Well
17,3,207,M,91,12,4,148,-59,Severe
15,7,187,M,38,7,4,88,-99,Severe
7,11,95,F,43,7,8,92,-3,Mild
12,10,154,M,56,8,9,105,-49,Severe
6,3,75,M,95,12,9,153,78,Well
12,6,150,M,76,10,10,130,-20,Severe
11,7,139,M,17,6,0,72,-67,Severe
16,11,203,M,110,14,3,171,-32,Severe
12,7,151,M,92,12,5,149,-2,Mild
15,4,184,F,32,6,10,82,-102,Severe
15,9,189,M,23,6,4,76,-113,Severe
14,6,174,F,2,5,3,63,-111,Severe
14,8,176,M,96,12,10,154,-22,Severe
13,11,167,F,20,6,2,74,-93,Severe
12,0,144,M,41,7,6,90,-54,Severe
6,0,72,F,55,8,8,104,32,Well
18,3,219,M,3,5,3,63,-156,Severe
15,9,189,F,34,7,0,84,-105,Severe
16,9,201,F,84,11,7,139,-62,Severe
17,5,209,M,96,12,10,154,-55,Severe
18,0,216,F,61,9,3,111,-105,Severe
7,9,93,M,20,6,2,74,-19,Severe
7,8,92,M,66,9,9,117,25,Well
11,5,137,F,48,8,1,97,-40,Severe
5,10,70,F,91,12,4,148,78,Well
7,11,95,M,93,12,6,150,55,Well
15,5,185,M,99,13,1,157,-28,Severe
12,7,151,F,88,12,0,144,-7,Severe
12,11,155,M,7,5,6,66,-89,Severe
14,11,179,M,29,6,8,80,-99,Severe
15,1,181,M,10,5,7,67,-114,Severe
7,1,85,M,106,13,10,166,81,Well
10,6,126,F,48,8,1,97,-29,Severe
7,8,92,M,67,9,10,118,26,Well
17,3,207,F,63,9,6,114,-93,Severe
12,3,147,M,101,13,4,160,13,Well
8,9,105,F,27,6,7,79,-26,Severe
12,7,151,F,64,9,7,115,-36,Severe
5,0,60,M,30,6,9,81,21,Well
12,11,155,F,100,13,3,159,4,Good
18,11,227,M,26,6,6,78,-149,Severe
7,2,86,M,20,6,2,74,-12,Severe
10,4,124,F,71,10,3,123,-1,Mild
9,1,109,F,85,11,9,141,32,Well
10,8,128,F,58,9,0,108,-20,Severe
14,5,173,M,69,10,1,121,-52,Severe
16,10,202,F,23,6,4,76,-126,Severe
12,8,152,M,83,11,6,138,-14,Severe
16,4,196,M,46,7,11,95,-101,Severe
8,7,103,F,55,8,8,104,1,Good
8,9,105,F,66,9,9,117,12,Well
5,0,60,F,83,11,6,138,78,Well
9,3,111,F,103,13,6,162,51,Well
9,8,116,F,76,10,10,130,14,Well
5,5,65,F,56,8,9,105,40,Well
10,0,120,M,4,5,4,64,-56,Severe
12,10,154,M,82,11,5,137,-17,Severe
11,2,134,M,16,5,11,71,-63,Severe
17,3,207,F,88,12,0,144,-63,Severe
18,3,219,M,86,11,10,142,-77,Severe
8,9,105,M,92,12,5,149,44,Well
9,8,116,F,101,13,4,160,44,Well
14,3,171,M,89,12,1,145,-26,Severe
11,5,137,M,69,10,1,121,-16,Severe
17,3,207,M,82,11,5,137,-70,Severe
11,6,138,M,6,5,5,65,-73,Severe
17,3,207,M,42,7,7,91,-116,Severe
7,6,90,M,97,12,11,155,65,Well
6,1,73,M,73,10,6,126,53,Well
6,1,73,M,89,12,1,145,72,Well
12,0,144,F,98,13,0,156,12,Well
8,4,100,F,4,5,4,64,-36,Severe
18,9,225,F,36,7,2,86,-139,Severe
9,3,111,F,97,12,11,155,44,Well
7,5,89,F,96,12,10,154,65,Well
9,10,118,F,45,7,10,94,-24,Severe
12,3,147,F,78,11,0,132,-15,Severe
9,11,119,M,66,9,9,117,-2,Mild
18,3,219,F,95,12,9,153,-66,Severe
7,8,92,F,82,11,5,137,45,Well
7,2,86,F,51,8,4,100,14,Well
17,3,207,M,17,6,0,72,-135,Severe
15,11,191,M,42,7,7,91,-100,Severe
7,3,87,F,2,5,3,63,-24,Severe
14,6,174,F,55,8,8,104,-70,Severe
13,2,158,F,33,6,11,83,-75,Severe
15,8,188,F,46,7,11,95,-93,Severe
6,6,78,F,37,7,3,87,9,Well
14,0,168,M,84,11,7,139,-29,Severe
10,5,125,M,93,12,6,150,25,Well
9,7,115,M,91,12,4,148,33,Well
9,2,110,M,54,8,7,103,-7,Severe
7,7,91,F,74,10,7,127,36,Well
14,2,170,F,91,12,4,148,-22,Severe
17,0,204,M,77,10,11,131,-73,Severe
15,11,191,M,23,6,4,76,-115,Severe
18,10,226,M,27,6,7,79,-147,Severe
10,10,130,M,22,6,3,75,-55,Severe
5,0,60,F,55,8,8,104,44,Well
8,7,103,F,88,12,0,144,41,Well
7,9,93,F,67,9,10,118,25,Well
12,3,147,F,90,12,3,147,0,Neutral
12,7,151,M,14,5,10,70,-81,Severe
18,3,219,M,108,14,0,168,-51,Severe
11,0,132,F,32,6,10,82,-50,Severe
13,5,161,F,87,11,11,143,-18,Severe
13,4,160,F,108,14,0,168,8,Well
18,6,222,M,4,5,4,64,-158,Severe
14,5,173,F,63,9,6,114,-59,Severe
17,5,209,M,15,5,11,71,-138,Severe
13,11,167,F,84,11,7,139,-28,Severe
10,7,127,F,80,11,3,135,8,Well
15,5,185,F,14,5,10,70,-115,Severe
18,2,218,F,69,10,1,121,-97,Severe
13,2,158,F,78,11,0,132,-26,Severe
5,5,65,F,61,9,3,111,46,Well
17,4,208,M,63,9,6,114,-94,Severe
16,3,195,M,97,12,11,155,-40,Severe
13,3,159,M,72,10,4,124,-35,Severe
9,0,108,F,7,5,6,66,-42,Severe
16,1,193,M,63,9,6,114,-79,Severe
13,4,160,F,16,5,11,71,-89,Severe
9,5,113,M,25,6,5,77,-36,Severe
9,8,116,F,37,7,3,87,-29,Severe
7,6,90,M,37,7,3,87,-3,Mild
7,7,91,M,13,5,9,69,-22,Severe
8,8,104,F,103,13,6,162,58,Well
9,9,117,M,95,12,9,153,36,Well
8,11,107,F,75,10,9,129,22,Well
11,1,133,M,95,12,9,153,20,Well
14,3,171,F,22,6,3,75,-96,Severe
18,2,218,M,78,11,0,132,-86,Severe
9,3,111,M,107,13,11,167,56,Well
8,10,106,F,71,10,3,123,17,Well
15,9,189,F,79,11,1,133,-56,Severe
10,3,123,M,27,6,7,79,-44,Severe
18,3,219,F,108,14,0,168,-51,Severe
8,6,102,M,82,11,5,137,35,Well
15,11,191,F,29,6,8,80,-111,Severe
7,0,84,M,23,6,4,76,-8,Severe
10,10,130,M,109,14,1,169,39,Well
5,8,68,M,30,6,9,81,13,Well
12,0,144,M,13,5,9,69,-75,Severe
7,10,94,F,101,13,4,160,66,Well
16,3,195,M,75,10,9,129,-66,Severe
17,5,209,F,26,6,6,78,-131,Severe
10,1,121,M,39,7,5,89,-32,Severe
10,4,124,F,12,5,9,69,-55,Severe
16,2,194,M,87,11,11,143,-51,Severe
11,4,136,M,77,10,11,131,-5,Mild
8,6,102,F,69,10,1,121,19,Well
6,10,82,M,83,11,6,138,56,Well
9,6,114,M,67,9,10,118,4,Good
14,2,170,M,55,8,8,104,-66,Severe
7,8,92,M,77,10,11,131,39,Well
15,5,185,M,21,6,2,74,-111,Severe
7,11,95,M,42,7,7,91,-4,Mild
17,10,214,F,57,8,10,106,-108,Severe
15,2,182,M,109,14,1,169,-13,Severe
18,8,224,F,13,5,9,69,-155,Severe
8,4,100,M,91,12,4,148,48,Well
5,2,62,M,43,7,8,92,30,Well
9,8,116,M,57,8,10,106,-10,Severe
14,8,176,M,110,14,3,171,-5,Mild
5,10,70,M,68,10,0,120,50,Well
13,6,162,M,89,12,1,145,-17,Severe
12,1,145,M,15,5,11,71,-74,Severe
18,5,221,M,91,12,4,148,-73,Severe
6,1,73,M,17,6,0,72,-1,Mild
14,3,171,F,90,12,3,147,-24,Severe
5,5,65,F,7,5,6,66,1,Good
10,4,124,M,95,12,9,153,29,Well
10,9,129,M,34,7,0,84,-45,Severe
18,3,219,M,62,9,4,112,-107,Severe
16,8,200,M,49,8,2,98,-102,Severe
8,6,102,F,98,13,0,156,54,Well
14,7,175,F,57,8,10,106,-69,Severe
12,6,150,F,14,5,10,70,-80,Severe
17,11,215,M,43,7,8,92,-123,Severe
18,5,221,F,15,5,11,71,-150,Severe
10,3,123,F,58,9,0,108,-15,Severe
18,1,217,F,96,12,10,154,-63,Severe
16,7,199,F,24,6,5,77,-122,Severe
13,4,160,M,57,8,10,106,-54,Severe
16,11,203,M,49,8,2,98,-105,Severe
5,2,62,F,91,12,4,148,86,Well
5,5,65,M,85,11,9,141,76,Well
8,3,99,F,79,11,1,133,34,Well
15,4,184,M,102,13,6,162,-22,Severe
18,2,218,M,93,12,6,150,-68,Severe
14,4,172,M,2,5,3,63,-109,Severe
6,6,78,M,77,10,11,131,53,Well
15,8,188,F,68,10,0,120,-68,Severe
14,5,173,F,58,9,0,108,-65,Severe
17,11,215,F,64,9,7,115,-100,Severe
14,3,171,M,38,7,4,88,-83,Severe
6,2,74,M,91,12,4,148,74,Well
17,0,204,F,5,5,5,65,-139,Severe
6,9,81,F,50,8,3,99,18,Well
15,6,186,M,65,9,8,116,-70,Severe
18,1,217,F,37,7,3,87,-130,Severe
12,10,154,M,54,8,7,103,-51,Severe
16,4,196,M,34,7,0,84,-112,Severe
7,3,87,F,9,5,7,67,-20,Severe
16,10,202,M,109,14,1,169,-33,Severe
9,4,112,F,9,5,7,67,-45,Severe
16,11,203,M,90,12,3,147,-56,Severe
12,3,147,F,11,5,8,68,-79,Severe
9,7,115,F,41,7,6,90,-25,Severe
13,7,163,F,60,9,2,110,-53,Severe
13,3,159,F,60,9,2,110,-49,Severe
8,1,97,F,32,6,10,82,-15,Severe
17,10,214,F,59,9,1,109,-105,Severe
17,2,206,M,2,5,3,63,-143,Severe
17,1,205,M,93,12,6,150,-55,Severe
16,10,202,M,57,8,10,106,-96,Severe
7,6,90,M,81,11,4,136,46,Well
14,8,176,F,102,13,6,162,-14,Severe
18,4,220,M,29,6,8,80,-140,Severe
5,2,62,M,49,8,2,98,36,Well
12,2,146,M,67,9,10,118,-28,Severe
16,6,198,M,97,12,11,155,-43,Severe
16,11,203,M,14,5,10,70,-133,Severe
8,9,105,F,86,11,10,142,37,Well
10,1,121,F,57,8,10,106,-15,Severe
8,3,99,F,87,11,11,143,44,Well
15,1,181,M,19,6,1,73,-108,Severe
12,3,147,F,65,9,8,116,-31,Severe
17,4,208,F,97,12,11,155,-53,Severe
15,4,184,M,76,10,10,130,-54,Severe
12,4,148,F,32,6,10,82,-66,Severe
18,2,218,F,106,13,10,166,-52,Severe
18,7,223,F,5,5,5,65,-158,Severe
7,4,88,M,10,5,7,67,-21,Severe
9,2,110,F,102,13,6,162,52,Well
11,4,136,M,12,5,9,69,-67,Severe
15,8,188,M,54,8,7,103,-85,Severe
11,4,136,M,13,5,9,69,-67,Severe
16,4,196,F,36,7,2,86,-110,Severe
5,4,64,F,72,10,4,124,60,Well
17,0,204,M,59,9,1,109,-95,Severe
8,8,104,F,47,8,0,96,-8,Severe
18,9,225,F,110,14,3,171,-54,Severe
18,0,216,F,78,11,0,132,-84,Severe
14,6,174,M,15,5,11,71,-103,Severe
6,1,73,M,53,8,6,102,29,Well
12,8,152,M,84,11,7,139,-13,Severe
9,0,108,F,110,14,3,171,63,Well
11,0,132,M,15,5,11,71,-61,Severe
14,9,177,F,43,7,8,92,-85,Severe
17,6,210,M,27,6,7,79,-131,Severe
13,4,160,M,2,5,3,63,-97,Severe
5,8,68,F,95,12,9,153,85,Well
6,3,75,M,42,7,7,91,16,Well
5,3,63,M,51,8,4,100,37,Well
17,10,214,F,60,9,2,110,-104,Severe
6,7,79,M,87,11,11,143,64,Well
12,4,148,M,108,14,0,168,20,Well
17,0,204,F,69,10,1,121,-83,Severe
10,3,123,F,78,11,0,132,9,Well
16,7,199,M,63,9,6,114,-85,Severe
5,6,66,F,10,5,7,67,1,Good
12,6,150,F,4,5,4,64,-86,Severe
5,1,61,M,58,9,0,108,47,Well
18,4,220,M,31,6,9,81,-139,Severe
15,10,190,M,16,5,11,71,-119,Severe
5,3,63,F,25,6,5,77,14,Well
8,2,98,F,55,8,8,104,6,Well
16,4,196,M,54,8,7,103,-93,Severe
18,5,221,F,75,10,9,129,-92,Severe
8,10,106,M,41,7,6,90,-16,Severe
10,0,120,F,19,6,1,73,-47,Severe
17,9,213,F,6,5,5,65,-148,Severe
15,3,183,M,2,5,3,63,-120,Severe
12,9,153,F,107,13,11,167,14,Well
16,3,195,F,55,8,8,104,-91,Severe
14,6,174,M,33,6,11,83,-91,Severe
6,9,81,M,27,6,7,79,-2,Mild
6,3,75,F,28,6,8,80,5,Good
18,5,221,M,38,7,4,88,-133,Severe
5,2,62,M,9,5,7,67,5,Good
9,10,118,F,76,10,10,130,12,Well
5,5,65,M,34,7,0,84,19,Well
16,1,193,F,103,13,6,162,-31,Severe
9,0,108,M,20,6,2,74,-34,Severe
15,4,184,M,54,8,7,103,-81,Severe
10,4,124,F,89,12,1,145,21,Well
10,1,121,F,103,13,6,162,41,Well
11,0,132,M,108,14,0,168,36,Well
15,9,189,M,68,10,0,120,-69,Severe
18,3,219,F,11,5,8,68,-151,Severe
8,6,102,M,73,10,6,126,24,Well
10,2,122,M,99,13,1,157,35,Well
7,7,91,F,88,12,0,144,53,Well
8,10,106,M,103,13,6,162,56,Well
13,0,156,F,93,12,6,150,-6,Severe
17,9,213,M,30,6,9,81,-132,Severe
10,11,131,M,81,11,4,136,5,Good
18,8,224,M,29,6,8,80,-144,Severe
12,3,147,F,109,14,1,169,22,Well
6,9,81,F,14,5,10,70,-11,Severe
17,0,204,M,100,13,3,159,-45,Severe
13,3,159,F,75,10,9,129,-30,Severe
18,4,220,M,7,5,6,66,-154,Severe
10,8,128,M,94,12,7,151,23,Well
7,2,86,M,16,5,11,71,-15,Severe
18,4,220,F,15,5,11,71,-149,Severe
17,3,207,M,93,12,6,150,-57,Severe
10,8,128,F,6,5,5,65,-63,Severe
18,6,222,M,94,12,7,151,-71,Severe
9,0,108,M,103,13,6,162,54,Well
16,5,197,M,41,7,6,90,-107,Severe
6,11,83,M,53,8,6,102,19,Well
12,11,155,F,80,11,3,135,-20,Severe
5,6,66,M,88,12,0,144,78,Well
10,10,130,F,40,7,5,89,-41,Severe
12,2,146,M,38,7,4,88,-58,Severe
7,10,94,F,2,5,3,63,-31,Severe
7,7,91,M,41,7,6,90,-1,Mild
8,8,104,M,44,7,9,93,-11,Severe
17,0,204,F,52,8,5,101,-103,Severe
12,3,147,M,86,11,10,142,-5,Mild
15,5,185,F,10,5,7,67,-118,Severe
11,4,136,M,70,10,2,122,-14,Severe
9,11,119,F,45,7,10,94,-25,Severe
11,8,140,M,56,8,9,105,-35,Severe
8,10,106,F,110,14,3,171,65,Well
12,3,147,F,66,9,9,117,-30,Severe
17,3,207,M,66,9,9,117,-90,Severe
7,1,85,M,110,14,3,171,86,Well
12,9,153,M,7,5,6,66,-87,Severe
14,10,178,M,6,5,5,65,-113,Severe
6,7,79,M,84,11,7,139,60,Well
5,10,70,F,42,7,7,91,21,Well
13,7,163,M,107,13,11,167,4,Good
14,9,177,M,44,7,9,93,-84,Severe
14,8,176,F,105,13,9,165,-11,Severe
14,6,174,F,68,10,0,120,-54,Severe
5,9,69,F,86,11,10,142,73,Well
7,1,85,F,26,6,6,78,-7,Severe
11,3,135,M,27,6,7,79,-56,Severe
8,7,103,F,18,6,1,73,-30,Severe
13,3,159,F,4,5,4,64,-95,Severe
15,3,183,F,31,6,9,81,-102,Severe
16,9,201,F,32,6,10,82,-119,Severe
10,2,122,F,93,12,6,150,28,Well
15,10,190,F,97,12,11,155,-35,Severe
7,2,86,M,90,12,3,147,61,Well
13,5,161,M,65,9,8,116,-45,Severe
6,2,74,M,6,5,5,65,-9,Severe
17,5,209,F,63,9,6,114,-95,Severe
8,2,98,M,60,9,2,110,12,Well
13,4,160,M,20,6,2,74,-86,Severe
10,9,129,M,98,13,0,156,27,Well
17,1,205,M,41,7,6,90,-115,Severe
8,8,104,M,40,7,5,89,-15,Severe
15,8,188,M,65,9,8,116,-72,Severe
16,3,195,M,89,12,1,145,-50,Severe
12,8,152,M,92,12,5,149,-3,Mild
9,8,116,F,81,11,4,136,20,Well
8,1,97,M,21,6,2,74,-23,Severe
17,4,208,F,107,13,11,167,-41,Severe
13,6,162,F,38,7,4,88,-74,Severe
7,7,91,M,66,9,9,117,26,Well
13,10,166,F,77,10,11,131,-35,Severe
10,3,123,M,24,6,5,77,-46,Severe
15,8,188,M,36,7,2,86,-102,Severe
7,8,92,F,22,6,3,75,-17,Severe
6,5,77,M,106,13,10,166,89,Well
11,11,143,M,45,7,10,94,-49,Severe
16,3,195,M,102,13,6,162,-33,Severe
14,7,175,F,44,7,9,93,-82,Severe
18,5,221,M,28,6,8,80,-141,Severe
12,9,153,M,10,5,7,67,-86,Severe
12,5,149,F,13,5,9,69,-80,Severe
7,11,95,F,31,6,9,81,-14,Severe
17,2,206,F,6,5,5,65,-141,Severe
16,8,200,M,95,12,9,153,-47,Severe
15,10,190,F,102,13,6,162,-28,Severe
15,3,183,F,36,7,2,86,-97,Severe
16,7,199,F,46,7,11,95,-104,Severe
7,11,95,F,45,7,10,94,-1,Mild
7,11,95,M,105,13,9,165,70,Well
13,10,166,M,40,7,5,89,-77,Severe
10,4,124,F,93,12,6,150,26,Well
8,8,104,F,26,6,6,78,-26,Severe
13,6,162,F,43,7,8,92,-70,Severe
17,7,211,M,41,7,6,90,-121,Severe
11,9,141,M,98,13,0,156,15,Well
9,8,116,F,36,7,2,86,-30,Severe
9,8,116,M,82,11,5,137,21,Well
14,2,170,M,9,5,7,67,-103,Severe
17,5,209,M,13,5,9,69,-140,Severe
9,6,114,M,33,6,11,83,-31,Severe
10,0,120,F,100,13,3,159,39,Well
9,6,114,F,71,10,3,123,9,Well
14,9,177,M,96,12,10,154,-23,Severe
6,10,82,F,46,7,11,95,13,Well
17,3,207,M,57,8,10,106,-101,Severe
18,7,223,F,25,6,5,77,-146,Severe
5,9,69,F,68,10,0,120,51,Well
14,5,173,M,108,14,0,168,-5,Mild
9,10,118,F,53,8,6,102,-16,Severe
18,9,225,F,13,5,9,69,-156,Severe
17,9,213,F,25,6,5,77,-136,Severe
10,8,128,M,84,11,7,139,11,Well
16,7,199,M,60,9,2,110,-89,Severe
15,5,185,M,61,9,3,111,-74,Severe
17,3,207,F,7,5,6,66,-141,Severe
15,6,186,F,60,9,2,110,-76,Severe
18,8,224,M,23,6,4,76,-148,Severe
10,5,125,M,8,5,6,66,-59,Severe
6,7,79,M,26,6,6,78,-1,Mild
6,3,75,M,51,8,4,100,25,Well
9,6,114,M,27,6,7,79,-35,Severe
14,3,171,F,30,6,9,81,-90,Severe
17,5,209,F,71,10,3,123,-86,Severe
18,8,224,F,23,6,4,76,-148,Severe
11,7,139,M,51,8,4,100,-39,Severe
18,0,216,F,42,7,7,91,-125,Severe
16,5,197,F,20,6,2,74,-123,Severe
18,7,223,M,17,6,0,72,-151,Severe
6,2,74,M,61,9,3,111,37,Well
10,0,120,F,83,11,6,138,18,Well
18,11,227,F,6,5,5,65,-162,Severe
7,11,95,M,98,13,0,156,61,Well
14,3,171,F,87,11,11,143,-28,Severe
5,4,64,M,73,10,6,126,62,Well
9,1,109,F,10,5,7,67,-42,Severe
9,3,111,F,54,8,7,103,-8,Severe
10,5,125,F,99,13,1,157,32,Well
11,6,138,M,33,6,11,83,-55,Severe
13,8,164,M,72,10,4,124,-40,Severe
10,10,130,F,91,12,4,148,18,Well
6,6,78,M,93,12,6,150,72,Well
15,5,185,F,56,8,9,105,-80,Severe
13,6,162,M,31,6,9,81,-81,Severe
12,3,147,M,69,10,1,121,-26,Severe
6,8,80,F,46,7,11,95,15,Well
16,4,196,F,35,7,1,85,-111,Severe
8,7,103,F,48,8,1,97,-6,Severe
7,3,87,F,90,12,3,147,60,Well
6,3,75,M,32,6,10,82,7,Well
5,8,68,M,18,6,1,73,5,Good
8,9,105,F,35,7,1,85,-20,Severe
12,5,149,F,19,6,1,73,-76,Severe
18,1,217,F,18,6,1,73,-144,Severe
6,5,77,F,47,8,0,96,19,Well
14,4,172,M,73,10,6,126,-46,Severe
13,1,157,M,34,7,0,84,-73,Severe
7,8,92,F,101,13,4,160,68,Well
9,2,110,M,66,9,9,117,7,Well
14,7,175,F,26,6,6,78,-97,Severe
6,4,76,M,11,5,8,68,-8,Severe
13,9,165,F,70,10,2,122,-43,Severe
8,3,99,F,107,13,11,167,68,Well
17,11,215,F,78,11,0,132,-83,Severe
10,2,122,F,33,6,11,83,-39,Severe
18,3,219,F,84,11,7,139,-80,Severe
14,8,176,F,84,11,7,139,-37,Severe
11,8,140,M,72,10,4,124,-16,Severe
16,11,203,M,81,11,4,136,-67,Severe
7,3,87,M,72,10,4,124,37,Well
11,3,135,F,60,9,2,110,-25,Severe
11,7,139,F,68,10,0,120,-19,Severe
18,7,223,F,15,5,11,71,-152,Severe
11,10,142,M,42,7,7,91,-51,Severe
12,1,145,F,31,6,9,81,-64,Severe
17,9,213,F,56,8,9,105,-108,Severe
17,3,207,M,104,13,7,163,-44,Severe
5,2,62,M,97,12,11,155,93,Well
7,10,94,F,76,10,10,130,36,Well
9,9,117,M,43,7,8,92,-25,Severe
9,11,119,M,108,14,0,168,49,Well
5,5,65,M,106,13,10,166,101,Well
10,10,130,M,28,6,8,80,-50,Severe
8,11,107,M,43,7,8,92,-15,Severe
14,7,175,F,22,6,3,75,-100,Severe
8,1,97,F,104,13,7,163,66,Well
5,3,63,M,46,7,11,95,32,Well
13,6,162,F,62,9,4,112,-50,Severe
7,8,92,M,95,12,9,153,61,Well
6,3,75,M,57,8,10,106,31,Well
8,11,107,F,2,5,3,63,-44,Severe
7,0,84,F,21,6,2,74,-10,Severe
7,3,87,F,50,8,3,99,12,Well
15,2,182,F,91,12,4,148,-34,Severe
8,5,101,M,84,11,7,139,38,Well
12,11,155,M,6,5,5,65,-90,Severe
9,2,110,F,74,10,7,127,17,Well
15,11,191,M,47,8,0,96,-95,Severe
18,5,221,F,39,7,5,89,-132,Severe
10,10,130,F,8,5,6,66,-64,Severe
11,8,140,M,23,6,4,76,-64,Severe
15,9,189,M,107,13,11,167,-22,Severe
10,3,123,M,22,6,3,75,-48,Severe
5,3,63,F,95,12,9,153,90,Well
18,0,216,F,57,8,10,106,-110,Severe
7,1,85,M,61,9,3,111,26,Well
7,6,90,F,38,7,4,88,-2,Mild
11,2,134,M,65,9,8,116,-18,Severe
9,5,113,M,13,5,9,69,-44,Severe
18,3,219,M,53,8,6,102,-117,Severe
15,2,182,M,85,11,9,141,-41,Severe
12,6,150,F,52,8,5,101,-49,Severe
6,8,80,M,2,5,3,63,-17,Severe
17,11,215,M,101,13,4,160,-55,Severe
14,4,172,M,28,6,8,80,-92,Severe
5,3,63,M,95,12,9,153,90,Well
12,1,145,M,16,5,11,71,-74,Severe
16,9,201,F,93,12,6,150,-51,Severe
9,4,112,F,20,6,2,74,-38,Severe
16,10,202,F,20,6,2,74,-128,Severe
6,6,78,M,6,5,5,65,-13,Severe
12,10,154,F,57,8,10,106,-48,Severe
16,6,198,M,37,7,3,87,-111,Severe
15,3,183,M,50,8,3,99,-84,Severe
18,6,222,M,24,6,5,77,-145,Severe
12,6,150,F,36,7,2,86,-64,Severe
10,7,127,F,18,6,1,73,-54,Severe
7,9,93,M,13,5,9,69,-24,Severe
10,6,126,F,73,10,6,126,0,Neutral
13,0,156,F,65,9,8,116,-40,Severe
8,11,107,M,82,11,5,137,30,Well
7,0,84,M,19,6,1,73,-11,Severe
8,3,99,F,102,13,6,162,63,Well
18,2,218,M,95,12,9,153,-65,Severe
14,7,175,F,48,8,1,97,-78,Severe
15,2,182,F,12,5,9,69,-113,Severe
5,10,70,M,16,5,11,71,1,Good
5,9,69,F,2,5,3,63,-6,Severe
5,7,67,M,20,6,2,74,7,Well
9,7,115,M,34,7,0,84,-31,Severe
15,8,188,M,67,9,10,118,-70,Severe
18,11,227,M,6,5,5,65,-162,Severe
17,5,209,F,83,11,6,138,-71,Severe
13,4,160,M,84,11,7,139,-21,Severe
10,0,120,M,35,7,1,85,-35,Severe
16,4,196,M,56,8,9,105,-91,Severe
8,1,97,M,25,6,5,77,-20,Severe
11,2,134,M,55,8,8,104,-30,Severe
18,10,226,M,11,5,8,68,-158,Severe
5,9,69,M,101,13,4,160,91,Well
8,10,106,M,71,10,3,123,17,Well
11,8,140,F,63,9,6,114,-26,Severe
13,7,163,M,69,10,1,121,-42,Severe
9,9,117,F,29,6,8,80,-37,Severe
17,0,204,F,13,5,9,69,-135,Severe
5,2,62,M,93,12,6,150,88,Well
14,9,177,F,12,5,9,69,-108,Severe
5,5,65,M,21,6,2,74,9,Well
9,2,110,M,107,13,11,167,57,Well
5,3,63,M,38,7,4,88,25,Well
6,2,74,M,5,5,5,65,-9,Severe
6,7,79,F,91,12,4,148,69,Well
18,9,225,F,19,6,1,73,-152,Severe
8,7,103,M,8,5,6,66,-37,Severe
9,3,111,F,84,11,7,139,28,Well
14,3,171,F,107,13,11,167,-4,Mild
6,3,75,M,10,5,7,67,-8,Severe
12,10,154,F,62,9,4,112,-42,Severe
10,3,123,M,102,13,6,162,39,Well
12,5,149,F,80,11,3,135,-14,Severe
12,0,144,F,86,11,10,142,-2,Mild
17,6,210,F,5,5,5,65,-145,Severe
6,11,83,M,26,6,6,78,-5,Mild
15,1,181,F,96,12,10,154,-27,Severe
18,1,217,M,9,5,7,67,-150,Severe
15,6,186,F,67,9,10,118,-68,Severe
15,7,187,M,57,8,10,106,-81,Severe
8,1,97,M,22,6,3,75,-22,Severe
12,6,150,M,91,12,4,148,-2,Mild
7,9,93,M,19,6,1,73,-20,Severe
5,7,67,F,14,5,10,70,3,Good
14,3,171,F,91,12,4,148,-23,Severe
15,6,186,M,105,13,9,165,-21,Severe
11,7,139,M,63,9,6,114,-25,Severe
5,4,64,M,83,11,6,138,74,Well
18,9,225,M,89,12,1,145,-80,Severe
9,9,117,M,69,10,1,121,4,Good
17,10,214,M,13,5,9,69,-145,Severe
11,3,135,F,19,6,1,73,-62,Severe
16,2,194,F,31,6,9,81,-113,Severe
15,11,191,M,58,9,0,108,-83,Severe
14,1,169,M,40,7,5,89,-80,Severe
9,8,116,F,8,5,6,66,-50,Severe
8,8,104,F,29,6,8,80,-24,Severe
13,1,157,M,47,8,0,96,-61,Severe
8,8,104,M,89,12,1,145,41,Well
7,4,88,F,86,11,10,142,54,Well
16,3,195,M,51,8,4,100,-95,Severe
18,5,221,F,63,9,6,114,-107,Severe
8,3,99,F,53,8,6,102,3,Good
8,0,96,M,89,12,1,145,49,Well
15,7,187,M,67,9,10,118,-69,Severe
6,0,72,F,83,11,6,138,66,Well
6,5,77,M,72,10,4,124,47,Well
15,6,186,M,25,6,5,77,-109,Severe
10,2,122,F,84,11,7,139,17,Well
14,7,175,F,59,9,1,109,-66,Severe
17,6,210,M,94,12,7,151,-59,Severe
18,11,227,F,20,6,2,74,-153,Severe
5,6,66,F,74,10,7,127,61,Well
7,3,87,F,29,6,8,80,-7,Severe
18,3,219,M,41,7,6,90,-129,Severe
17,1,205,F,58,9,0,108,-97,Severe
16,9,201,F,109,14,1,169,-32,Severe
17,2,206,M,89,12,1,145,-61,Severe
7,1,85,M,44,7,9,93,8,Well
10,3,123,M,57,8,10,106,-17,Severe
10,8,128,F,40,7,5,89,-39,Severe
5,6,66,F,38,7,4,88,22,Well
6,5,77,F,97,12,11,155,78,Well
16,8,200,F,38,7,4,88,-112,Severe
5,6,66,F,89,12,1,145,79,Well
12,2,146,F,44,7,9,93,-53,Severe
15,11,191,M,53,8,6,102,-89,Severe
16,10,202,F,30,6,9,81,-121,Severe
7,5,89,M,75,10,9,129,40,Well
13,6,162,M,105,13,9,165,3,Good
13,6,162,M,10,5,7,67,-95,Severe
11,9,141,M,32,6,10,82,-59,Severe
11,5,137,F,21,6,2,74,-63,Severe
9,8,116,F,23,6,4,76,-40,Severe
10,8,128,M,60,9,2,110,-18,Severe
7,8,92,M,78,11,0,132,40,Well
11,1,133,F,8,5,6,66,-67,Severe
7,7,91,F,92,12,5,149,58,Well
6,0,72,F,102,13,6,162,90,Well
9,3,111,M,97,12,11,155,44,Well
8,6,102,M,94,12,7,151,49,Well
18,0,216,M,32,6,10,82,-134,Severe
6,3,75,M,29,6,8,80,5,Good
13,9,165,M,93,12,6,150,-15,Severe
17,4,208,F,101,13,4,160,-48,Severe
7,1,85,M,3,5,3,63,-22,Severe
11,6,138,M,62,9,4,112,-26,Severe
11,0,132,F,106,13,10,166,34,Well
7,4,88,M,13,5,9,69,-19,Severe
16,8,200,M,8,5,6,66,-134,Severe
11,3,135,M,54,8,7,103,-32,Severe
11,7,139,F,85,11,9,141,2,Good
17,8,212,M,33,6,11,83,-129,Severe
13,11,167,M,13,5,9,69,-98,Severe
10,0,120,F,104,13,7,163,43,Well
6,4,76,F,69,10,1,121,45,Well
5,9,69,F,52,8,5,101,32,Well
5,5,65,F,79,11,1,133,68,Well
15,8,188,F,71,10,3,123,-65,Severe
14,7,175,F,41,7,6,90,-85,Severe
7,3,87,F,100,13,3,159,72,Well
14,7,175,M,72,10,4,124,-51,Severe
11,9,141,F,68,10,0,120,-21,Severe
13,6,162,M,91,12,4,148,-14,Severe
10,5,125,F,24,6,5,77,-48,Severe
10,0,120,F,102,13,6,162,42,Well
16,3,195,M,92,12,5,149,-46,Severe
14,3,171,F,104,13,7,163,-8,Severe
11,3,135,F,48,8,1,97,-38,Severe
14,4,172,F,86,11,10,142,-30,Severe
12,1,145,F,10,5,7,67,-78,Severe
7,10,94,F,84,11,7,139,45,Well
8,11,107,F,27,6,7,79,-28,Severe
15,11,191,F,72,10,4,124,-67,Severe
18,3,219,M,93,12,6,150,-69,Severe
5,11,71,F,50,8,3,99,28,Well
8,3,99,M,96,12,10,154,55,Well
11,6,138,M,9,5,7,67,-71,Severe
12,9,153,F,8,5,6,66,-87,Severe
12,4,148,M,31,6,9,81,-67,Severe
11,11,143,F,59,9,1,109,-34,Severe
5,9,69,M,42,7,7,91,22,Well
10,3,123,M,35,7,1,85,-38,Severe
18,0,216,F,3,5,3,63,-153,Severe
17,5,209,F,58,9,0,108,-101,Severe
5,0,60,M,31,6,9,81,21,Well
14,3,171,M,104,13,7,163,-8,Severe
10,4,124,F,102,13,6,162,38,Well
10,4,124,M,75,10,9,129,5,Good
6,8,80,M,22,6,3,75,-5,Mild
17,10,214,M,86,11,10,142,-72,Severe
13,9,165,M,14,5,10,70,-95,Severe
16,7,199,F,31,6,9,81,-118,Severe
5,1,61,F,40,7,5,89,28,Well
17,11,215,F,69,10,1,121,-94,Severe
7,2,86,M,110,14,3,171,85,Well
5,2,62,F,25,6,5,77,15,Well
13,3,159,F,89,12,1,145,-14,Severe
8,2,98,M,63,9,6,114,16,Well
10,0,120,F,73,10,6,126,6,Well
15,6,186,F,65,9,8,116,-70,Severe
13,0,156,F,54,8,7,103,-53,Severe
11,8,140,M,20,6,2,74,-66,Severe
16,7,199,F,59,9,1,109,-90,Severe
7,8,92,F,78,11,0,132,40,Well
16,9,201,F,79,11,1,133,-68,Severe
17,8,212,M,71,10,3,123,-89,Severe
11,6,138,F,42,7,7,91,-47,Severe
17,9,213,F,48,8,1,97,-116,Severe
15,9,189,F,26,6,6,78,-111,Severe
15,11,191,F,46,7,11,95,-96,Severe
5,8,68,M,63,9,6,114,46,Well
18,3,219,F,21,6,2,74,-145,Severe
15,1,181,M,107,13,11,167,-14,Severe
9,9,117,F,50,8,3,99,-18,Severe
13,8,164,M,46,7,11,95,-69,Severe
18,7,223,M,79,11,1,133,-90,Severe
6,9,81,F,75,10,9,129,48,Well
10,3,123,F,6,5,5,65,-58,Severe
14,10,178,M,94,12,7,151,-27,Severe
17,4,208,M,53,8,6,102,-106,Severe
10,0,120,F,70,10,2,122,2,Good
15,7,187,F,49,8,2,98,-89,Severe
5,7,67,F,63,9,6,114,47,Well
10,4,124,F,42,7,7,91,-33,Severe
7,3,87,F,74,10,7,127,40,Well
8,3,99,F,33,6,11,83,-16,Severe
7,3,87,F,85,11,9,141,54,Well
11,0,132,F,104,13,7,163,31,Well
12,9,153,M,109,14,1,169,16,Well
7,0,84,M,41,7,6,90,6,Well
12,4,148,F,62,9,4,112,-36,Severe
10,5,125,M,16,5,11,71,-54,Severe
10,4,124,M,63,9,6,114,-10,Severe
17,9,213,M,49,8,2,98,-115,Severe
18,10,226,F,56,8,9,105,-121,Severe
5,6,66,F,21,6,2,74,8,Well
17,5,209,F,66,9,9,117,-92,Severe
10,6,126,F,54,8,7,103,-23,Severe
8,8,104,M,31,6,9,81,-23,Severe
15,8,188,F,49,8,2,98,-90,Severe
15,9,189,F,102,13,6,162,-27,Severe
13,3,159,F,3,5,3,63,-96,Severe
10,0,120,M,44,7,9,93,-27,Severe
9,0,108,M,49,8,2,98,-10,Severe
17,6,210,M,105,13,9,165,-45,Severe
17,10,214,F,107,13,11,167,-47,Severe
13,1,157,F,58,9,0,108,-49,Severe
11,8,140,M,6,5,5,65,-75,Severe
11,3,135,M,49,8,2,98,-37,Severe
16,9,201,F,110,14,3,171,-30,Severe
6,10,82,M,102,13,6,162,80,Well
13,8,164,F,8,5,6,66,-98,Severe
16,3,195,M,68,10,0,120,-75,Severe
7,11,95,F,59,9,1,109,14,Well
16,3,195,M,110,14,3,171,-24,Severe
16,9,201,F,56,8,9,105,-96,Severe
7,8,92,M,13,5,9,69,-23,Severe
6,4,76,M,68,10,0,120,44,Well
14,0,168,F,62,9,4,112,-56,Severe
16,11,203,M,104,13,7,163,-40,Severe
14,1,169,M,79,11,1,133,-36,Severe
5,2,62,F,11,5,8,68,6,Well
12,4,148,F,26,6,6,78,-70,Severe
13,8,164,F,3,5,3,63,-101,Severe
13,10,166,F,73,10,6,126,-40,Severe
12,5,149,M,18,6,1,73,-76,Severe
7,2,86,F,5,5,5,65,-21,Severe
9,1,109,F,33,6,11,83,-26,Severe
12,7,151,M,25,6,5,77,-74,Severe
14,3,171,M,69,10,1,121,-50,Severe
6,5,77,M,103,13,6,162,85,Well
17,9,213,M,92,12,5,149,-64,Severe
12,10,154,M,36,7,2,86,-68,Severe
14,5,173,M,3,5,3,63,-110,Severe
8,10,106,M,99,13,1,157,51,Well
15,5,185,F,100,13,3,159,-26,Severe
10,4,124,M,74,10,7,127,3,Good
15,1,181,M,11,5,8,68,-113,Severe
13,8,164,F,109,14,1,169,5,Good
7,7,91,M,70,10,2,122,31,Well
12,11,155,M,3,5,3,63,-92,Severe
10,3,123,M,58,9,0,108,-15,Severe
10,11,131,F,8,5,6,66,-65,Severe
14,8,176,F,61,9,3,111,-65,Severe
6,6,78,F,7,5,6,66,-12,Severe
5,10,70,F,71,10,3,123,53,Well
14,11,179,F,46,7,11,95,-84,Severe
16,7,199,F,56,8,9,105,-94,Severe
10,0,120,M,2,5,3,63,-57,Severe
7,8,92,F,41,7,6,90,-2,Mild
12,1,145,F,14,5,10,70,-75,Severe
7,10,94,F,72,10,4,124,30,Well
17,6,210,M,98,13,0,156,-54,Severe
16,9,201,M,110,14,3,171,-30,Severe
10,3,123,M,10,5,7,67,-56,Severe
7,0,84,F,72,10,4,124,40,Well
11,1,133,M,38,7,4,88,-45,Severe
18,3,219,F,34,7,0,84,-135,Severe
6,0,72,F,94,12,7,151,79,Well
13,8,164,F,29,6,8,80,-84,Severe
11,4,136,M,71,10,3,123,-13,Severe
6,3,75,F,70,10,2,122,47,Well
12,2,146,M,94,12,7,151,5,Good
9,1,109,M,56,8,9,105,-4,Mild
7,7,91,F,60,9,2,110,19,Well
14,6,174,F,107,13,11,167,-7,Severe
10,10,130,M,64,9,7,115,-15,Severe
18,0,216,F,15,5,11,71,-145,Severe
16,10,202,F,98,13,0,156,-46,Severe
9,4,112,F,104,13,7,163,51,Well
9,10,118,F,69,10,1,121,3,Good
9,4,112,F,39,7,5,89,-23,Severe
6,1,73,M,85,11,9,141,68,Well
8,11,107,M,55,8,8,104,-3,Mild
12,3,147,M,83,11,6,138,-9,Severe
12,9,153,F,76,10,10,130,-23,Severe
9,7,115,M,72,10,4,124,9,Well
8,2,98,F,53,8,6,102,4,Good
13,4,160,F,67,9,10,118,-42,Severe
8,11,107,F,88,12,0,144,37,Well
17,3,207,F,84,11,7,139,-68,Severe
11,8,140,M,69,10,1,121,-19,Severe
7,8,92,F,7,5,6,66,-26,Severe
14,11,179,M,55,8,8,104,-75,Severe
8,7,103,M,18,6,1,73,-30,Severe
18,3,219,F,48,8,1,97,-122,Severe
10,2,122,M,31,6,9,81,-41,Severe
13,0,156,M,73,10,6,126,-30,Severe
9,10,118,F,54,8,7,103,-15,Severe
6,3,75,M,28,6,8,80,5,Good
16,0,192,F,87,11,11,143,-49,Severe
11,5,137,F,109,14,1,169,32,Well
5,11,71,F,35,7,1,85,14,Well
17,1,205,F,47,8,0,96,-109,Severe
6,3,75,F,53,8,6,102,27,Well
16,5,197,M,105,13,9,165,-32,Severe
5,3,63,M,68,10,0,120,57,Well
9,3,111,M,69,10,1,121,10,Well
7,1,85,F,5,5,5,65,-20,Severe
11,6,138,F,57,8,10,106,-32,Severe
18,8,224,F,50,8,3,99,-125,Severe
13,9,165,M,33,6,11,83,-82,Severe
8,2,98,M,96,12,10,154,56,Well
14,3,171,M,35,7,1,85,-86,Severe
15,6,186,M,5,5,5,65,-121,Severe
13,3,159,F,31,6,9,81,-78,Severe
14,1,169,M,76,10,10,130,-39,Severe
12,1,145,F,83,11,6,138,-7,Severe
16,11,203,M,36,7,2,86,-117,Severe
10,7,127,F,56,8,9,105,-22,Severe
18,10,226,M,72,10,4,124,-102,Severe
11,2,134,F,89,12,1,145,11,Well
9,11,119,M,40,7,5,89,-30,Severe
13,8,164,F,59,9,1,109,-55,Severe
12,2,146,M,98,13,0,156,10,Well
18,10,226,M,77,10,11,131,-95,Severe
11,0,132,F,20,6,2,74,-58,Severe
7,5,89,M,82,11,5,137,48,Well
17,9,213,F,70,10,2,122,-91,Severe
9,9,117,M,82,11,5,137,20,Well
7,5,89,M,36,7,2,86,-3,Mild
14,5,173,F,86,11,10,142,-31,Severe
7,3,87,M,65,9,8,116,29,Well
6,10,82,F,24,6,5,77,-5,Mild
8,5,101,F,91,12,4,148,47,Well
18,1,217,F,10,5,7,67,-150,Severe
16,6,198,M,31,6,9,81,-117,Severe
7,5,89,M,101,13,4,160,71,Well
17,8,212,F,64,9,7,115,-97,Severe
10,8,128,M,33,6,11,83,-45,Severe
9,2,110,M,102,13,6,162,52,Well
6,8,80,M,60,9,2,110,30,Well
9,0,108,M,76,10,10,130,22,Well
15,5,185,F,93,12,6,150,-35,Severe
8,5,101,F,52,8,5,101,0,Neutral
7,5,89,M,100,13,3,159,70,Well
11,6,138,M,105,13,9,165,27,Well
13,3,159,F,102,13,6,162,3,Good
18,6,222,F,16,5,11,71,-151,Severe
9,10,118,M,95,12,9,153,35,Well
17,8,212,F,84,11,7,139,-73,Severe
11,11,143,F,107,13,11,167,24,Well
13,5,161,M,108,14,0,168,7,Well
11,8,140,F,94,12,7,151,11,Well
5,0,60,M,28,6,8,80,20,Well
16,7,199,F,45,7,10,94,-105,Severe
5,7,67,M,109,14,1,169,102,Well
5,4,64,M,3,5,3,63,-1,Mild
13,6,162,M,3,5,3,63,-99,Severe
18,11,227,F,18,6,1,73,-154,Severe
12,2,146,F,84,11,7,139,-7,Severe
7,2,86,M,36,7,2,86,0,Neutral
12,10,154,F,8,5,6,66,-88,Severe
14,11,179,F,57,8,10,106,-73,Severe
7,6,90,F,36,7,2,86,-4,Mild
6,8,80,M,75,10,9,129,49,Well
7,6,90,M,20,6,2,74,-16,Severe
8,1,97,F,39,7,5,89,-8,Severe
9,4,112,M,84,11,7,139,27,Well
9,4,112,F,43,7,8,92,-20,Severe
15,11,191,M,12,5,9,69,-122,Severe
15,5,185,F,105,13,9,165,-20,Severe
10,1,121,M,75,10,9,129,8,Well
7,6,90,M,29,6,8,80,-10,Severe
6,3,75,M,46,7,11,95,20,Well
8,8,104,M,19,6,1,73,-31,Severe
14,3,171,M,61,9,3,111,-60,Severe
18,6,222,M,7,5,6,66,-156,Severe
8,1,97,F,46,7,11,95,-2,Mild
12,1,145,M,82,11,5,137,-8,Severe
17,8,212,F,5,5,5,65,-147,Severe
15,3,183,M,60,9,2,110,-73,Severe
5,8,68,M,21,6,2,74,6,Well
16,8,200,M,103,13,6,162,-38,Severe
14,3,171,M,40,7,5,89,-82,Severe
14,10,178,M,36,7,2,86,-92,Severe
9,3,111,F,101,13,4,160,49,Well
10,9,129,F,6,5,5,65,-64,Severe
8,1,97,M,43,7,8,92,-5,Mild
8,6,102,M,5,5,5,65,-37,Severe
15,2,182,M,55,8,8,104,-78,Severe
17,7,211,M,90,12,3,147,-64,Severe
7,9,93,F,87,11,11,143,50,Well
7,10,94,M,48,8,1,97,3,Good
18,4,220,F,8,5,6,66,-154,Severe
7,3,87,F,59,9,1,109,22,Well
9,3,111,F,55,8,8,104,-7,Severe
5,6,66,F,53,8,6,102,36,Well
5,10,70,M,20,6,2,74,4,Good
17,5,209,M,7,5,6,66,-143,Severe
15,8,188,F,19,6,1,73,-115,Severe
8,0,96,F,109,14,1,169,73,Well
6,7,79,F,83,11,6,138,59,Well
14,5,173,M,15,5,11,71,-102,Severe
10,7,127,F,30,6,9,81,-46,Severe
16,6,198,M,78,11,0,132,-66,Severe
18,9,225,F,44,7,9,93,-132,Severe
8,3,99,F,9,5,7,67,-32,Severe
15,8,188,F,50,8,3,99,-89,Severe
16,10,202,F,99,13,1,157,-45,Severe
7,3,87,F,11,5,8,68,-19,Severe
15,0,180,M,49,8,2,98,-82,Severe
11,3,135,F,20,6,2,74,-61,Severe
10,11,131,F,7,5,6,66,-65,Severe
13,4,160,F,2,5,3,63,-97,Severe
17,8,212,M,76,10,10,130,-82,Severe
7,5,89,M,53,8,6,102,13,Well
10,5,125,F,11,5,8,68,-57,Severe
18,7,223,M,86,11,10,142,-81,Severe
13,3,159,F,38,7,4,88,-71,Severe
9,3,111,M,96,12,10,154,43,Well
17,11,215,M,103,13,6,162,-53,Severe
7,0,84,M,81,11,4,136,52,Well
15,3,183,F,38,7,4,88,-95,Severe
15,9,189,F,77,10,11,131,-58,Severe
16,6,198,F,86,11,10,142,-56,Severe
7,9,93,F,4,5,4,64,-29,Severe
11,3,135,F,88,12,0,144,9,Well
9,10,118,M,2,5,3,63,-55,Severe
11,5,137,M,51,8,4,100,-37,Severe
15,0,180,M,63,9,6,114,-66,Severe
10,5,125,M,26,6,6,78,-47,Severe
12,5,149,F,31,6,9,81,-68,Severe
6,2,74,F,10,5,7,67,-7,Severe
5,4,64,M,77,10,11,131,67,Well
10,2,122,F,43,7,8,92,-30,Severe
5,8,68,M,10,5,7,67,-1,Mild
11,0,132,M,84,11,7,139,7,Well
18,11,227,M,69,10,1,121,-106,Severe
12,3,147,F,8,5,6,66,-81,Severe
18,0,216,F,24,6,5,77,-139,Severe
7,0,84,M,58,9,0,108,24,Well
17,2,206,F,80,11,3,135,-71,Severe
6,9,81,F,96,12,10,154,73,Well
8,10,106,M,61,9,3,111,5,Good
15,11,191,M,37,7,3,87,-104,Severe
16,1,193,M,79,11,1,133,-60,Severe
5,2,62,F,102,13,6,162,100,Well
17,9,213,M,29,6,8,80,-133,Severe
5,9,69,F,76,10,10,130,61,Well
11,4,136,M,5,5,5,65,-71,Severe
11,6,138,F,28,6,8,80,-58,Severe
14,3,171,M,36,7,2,86,-85,Severe
7,10,94,M,66,9,9,117,23,Well
15,8,188,F,59,9,1,109,-79,Severe
12,11,155,M,65,9,8,116,-39,Severe
14,10,178,M,15,5,11,71,-107,Severe
17,6,210,M,89,12,1,145,-65,Severe
7,9,93,M,27,6,7,79,-14,Severe
13,4,160,M,109,14,1,169,9,Well
16,7,199,M,95,12,9,153,-46,Severe
17,9,213,M,18,6,1,73,-140,Severe
9,3,111,M,41,7,6,90,-21,Severe
18,4,220,F,24,6,5,77,-143,Severe
13,0,156,M,16,5,11,71,-85,Severe
12,9,153,M,39,7,5,89,-64,Severe
12,6,150,M,100,13,3,159,9,Well
8,4,100,M,101,13,4,160,60,Well
17,11,215,M,59,9,1,109,-106,Severe
10,2,122,M,64,9,7,115,-7,Severe
5,1,61,M,102,13,6,162,101,Well
11,9,141,M,97,12,11,155,14,Well
11,2,134,M,11,5,8,68,-66,Severe
7,3,87,M,46,7,11,95,8,Well
6,10,82,F,43,7,8,92,10,Well
17,6,210,F,64,9,7,115,-95,Severe
14,5,173,F,71,10,3,123,-50,Severe
5,11,71,M,19,6,1,73,2,Good
13,10,166,M,102,13,6,162,-4,Mild
8,9,105,M,49,8,2,98,-7,Severe
15,9,189,F,10,5,7,67,-122,Severe
13,3,159,F,62,9,4,112,-47,Severe
15,4,184,M,99,13,1,157,-27,Severe
16,1,193,M,31,6,9,81,-112,Severe
5,8,68,M,24,6,5,77,9,Well
9,0,108,M,110,14,3,171,63,Well
17,9,213,M,13,5,9,69,-144,Severe
14,4,172,F,50,8,3,99,-73,Severe
6,4,76,F,65,9,8,116,40,Well
9,0,108,M,44,7,9,93,-15,Severe
5,9,69,M,16,5,11,71,2,Good
9,4,112,M,85,11,9,141,29,Well
7,4,88,F,62,9,4,112,24,Well
9,7,115,M,98,13,0,156,41,Well
5,4,64,M,32,6,10,82,18,Well
9,2,110,M,9,5,7,67,-43,Severe
9,1,109,M,46,7,11,95,-14,Severe
9,5,113,F,79,11,1,133,20,Well
7,5,89,F,104,13,7,163,74,Well
8,1,97,F,44,7,9,93,-4,Mild
7,0,84,F,98,13,0,156,72,Well
17,4,208,F,75,10,9,129,-79,Severe
8,0,96,F,61,9,3,111,15,Well
11,8,140,M,13,5,9,69,-71,Severe
13,3,159,F,6,5,5,65,-94,Severe
18,3,219,M,69,10,1,121,-98,Severe
10,1,121,F,109,14,1,169,48,Well
9,6,114,F,65,9,8,116,2,Good
9,7,115,F,100,13,3,159,44,Well
15,3,183,F,88,12,0,144,-39,Severe
5,7,67,F,87,11,11,143,76,Well
11,11,143,F,17,6,0,72,-71,Severe
5,2,62,F,34,7,0,84,22,Well
17,4,208,F,102,13,6,162,-46,Severe
10,2,122,M,62,9,4,112,-10,Severe
6,3,75,M,75,10,9,129,54,Well
7,3,87,M,15,5,11,71,-16,Severe
13,3,159,M,80,11,3,135,-24,Severe
7,5,89,M,5,5,5,65,-24,Severe
11,10,142,F,33,6,11,83,-59,Severe
18,0,216,F,86,11,10,142,-74,Severe
5,3,63,F,79,11,1,133,70,Well
12,5,149,M,41,7,6,90,-59,Severe
18,4,220,F,93,12,6,150,-70,Severe
7,4,88,M,14,5,10,70,-18,Severe
16,0,192,M,98,13,0,156,-36,Severe
15,10,190,F,5,5,5,65,-125,Severe
17,3,207,F,90,12,3,147,-60,Severe
17,9,213,F,82,11,5,137,-76,Severe
10,6,126,M,32,6,10,82,-44,Severe
18,2,218,F,17,6,0,72,-146,Severe
12,3,147,F,61,9,3,111,-36,Severe
11,8,140,F,36,7,2,86,-54,Severe
18,10,226,F,19,6,1,73,-153,Severe
11,7,139,F,100,13,3,159,20,Well
14,5,173,M,75,10,9,129,-44,Severe
12,5,149,M,71,10,3,123,-26,Severe
14,11,179,F,74,10,7,127,-52,Severe
14,2,170,F,95,12,9,153,-17,Severe
15,4,184,M,10,5,7,67,-117,Severe
17,3,207,F,7,5,6,66,-141,Severe
18,11,227,F,19,6,1,73,-154,Severe
9,7,115,M,37,7,3,87,-28,Severe
9,4,112,F,61,9,3,111,-1,Mild
11,9,141,F,53,8,6,102,-39,Severe
9,9,117,M,63,9,6,114,-3,Mild
18,3,219,F,20,6,2,74,-145,Severe
9,11,119,F,108,14,0,168,49,Well
11,9,141,F,104,13,7,163,22,Well
12,3,147,F,92,12,5,149,2,Good
18,9,225,M,30,6,9,81,-144,Severe
5,7,67,F,34,7,0,84,17,Well
12,2,146,F,91,12,4,148,2,Good
15,5,185,F,101,13,4,160,-25,Severe
13,8,164,F,104,13,7,163,-1,Mild
10,4,124,M,70,10,2,122,-2,Mild
14,3,171,M,55,8,8,104,-67,Severe
14,1,169,F,93,12,6,150,-19,Severe
17,6,210,F,82,11,5,137,-73,Severe
6,3,75,M,71,10,3,123,48,Well
15,10,190,F,59,9,1,109,-81,Severe
7,7,91,M,89,12,1,145,54,Well
5,11,71,F,25,6,5,77,6,Well
6,3,75,M,22,6,3,75,0,Neutral
10,10,130,F,63,9,6,114,-16,Severe
13,2,158,M,65,9,8,116,-42,Severe
12,10,154,F,72,10,4,124,-30,Severe
12,3,147,F,87,11,11,143,-4,Mild
15,6,186,M,30,6,9,81,-105,Severe
7,10,94,F,19,6,1,73,-21,Severe
14,10,178,F,79,11,1,133,-45,Severe
16,5,197,F,51,8,4,100,-97,Severe
15,4,184,M,33,6,11,83,-101,Severe
13,10,166,F,32,6,10,82,-84,Severe
11,1,133,M,30,6,9,81,-52,Severe
16,10,202,M,61,9,3,111,-91,Severe
11,5,137,M,70,10,2,122,-15,Severe
15,11,191,F,83,11,6,138,-53,Severe
8,1,97,M,54,8,7,103,6,Well
17,9,213,F,49,8,2,98,-115,Severe
15,2,182,M,108,14,0,168,-14,Severe
18,5,221,M,84,11,7,139,-82,Severe
12,3,147,M,83,11,6,138,-9,Severe
5,11,71,M,68,10,0,120,49,Well
8,11,107,M,105,13,9,165,58,Well
8,9,105,F,56,8,9,105,0,Neutral
8,1,97,M,101,13,4,160,63,Well
8,11,107,F,11,5,8,68,-39,Severe
15,7,187,F,85,11,9,141,-46,Severe
7,3,87,F,25,6,5,77,-10,Severe
16,6,198,F,104,13,7,163,-35,Severe
16,9,201,M,20,6,2,74,-127,Severe
6,7,79,F,80,11,3,135,56,Well
11,2,134,F,21,6,2,74,-60,Severe
8,5,101,M,30,6,9,81,-20,Severe
8,0,96,F,103,13,6,162,66,Well
15,11,191,F,13,5,9,69,-122,Severe
15,4,184,M,75,10,9,129,-55,Severe
17,6,210,F,33,6,11,83,-127,Severe
15,1,181,F,40,7,5,89,-92,Severe
11,6,138,M,57,8,10,106,-32,Severe
10,0,120,F,20,6,2,74,-46,Severe
13,3,159,F,28,6,8,80,-79,Severe
7,6,90,F,58,9,0,108,18,Well
9,11,119,M,97,12,11,155,36,Well
15,4,184,F,71,10,3,123,-61,Severe
10,10,130,F,33,6,11,83,-47,Severe
6,3,75,M,49,8,2,98,23,Well
7,5,89,F,4,5,4,64,-25,Severe
6,3,75,M,76,10,10,130,55,Well
12,5,149,M,42,7,7,91,-58,Severe
8,7,103,F,38,7,4,88,-15,Severe
17,10,214,M,18,6,1,73,-141,Severe
12,11,155,M,103,13,6,162,7,Well
9,4,112,M,101,13,4,160,48,Well
14,10,178,F,108,14,0,168,-10,Severe
14,6,174,F,52,8,5,101,-73,Severe
14,3,171,F,92,12,5,149,-22,Severe
5,6,66,M,32,6,10,82,16,Well
17,8,212,F,28,6,8,80,-132,Severe
6,11,83,F,109,14,1,169,86,Well
14,5,173,F,83,11,6,138,-35,Severe
15,5,185,M,46,7,11,95,-90,Severe
11,9,141,F,71,10,3,123,-18,Severe
18,5,221,M,61,9,3,111,-110,Severe
17,5,209,M,110,14,3,171,-38,Severe
5,0,60,M,11,5,8,68,8,Well
7,1,85,M,104,13,7,163,78,Well
5,8,68,F,51,8,4,100,32,Well
9,3,111,M,45,7,10,94,-17,Severe
17,5,209,M,22,6,3,75,-134,Severe
12,4,148,F,91,12,4,148,0,Neutral
10,3,123,M,75,10,9,129,6,Well
7,4,88,M,27,6,7,79,-9,Severe
12,6,150,M,63,9,6,114,-36,Severe
13,9,165,F,42,7,7,91,-74,Severe
13,4,160,M,17,6,0,72,-88,Severe
18,3,219,M,20,6,2,74,-145,Severe
16,4,196,F,66,9,9,117,-79,Severe
18,4,220,F,81,11,4,136,-84,Severe
14,4,172,F,77,10,11,131,-41,Severe
11,0,132,M,36,7,2,86,-46,Severe
12,3,147,F,68,10,0,120,-27,Severe
12,2,146,F,96,12,10,154,8,Well
8,0,96,F,30,6,9,81,-15,Severe
17,7,211,F,27,6,7,79,-132,Severe
15,11,191,M,52,8,5,101,-90,Severe
9,6,114,M,63,9,6,114,0,Neutral
12,11,155,M,97,12,11,155,0,Neutral
14,8,176,M,57,8,10,106,-70,Severe
6,5,77,F,79,11,1,133,56,Well
10,9,129,F,86,11,10,142,13,Well
16,5,197,M,46,7,11,95,-102,Severe
12,6,150,F,20,6,2,74,-76,Severe
13,4,160,F,87,11,11,143,-17,Severe
18,0,216,M,105,13,9,165,-51,Severe
8,3,99,F,46,7,11,95,-4,Mild
11,5,137,F,82,11,5,137,0,Neutral
12,3,147,F,80,11,3,135,-12,Severe
14,0,168,M,60,9,2,110,-58,Severe
11,10,142,M,98,13,0,156,14,Well
10,11,131,F,26,6,6,78,-53,Severe
17,1,205,F,53,8,6,102,-103,Severe
8,6,102,M,105,13,9,165,63,Well
5,8,68,M,11,5,8,68,0,Neutral
6,8,80,F,104,13,7,163,83,Well
16,4,196,M,67,9,10,118,-78,Severe
18,7,223,M,8,5,6,66,-157,Severe
12,4,148,M,21,6,2,74,-74,Severe
10,2,122,F,18,6,1,73,-49,Severe
6,9,81,F,94,12,7,151,70,Well
10,4,124,F,13,5,9,69,-55,Severe
10,5,125,F,12,5,9,69,-56,Severe
13,8,164,M,102,13,6,162,-2,Mild
13,6,162,M,11,5,8,68,-94,Severe
18,4,220,F,17,6,0,72,-148,Severe
15,1,181,M,4,5,4,64,-117,Severe
11,3,135,F,81,11,4,136,1,Good
5,4,64,M,42,7,7,91,27,Well
18,0,216,F,66,9,9,117,-99,Severe
6,1,73,M,69,10,1,121,48,Well
12,3,147,F,2,5,3,63,-84,Severe
10,7,127,M,4,5,4,64,-63,Severe
5,1,61,F,109,14,1,169,108,Well
6,8,80,F,40,7,5,89,9,Well
14,0,168,M,67,9,10,118,-50,Severe
13,3,159,M,66,9,9,117,-42,Severe
11,7,139,M,106,13,10,166,27,Well
5,3,63,F,98,13,0,156,93,Well
10,5,125,M,75,10,9,129,4,Good
16,3,195,F,108,14,0,168,-27,Severe
6,5,77,M,37,7,3,87,10,Well
12,5,149,M,96,12,10,154,5,Good
11,9,141,F,32,6,10,82,-59,Severe
17,9,213,F,50,8,3,99,-114,Severe
10,6,126,F,64,9,7,115,-11,Severe
10,11,131,M,11,5,8,68,-63,Severe
11,0,132,M,83,11,6,138,6,Well
17,3,207,M,15,5,11,71,-136,Severe
7,6,90,M,11,5,8,68,-22,Severe
8,10,106,F,26,6,6,78,-28,Severe
9,9,117,M,58,9,0,108,-9,Severe
12,3,147,F,46,7,11,95,-52,Severe
8,5,101,F,43,7,8,92,-9,Severe
16,7,199,F,102,13,6,162,-37,Severe
5,3,63,M,77,10,11,131,68,Well
10,4,124,F,88,12,0,144,20,Well
15,9,189,M,34,7,0,84,-105,Severe
16,7,199,F,29,6,8,80,-119,Severe
13,1,157,F,89,12,1,145,-12,Severe
16,6,198,F,52,8,5,101,-97,Severe
16,2,194,F,96,12,10,154,-40,Severe
13,5,161,M,33,6,11,83,-78,Severe
15,7,187,F,108,14,0,168,-19,Severe
14,10,178,M,62,9,4,112,-66,Severe
8,6,102,F,26,6,6,78,-24,Severe
16,10,202,F,28,6,8,80,-122,Severe
7,3,87,F,90,12,3,147,60,Well
5,1,61,M,25,6,5,77,16,Well
11,11,143,F,71,10,3,123,-20,Severe
13,7,163,M,79,11,1,133,-30,Severe
10,11,131,F,6,5,5,65,-66,Severe
14,7,175,M,76,10,10,130,-45,Severe
18,9,225,M,9,5,7,67,-158,Severe
6,0,72,M,56,8,9,105,33,Well
9,3,111,M,91,12,4,148,37,Well
6,9,81,M,59,9,1,109,28,Well
9,2,110,F,24,6,5,77,-33,Severe
18,3,219,M,28,6,8,80,-139,Severe
13,5,161,F,90,12,3,147,-14,Severe
5,4,64,F,98,13,0,156,92,Well
8,6,102,M,109,14,1,169,67,Well
9,5,113,F,95,12,9,153,40,Well
9,0,108,M,66,9,9,117,9,Well
8,4,100,M,104,13,7,163,63,Well
15,2,182,F,17,6,0,72,-110,Severe
15,11,191,M,66,9,9,117,-74,Severe
7,1,85,M,17,6,0,72,-13,Severe
6,2,74,M,70,10,2,122,48,Well
15,4,184,F,9,5,7,67,-117,Severe
12,5,149,M,44,7,9,93,-56,Severe
15,2,182,M,83,11,6,138,-44,Severe
15,2,182,M,66,9,9,117,-65,Severe
12,6,150,M,99,13,1,157,7,Well
16,10,202,F,16,5,11,71,-131,Severe
15,10,190,F,77,10,11,131,-59,Severe
16,1,193,F,43,7,8,92,-101,Severe
8,4,100,F,71,10,3,123,23,Well
7,8,92,F,92,12,5,149,57,Well
6,7,79,F,50,8,3,99,20,Well
18,0,216,F,67,9,10,118,-98,Severe
9,4,112,F,11,5,8,68,-44,Severe
12,2,146,M,75,10,9,129,-17,Severe
11,7,139,M,6,5,5,65,-74,Severe
13,11,167,M,104,13,7,163,-4,Mild
13,3,159,M,99,13,1,157,-2,Mild
17,3,207,M,45,7,10,94,-113,Severe
17,7,211,M,11,5,8,68,-143,Severe
18,4,220,M,54,8,7,103,-117,Severe
16,2,194,F,85,11,9,141,-53,Severe
6,2,74,M,74,10,7,127,53,Well
8,0,96,F,12,5,9,69,-27,Severe
6,3,75,M,28,6,8,80,5,Good
18,0,216,M,104,13,7,163,-53,Severe
11,7,139,F,52,8,5,101,-38,Severe
10,11,131,F,49,8,2,98,-33,Severe
18,4,220,M,47,8,0,96,-124,Severe
14,4,172,F,30,6,9,81,-91,Severe
11,11,143,F,3,5,3,63,-80,Severe
13,7,163,M,88,12,0,144,-19,Severe
9,0,108,M,27,6,7,79,-29,Severe
12,3,147,F,7,5,6,66,-81,Severe
12,2,146,F,105,13,9,165,19,Well
14,4,172,M,91,12,4,148,-24,Severe
11,3,135,M,68,10,0,120,-15,Severe
11,8,140,M,105,13,9,165,25,Well
6,3,75,M,109,14,1,169,94,Well
6,6,78,F,93,12,6,150,72,Well
15,7,187,F,19,6,1,73,-114,Severe
18,7,223,M,44,7,9,93,-130,Severe
7,9,93,M,75,10,9,129,36,Well
5,10,70,M,51,8,4,100,30,Well
8,10,106,M,75,10,9,129,23,Well
18,9,225,F,14,5,10,70,-155,Severe
6,6,78,F,63,9,6,114,36,Well
11,9,141,M,2,5,3,63,-78,Severe
18,3,219,M,90,12,3,147,-72,Severe
18,11,227,M,18,6,1,73,-154,Severe
10,4,124,M,46,7,11,95,-29,Severe
17,5,209,M,70,10,2,122,-87,Severe
18,1,217,F,50,8,3,99,-118,Severe
7,1,85,F,36,7,2,86,1,Good
9,11,119,M,50,8,3,99,-20,Severe
14,3,171,F,37,7,3,87,-84,Severe
10,3,123,M,71,10,3,123,0,Neutral
15,4,184,F,5,5,5,65,-119,Severe
12,4,148,F,64,9,7,115,-33,Severe
12,10,154,M,24,6,5,77,-77,Severe
13,6,162,M,107,13,11,167,5,Good
6,2,74,M,32,6,10,82,8,Well
8,8,104,F,51,8,4,100,-4,Mild
14,1,169,F,71,10,3,123,-46,Severe
15,9,189,F,92,12,5,149,-40,Severe
17,3,207,M,88,12,0,144,-63,Severe
18,0,216,M,20,6,2,74,-142,Severe
14,1,169,F,110,14,3,171,2,Good
9,8,116,F,92,12,5,149,33,Well
8,7,103,F,60,9,2,110,7,Well
6,5,77,M,90,12,3,147,70,Well
18,2,218,F,6,5,5,65,-153,Severe
13,1,157,M,57,8,10,106,-51,Severe
17,3,207,M,100,13,3,159,-48,Severe
18,3,219,F,16,5,11,71,-148,Severe
13,6,162,F,14,5,10,70,-92,Severe
8,1,97,M,85,11,9,141,44,Well
5,10,70,F,16,5,11,71,1,Good
14,8,176,F,97,12,11,155,-21,Severe
16,5,197,F,52,8,5,101,-96,Severe
16,2,194,M,30,6,9,81,-113,Severe
11,5,137,M,99,13,1,157,20,Well
8,3,99,F,31,6,9,81,-18,Severe
12,11,155,M,29,6,8,80,-75,Severe
5,2,62,M,101,13,4,160,98,Well
12,11,155,F,46,7,11,95,-60,Severe
11,2,134,F,71,10,3,123,-11,Severe
5,3,63,M,94,12,7,151,88,Well
13,9,165,F,60,9,2,110,-55,Severe
9,1,109,F,46,7,11,95,-14,Severe
16,3,195,F,74,10,7,127,-68,Severe
9,1,109,F,78,11,0,132,23,Well
12,0,144,F,54,8,7,103,-41,Severe
5,5,65,F,3,5,3,63,-2,Mild
8,4,100,M,27,6,7,79,-21,Severe
14,6,174,F,75,10,9,129,-45,Severe
17,9,213,F,34,7,0,84,-129,Severe
15,0,180,M,19,6,1,73,-107,Severe
18,3,219,M,76,10,10,130,-89,Severe
10,4,124,M,40,7,5,89,-35,Severe
5,7,67,M,63,9,6,114,47,Well
15,4,184,M,2,5,3,63,-121,Severe
16,11,203,M,12,5,9,69,-134,Severe
18,8,224,F,96,12,10,154,-70,Severe
8,3,99,M,62,9,4,112,13,Well
15,4,184,F,15,5,11,71,-113,Severe
8,0,96,F,47,8,0,96,0,Neutral
8,10,106,M,88,12,0,144,38,Well
17,9,213,F,80,11,3,135,-78,Severe
15,10,190,M,2,5,3,63,-127,Severe
6,1,73,F,50,8,3,99,26,Well
15,8,188,F,21,6,2,74,-114,Severe
6,1,73,F,6,5,5,65,-8,Severe
17,11,215,F,53,8,6,102,-113,Severe
15,1,181,M,104,13,7,163,-18,Severe
12,2,146,M,91,12,4,148,2,Good
13,3,159,M,71,10,3,123,-36,Severe
11,3,135,F,91,12,4,148,13,Well
12,3,147,M,96,12,10,154,7,Well
15,3,183,M,7,5,6,66,-117,Severe
10,3,123,F,68,10,0,120,-3,Mild
9,0,108,F,58,9,0,108,0,Neutral
17,11,215,M,49,8,2,98,-117,Severe
17,7,211,M,35,7,1,85,-126,Severe
15,7,187,F,69,10,1,121,-66,Severe
5,2,62,F,65,9,8,116,54,Well
17,8,212,F,81,11,4,136,-76,Severe
9,3,111,M,70,10,2,122,11,Well
15,6,186,F,104,13,7,163,-23,Severe
11,11,143,M,68,10,0,120,-23,Severe
7,7,91,M,85,11,9,141,50,Well
17,2,206,M,104,13,7,163,-43,Severe
15,3,183,F,93,12,6,150,-33,Severe
17,6,210,F,8,5,6,66,-144,Severe
7,3,87,F,107,13,11,167,80,Well
7,3,87,M,26,6,6,78,-9,Severe
7,7,91,F,56,8,9,105,14,Well
13,7,163,M,24,6,5,77,-86,Severe
11,5,137,M,88,12,0,144,7,Well
13,7,163,F,75,10,9,129,-34,Severe
7,2,86,M,106,13,10,166,80,Well
9,0,108,M,57,8,10,106,-2,Mild
16,6,198,M,84,11,7,139,-59,Severe
7,10,94,M,81,11,4,136,42,Well
13,2,158,F,54,8,7,103,-55,Severe
16,3,195,F,28,6,8,80,-115,Severe
12,9,153,M,101,13,4,160,7,Well
10,7,127,M,94,12,7,151,24,Well
13,4,160,F,77,10,11,131,-29,Severe
7,4,88,F,76,10,10,130,42,Well
8,8,104,M,94,12,7,151,47,Well
9,5,113,F,49,8,2,98,-15,Severe
9,9,117,F,62,9,4,112,-5,Mild
16,9,201,M,62,9,4,112,-89,Severe
13,4,160,M,34,7,0,84,-76,Severe
11,8,140,M,74,10,7,127,-13,Severe
12,6,150,M,85,11,9,141,-9,Severe
8,7,103,F,41,7,6,90,-13,Severe
8,0,96,F,49,8,2,98,2,Good
14,11,179,M,20,6,2,74,-105,Severe
11,3,135,F,27,6,7,79,-56,Severe
9,8,116,F,73,10,6,126,10,Well
9,4,112,F,80,11,3,135,23,Well
18,1,217,F,92,12,5,149,-68,Severe
6,3,75,F,77,10,11,131,56,Well
9,5,113,F,87,11,11,143,30,Well
12,8,152,M,11,5,8,68,-84,Severe
17,2,206,F,54,8,7,103,-103,Severe
7,6,90,F,47,8,0,96,6,Well
14,7,175,M,22,6,3,75,-100,Severe
18,2,218,F,82,11,5,137,-81,Severe
5,4,64,M,87,11,11,143,79,Well
10,9,129,F,97,12,11,155,26,Well
17,4,208,F,4,5,4,64,-144,Severe
6,9,81,F,86,11,10,142,61,Well
7,6,90,F,44,7,9,93,3,Good
9,6,114,F,2,5,3,63,-51,Severe
18,2,218,M,85,11,9,141,-77,Severe
15,3,183,F,21,6,2,74,-109,Severe
18,3,219,F,42,7,7,91,-128,Severe
17,4,208,M,69,10,1,121,-87,Severe
15,9,189,M,78,11,0,132,-57,Severe
6,6,78,M,16,5,11,71,-7,Severe
6,1,73,M,110,14,3,171,98,Well
15,2,182,F,90,12,3,147,-35,Severe
9,3,111,F,64,9,7,115,4,Good
7,4,88,M,11,5,8,68,-20,Severe
11,11,143,F,70,10,2,122,-21,Severe
18,3,219,M,85,11,9,141,-78,Severe
10,0,120,F,93,12,6,150,30,Well
13,9,165,M,95,12,9,153,-12,Severe
14,3,171,M,64,9,7,115,-56,Severe
15,6,186,M,17,6,0,72,-114,Severe
11,3,135,F,96,12,10,154,19,Well
10,5,125,M,77,10,11,131,6,Well
12,4,148,F,15,5,11,71,-77,Severe
15,9,189,M,76,10,10,130,-59,Severe
17,8,212,F,54,8,7,103,-109,Severe
8,8,104,M,95,12,9,153,49,Well
7,8,92,F,106,13,10,166,74,Well
9,2,110,M,15,5,11,71,-39,Severe
15,7,187,F,26,6,6,78,-109,Severe
12,2,146,F,15,5,11,71,-75,Severe
16,4,196,M,59,9,1,109,-87,Severe
16,0,192,M,90,12,3,147,-45,Severe
16,8,200,M,53,8,6,102,-98,Severe
6,0,72,F,29,6,8,80,8,Well
17,3,207,M,45,7,10,94,-113,Severe
8,2,98,F,71,10,3,123,25,Well
17,7,211,F,105,13,9,165,-46,Severe
15,5,185,M,74,10,7,127,-58,Severe
5,11,71,F,71,10,3,123,52,Well
9,3,111,M,32,6,10,82,-29,Severe
14,1,169,F,35,7,1,85,-84,Severe
10,0,120,F,65,9,8,116,-4,Mild
14,2,170,F,37,7,3,87,-83,Severe
14,2,170,M,77,10,11,131,-39,Severe
18,3,219,M,37,7,3,87,-132,Severe
11,7,139,M,57,8,10,106,-33,Severe
10,5,125,F,25,6,5,77,-48,Severe
9,9,117,M,80,11,3,135,18,Well
10,3,123,M,25,6,5,77,-46,Severe
5,10,70,F,18,6,1,73,3,Good
8,7,103,F,66,9,9,117,14,Well
18,10,226,M,36,7,2,86,-140,Severe
17,8,212,M,83,11,6,138,-74,Severe
9,4,112,M,87,11,11,143,31,Well
7,1,85,F,59,9,1,109,24,Well
8,10,106,M,104,13,7,163,57,Well
18,0,216,M,17,6,0,72,-144,Severe
11,10,142,M,44,7,9,93,-49,Severe
16,4,196,M,52,8,5,101,-95,Severe
7,1,85,F,79,11,1,133,48,Well
8,1,97,M,44,7,9,93,-4,Mild
18,6,222,F,83,11,6,138,-84,Severe
8,2,98,M,21,6,2,74,-24,Severe
13,4,160,F,60,9,2,110,-50,Severe
14,0,168,F,19,6,1,73,-95,Severe
18,11,227,F,46,7,11,95,-132,Severe
9,6,114,M,49,8,2,98,-16,Severe
15,4,184,M,97,12,11,155,-29,Severe
16,7,199,M,36,7,2,86,-113,Severe
10,6,126,M,75,10,9,129,3,Good
9,3,111,F,107,13,11,167,56,Well
17,2,206,F,39,7,5,89,-117,Severe
5,10,70,M,34,7,0,84,14,Well
6,0,72,M,87,11,11,143,71,Well
7,0,84,F,101,13,4,160,76,Well
6,7,79,M,8,5,6,66,-13,Severe
7,7,91,M,2,5,3,63,-28,Severe
7,3,87,M,98,13,0,156,69,Well
10,6,126,M,42,7,7,91,-35,Severe
9,10,118,F,39,7,5,89,-29,Severe
12,9,153,F,46,7,11,95,-58,Severe
6,3,75,M,30,6,9,81,6,Well
10,6,126,M,99,13,1,157,31,Well
8,1,97,M,16,5,11,71,-26,Severe
6,3,75,F,43,7,8,92,17,Well
17,2,206,F,68,10,0,120,-86,Severe
15,7,187,F,40,7,5,89,-98,Severe
11,5,137,F,77,10,11,131,-6,Severe
14,6,174,M,35,7,1,85,-89,Severe
9,11,119,M,96,12,10,154,35,Well
12,7,151,M,27,6,7,79,-72,Severe
15,1,181,F,34,7,0,84,-97,Severe
16,7,199,M,32,6,10,82,-117,Severe
15,8,188,F,18,6,1,73,-115,Severe
16,3,195,F,20,6,2,74,-121,Severe
11,6,138,F,61,9,3,111,-27,Severe
8,3,99,F,3,5,3,63,-36,Severe
7,8,92,F,84,11,7,139,47,Well
10,1,121,M,2,5,3,63,-58,Severe
12,8,152,F,33,6,11,83,-69,Severe
8,0,96,F,21,6,2,74,-22,Severe
12,10,154,M,69,10,1,121,-33,Severe
7,0,84,F,93,12,6,150,66,Well
9,3,111,F,105,13,9,165,54,Well
13,10,166,F,14,5,10,70,-96,Severe
6,8,80,F,66,9,9,117,37,Well
11,3,135,M,110,14,3,171,36,Well
6,10,82,F,101,13,4,160,78,Well
10,1,121,F,18,6,1,73,-48,Severe
12,3,147,F,72,10,4,124,-23,Severe
17,10,214,M,22,6,3,75,-139,Severe
10,3,123,M,14,5,10,70,-53,Severe
14,2,170,M,101,13,4,160,-10,Severe
13,11,167,M,97,12,11,155,-12,Severe
16,7,199,F,43,7,8,92,-107,Severe
13,10,166,M,16,5,11,71,-95,Severe
11,5,137,M,106,13,10,166,29,Well
15,6,186,F,6,5,5,65,-121,Severe
11,7,139,M,7,5,6,66,-73,Severe
10,5,125,F,59,9,1,109,-16,Severe
7,5,89,F,80,11,3,135,46,Well
9,4,112,M,69,10,1,121,9,Well
5,8,68,M,32,6,10,82,14,Well
11,10,142,M,35,7,1,85,-57,Severe
8,3,99,F,82,11,5,137,38,Well
9,3,111,F,93,12,6,150,39,Well
15,9,189,F,35,7,1,85,-104,Severe
7,6,90,M,56,8,9,105,15,Well
12,0,144,M,107,13,11,167,23,Well
7,11,95,M,87,11,11,143,48,Well
8,3,99,F,18,6,1,73,-26,Severe
7,3,87,M,32,6,10,82,-5,Mild
5,3,63,M,40,7,5,89,26,Well
7,2,86,M,87,11,11,143,57,Well
5,0,60,M,102,13,6,162,102,Well
18,3,219,M,65,9,8,116,-103,Severe
17,3,207,F,15,5,11,71,-136,Severe
7,1,85,F,80,11,3,135,50,Well
10,0,120,F,69,10,1,121,1,Good
17,5,209,M,77,10,11,131,-78,Severe
6,1,73,M,37,7,3,87,14,Well
7,3,87,F,8,5,6,66,-21,Severe
9,5,113,M,50,8,3,99,-14,Severe
17,6,210,M,30,6,9,81,-129,Severe
9,8,116,F,18,6,1,73,-43,Severe
13,9,165,F,76,10,10,130,-35,Severe
9,5,113,M,78,11,0,132,19,Well
10,4,124,M,104,13,7,163,39,Well
11,6,138,F,86,11,10,142,4,Good
6,7,79,F,103,13,6,162,83,Well
11,8,140,M,3,5,3,63,-77,Severe
5,6,66,M,21,6,2,74,8,Well
14,2,170,M,84,11,7,139,-31,Severe
14,8,176,M,42,7,7,91,-85,Severe
12,9,153,M,104,13,7,163,10,Well
12,7,151,F,59,9,1,109,-42,Severe
16,10,202,M,59,9,1,109,-93,Severe
17,6,210,F,59,9,1,109,-101,Severe
16,3,195,F,56,8,9,105,-90,Severe
18,3,219,M,65,9,8,116,-103,Severe
12,6,150,M,71,10,3,123,-27,Severe
5,6,66,F,45,7,10,94,28,Well
17,3,207,F,93,12,6,150,-57,Severe
16,5,197,F,21,6,2,74,-123,Severe
5,9,69,F,58,9,0,108,39,Well
15,5,185,M,104,13,7,163,-22,Severe
11,6,138,M,27,6,7,79,-59,Severe
15,2,182,M,35,7,1,85,-97,Severe
18,6,222,F,19,6,1,73,-149,Severe
17,5,209,F,102,13,6,162,-47,Severe
16,8,200,F,43,7,8,92,-108,Severe
17,6,210,F,41,7,6,90,-120,Severe
18,10,226,M,102,13,6,162,-64,Severe
7,8,92,F,100,13,3,159,67,Well
11,0,132,F,67,9,10,118,-14,Severe
8,9,105,F,85,11,9,141,36,Well
9,8,116,M,76,10,10,130,14,Well
14,4,172,F,108,14,0,168,-4,Mild
18,3,219,M,9,5,7,67,-152,Severe
18,10,226,F,57,8,10,106,-120,Severe
17,1,205,F,15,5,11,71,-134,Severe
9,2,110,F,40,7,5,89,-21,Severe
8,5,101,F,7,5,6,66,-35,Severe
8,0,96,M,87,11,11,143,47,Well
9,6,114,F,37,7,3,87,-27,Severe
8,2,98,F,92,12,5,149,51,Well
8,4,100,M,29,6,8,80,-20,Severe
12,2,146,M,86,11,10,142,-4,Mild
11,5,137,F,35,7,1,85,-52,Severe
6,3,75,F,11,5,8,68,-7,Severe
8,4,100,M,73,10,6,126,26,Well
9,2,110,M,10,5,7,67,-43,Severe
12,9,153,F,92,12,5,149,-4,Mild
15,3,183,F,46,7,11,95,-88,Severe
11,8,140,F,93,12,6,150,10,Well
14,5,173,F,29,6,8,80,-93,Severe
12,4,148,F,102,13,6,162,14,Well
6,8,80,M,88,12,0,144,64,Well
18,10,226,M,70,10,2,122,-104,Severe
9,6,114,F,64,9,7,115,1,Good
11,11,143,M,50,8,3,99,-44,Severe
12,6,150,F,42,7,7,91,-59,Severe
13,4,160,M,11,5,8,68,-92,Severe
10,1,121,M,81,11,4,136,15,Well
11,1,133,F,41,7,6,90,-43,Severe
13,3,159,M,18,6,1,73,-86,Severe
7,7,91,M,72,10,4,124,33,Well
7,10,94,F,29,6,8,80,-14,Severe
10,11,131,M,53,8,6,102,-29,Severe
6,9,81,F,92,12,5,149,68,Well
11,3,135,F,7,5,6,66,-69,Severe
6,1,73,M,101,13,4,160,87,Well
12,1,145,F,32,6,10,82,-63,Severe
17,0,204,F,16,5,11,71,-133,Severe
6,5,77,F,38,7,4,88,11,Well
5,3,63,M,47,8,0,96,33,Well
10,7,127,F,41,7,6,90,-37,Severe
13,4,160,F,12,5,9,69,-91,Severe
17,9,213,F,108,14,0,168,-45,Severe
14,3,171,M,82,11,5,137,-34,Severe
10,6,126,M,94,12,7,151,25,Well
15,11,191,M,93,12,6,150,-41,Severe
8,8,104,M,10,5,7,67,-37,Severe
7,4,88,M,100,13,3,159,71,Well
17,5,209,M,84,11,7,139,-70,Severe
5,0,60,F,94,12,7,151,91,Well
14,2,170,M,56,8,9,105,-65,Severe
8,2,98,M,104,13,7,163,65,Well
5,4,64,M,30,6,9,81,17,Well
10,7,127,F,16,5,11,71,-56,Severe
9,7,115,F,58,9,0,108,-7,Severe
9,6,114,F,69,10,1,121,7,Well
5,6,66,M,107,13,11,167,101,Well
15,9,189,M,64,9,7,115,-74,Severe
14,10,178,M,65,9,8,116,-62,Severe
14,6,174,M,13,5,9,69,-105,Severe
15,8,188,M,58,9,0,108,-80,Severe
12,11,155,M,83,11,6,138,-17,Severe
16,4,196,F,96,12,10,154,-42,Severe
7,8,92,M,100,13,3,159,67,Well
9,11,119,F,75,10,9,129,10,Well
18,4,220,M,67,9,10,118,-102,Severe
17,9,213,F,12,5,9,69,-144,Severe
18,4,220,M,78,11,0,132,-88,Severe
11,8,140,F,49,8,2,98,-42,Severe
14,2,170,M,71,10,3,123,-47,Severe
15,3,183,M,90,12,3,147,-36,Severe
12,3,147,F,84,11,7,139,-8,Severe
16,5,197,F,102,13,6,162,-35,Severe
11,1,133,M,109,14,1,169,36,Well
9,9,117,M,12,5,9,69,-48,Severe
7,9,93,M,81,11,4,136,43,Well
7,11,95,F,67,9,10,118,23,Well
15,3,183,M,41,7,6,90,-93,Severe
12,5,149,M,64,9,7,115,-34,Severe
11,9,141,F,58,9,0,108,-33,Severe
16,5,197,M,27,6,7,79,-118,Severe
17,2,206,F,104,13,7,163,-43,Severe
10,6,126,F,109,14,1,169,43,Well
9,3,111,F,2,5,3,63,-48,Severe
14,7,175,M,94,12,7,151,-24,Severe
12,11,155,M,109,14,1,169,14,Well
5,10,70,M,104,13,7,163,93,Well
8,0,96,F,54,8,7,103,7,Well
13,9,165,M,67,9,10,118,-47,Severe
15,3,183,M,49,8,2,98,-85,Severe
13,7,163,F,44,7,9,93,-70,Severe
14,9,177,F,61,9,3,111,-66,Severe
8,1,97,M,6,5,5,65,-32,Severe
16,7,199,M,29,6,8,80,-119,Severe
13,3,159,M,86,11,10,142,-17,Severe
12,7,151,F,21,6,2,74,-77,Severe
15,8,188,M,23,6,4,76,-112,Severe
12,10,154,F,67,9,10,118,-36,Severe
6,3,75,F,88,12,0,144,69,Well
6,7,79,F,95,12,9,153,74,Well
11,1,133,M,72,10,4,124,-9,Severe
13,2,158,F,9,5,7,67,-91,Severe
16,4,196,M,51,8,4,100,-96,Severe
8,9,105,M,76,10,10,130,25,Well
11,11,143,F,89,12,1,145,2,Good
13,1,157,M,53,8,6,102,-55,Severe
12,3,147,M,107,13,11,167,20,Well
6,3,75,F,12,5,9,69,-6,Severe
16,5,197,M,87,11,11,143,-54,Severe
7,11,95,F,92,12,5,149,54,Well
5,11,71,F,57,8,10,106,35,Well
16,1,193,M,17,6,0,72,-121,Severe
7,0,84,M,4,5,4,64,-20,Severe
13,9,165,F,52,8,5,101,-64,Severe
17,4,208,M,45,7,10,94,-114,Severe
6,2,74,M,43,7,8,92,18,Well
9,8,116,F,79,11,1,133,17,Well
5,4,64,F,61,9,3,111,47,Well
6,11,83,M,7,5,6,66,-17,Severe
9,2,110,F,88,12,0,144,34,Well
5,8,68,M,91,12,4,148,80,Well
10,8,128,M,35,7,1,85,-43,Severe
5,10,70,F,15,5,11,71,1,Good
16,6,198,F,6,5,5,65,-133,Severe
16,2,194,M,42,7,7,91,-103,Severe
5,10,70,M,62,9,4,112,42,Well
17,9,213,M,104,13,7,163,-50,Severe
8,4,100,F,101,13,4,160,60,Well
8,6,102,F,76,10,10,130,28,Well
5,4,64,F,52,8,5,101,37,Well
16,1,193,M,34,7,0,84,-109,Severe
9,3,111,M,6,5,5,65,-46,Severe
11,8,140,M,21,6,2,74,-66,Severe
7,2,86,M,63,9,6,114,28,Well
8,9,105,M,88,12,0,144,39,Well
10,1,121,F,11,5,8,68,-53,Severe
12,10,154,F,18,6,1,73,-81,Severe
5,3,63,M,87,11,11,143,80,Well
11,10,142,F,103,13,6,162,20,Well
18,0,216,M,15,5,11,71,-145,Severe
18,3,219,M,44,7,9,93,-126,Severe
15,11,191,F,3,5,3,63,-128,Severe
16,4,196,F,75,10,9,129,-67,Severe
15,5,185,F,109,14,1,169,-16,Severe
18,1,217,M,86,11,10,142,-75,Severe
14,1,169,F,17,6,0,72,-97,Severe
7,8,92,F,49,8,2,98,6,Well
8,7,103,M,15,5,11,71,-32,Severe
12,1,145,M,54,8,7,103,-42,Severe
17,1,205,F,42,7,7,91,-114,Severe
14,0,168,F,56,8,9,105,-63,Severe
16,4,196,F,99,13,1,157,-39,Severe
11,7,139,F,74,10,7,127,-12,Severe
5,7,67,F,105,13,9,165,98,Well
8,11,107,F,83,11,6,138,31,Well
5,3,63,F,24,6,5,77,14,Well
7,1,85,F,74,10,7,127,42,Well
15,9,189,F,88,12,0,144,-45,Severe
13,2,158,F,95,12,9,153,-5,Mild
5,1,61,F,77,10,11,131,70,Well
6,6,78,M,66,9,9,117,39,Well
17,10,214,F,96,12,10,154,-60,Severe
11,1,133,F,17,6,0,72,-61,Severe
13,8,164,M,57,8,10,106,-58,Severe
11,7,139,F,96,12,10,154,15,Well
9,2,110,F,34,7,0,84,-26,Severe
5,4,64,M,43,7,8,92,28,Well
18,6,222,M,79,11,1,133,-89,Severe
10,3,123,F,77,10,11,131,8,Well
5,11,71,M,109,14,1,169,98,Well
13,1,157,M,103,13,6,162,5,Good
14,6,174,F,101,13,4,160,-14,Severe
18,0,216,M,25,6,5,77,-139,Severe
18,4,220,F,30,6,9,81,-139,Severe
8,7,103,F,39,7,5,89,-14,Severe
12,10,154,F,32,6,10,82,-72,Severe
17,1,205,F,51,8,4,100,-105,Severe
15,9,189,M,89,12,1,145,-44,Severe
7,9,93,F,94,12,7,151,58,Well
8,11,107,M,34,7,0,84,-23,Severe
9,11,119,M,11,5,8,68,-51,Severe
9,10,118,F,103,13,6,162,44,Well
6,2,74,F,7,5,6,66,-8,Severe
12,7,151,F,95,12,9,153,2,Good
16,10,202,F,51,8,4,100,-102,Severe
13,4,160,M,87,11,11,143,-17,Severe
16,2,194,M,68,10,0,120,-74,Severe
7,0,84,F,90,12,3,147,63,Well
5,11,71,M,10,5,7,67,-4,Mild
13,2,158,M,10,5,7,67,-91,Severe
13,10,166,M,105,13,9,165,-1,Mild
16,11,203,F,83,11,6,138,-65,Severe
13,3,159,F,78,11,0,132,-27,Severe
11,1,133,M,17,6,0,72,-61,Severe
12,0,144,F,59,9,1,109,-35,Severe
7,0,84,F,48,8,1,97,13,Well
15,0,180,M,91,12,4,148,-32,Severe
16,4,196,F,37,7,3,87,-109,Severe
18,10,226,M,19,6,1,73,-153,Severe
13,4,160,M,80,11,3,135,-25,Severe
8,1,97,F,3,5,3,63,-34,Severe
14,6,174,M,57,8,10,106,-68,Severe
18,2,218,F,75,10,9,129,-89,Severe
13,6,162,M,26,6,6,78,-84,Severe
9,9,117,M,21,6,2,74,-43,Severe
5,3,63,M,47,8,0,96,33,Well
17,5,209,M,57,8,10,106,-103,Severe
18,7,223,F,43,7,8,92,-131,Severe
9,11,119,F,63,9,6,114,-5,Mild
10,7,127,F,70,10,2,122,-5,Mild
10,1,121,M,6,5,5,65,-56,Severe
8,0,96,M,39,7,5,89,-7,Severe
11,0,132,F,13,5,9,69,-63,Severe
8,3,99,F,61,9,3,111,12,Well
12,0,144,M,73,10,6,126,-18,Severe
18,3,219,F,15,5,11,71,-148,Severe
7,6,90,F,12,5,9,69,-21,Severe
18,4,220,F,94,12,7,151,-69,Severe
6,3,75,F,50,8,3,99,24,Well
11,2,134,F,23,6,4,76,-58,Severe
14,1,169,M,9,5,7,67,-102,Severe
5,9,69,M,15,5,11,71,2,Good
6,1,73,F,90,12,3,147,74,Well
9,0,108,F,35,7,1,85,-23,Severe
12,3,147,F,75,10,9,129,-18,Severe
10,1,121,F,42,7,7,91,-30,Severe
13,4,160,M,108,14,0,168,8,Well
6,8,80,F,106,13,10,166,86,Well
7,7,91,F,26,6,6,78,-13,Severe
14,1,169,F,39,7,5,89,-80,Severe
6,8,80,F,74,10,7,127,47,Well
6,7,79,M,16,5,11,71,-8,Severe
13,9,165,F,61,9,3,111,-54,Severe
13,1,157,M,88,12,0,144,-13,Severe
14,6,174,M,52,8,5,101,-73,Severe
7,2,86,F,89,12,1,145,59,Well
16,2,194,M,105,13,9,165,-29,Severe
5,9,69,M,103,13,6,162,93,Well
7,4,88,F,80,11,3,135,47,Well
11,5,137,F,15,5,11,71,-66,Severe
12,8,152,F,71,10,3,123,-29,Severe
13,3,159,F,100,13,3,159,0,Neutral
6,3,75,F,104,13,7,163,88,Well
10,11,131,F,11,5,8,68,-63,Severe
12,3,147,F,6,5,5,65,-82,Severe
8,11,107,F,104,13,7,163,56,Well
16,8,200,M,68,10,0,120,-80,Severe
6,9,81,F,40,7,5,89,8,Well
15,4,184,M,94,12,7,151,-33,Severe
16,0,192,M,58,9,0,108,-84,Severe
12,6,150,F,31,6,9,81,-69,Severe
7,6,90,F,93,12,6,150,60,Well
16,5,197,M,48,8,1,97,-100,Severe
13,3,159,M,39,7,5,89,-70,Severe
11,5,137,F,30,6,9,81,-56,Severe
11,2,134,F,26,6,6,78,-56,Severe
13,3,159,F,60,9,2,110,-49,Severe
5,11,71,M,80,11,3,135,64,Well
17,6,210,F,50,8,3,99,-111,Severe
5,4,64,F,47,8,0,96,32,Well
7,6,90,F,18,6,1,73,-17,Severe
18,9,225,F,70,10,2,122,-103,Severe
5,7,67,F,85,11,9,141,74,Well
7,6,90,F,106,13,10,166,76,Well
15,7,187,M,39,7,5,89,-98,Severe
5,5,65,M,55,8,8,104,39,Well
7,3,87,F,60,9,2,110,23,Well
11,1,133,F,53,8,6,102,-31,Severe
13,1,157,M,12,5,9,69,-88,Severe
18,6,222,F,77,10,11,131,-91,Severe
18,6,222,F,36,7,2,86,-136,Severe
7,10,94,M,36,7,2,86,-8,Severe
14,8,176,M,102,13,6,162,-14,Severe
9,4,112,M,53,8,6,102,-10,Severe
13,0,156,F,96,12,10,154,-2,Mild
16,3,195,M,36,7,2,86,-109,Severe
10,8,128,F,46,7,11,95,-33,Severe
6,3,75,M,83,11,6,138,63,Well
12,7,151,F,48,8,1,97,-54,Severe
9,1,109,F,21,6,2,74,-35,Severe
5,1,61,M,5,5,5,65,4,Good
10,0,120,M,100,13,3,159,39,Well
8,2,98,M,92,12,5,149,51,Well
17,0,204,M,99,13,1,157,-47,Severe
6,6,78,F,67,9,10,118,40,Well
11,5,137,F,105,13,9,165,28,Well
11,6,138,M,48,8,1,97,-41,Severe
10,4,124,F,55,8,8,104,-20,Severe
7,10,94,F,32,6,10,82,-12,Severe
8,9,105,M,10,5,7,67,-38,Severe
16,2,194,M,37,7,3,87,-107,Severe
14,9,177,M,33,6,11,83,-94,Severe
17,10,214,F,3,5,3,63,-151,Severe
16,6,198,M,26,6,6,78,-120,Severe
6,4,76,M,8,5,6,66,-10,Severe
13,1,157,M,10,5,7,67,-90,Severe
15,2,182,M,53,8,6,102,-80,Severe
12,11,155,M,12,5,9,69,-86,Severe
14,2,170,F,104,13,7,163,-7,Severe
6,8,80,M,42,7,7,91,11,Well
6,2,74,F,99,13,1,157,83,Well
13,5,161,M,70,10,2,122,-39,Severe
5,6,66,M,57,8,10,106,40,Well
15,1,181,F,20,6,2,74,-107,Severe
7,0,84,F,109,14,1,169,85,Well
6,3,75,M,26,6,6,78,3,Good
6,8,80,F,102,13,6,162,82,Well
15,7,187,M,81,11,4,136,-51,Severe
13,1,157,M,40,7,5,89,-68,Severe
5,7,67,F,67,9,10,118,51,Well
5,3,63,F,36,7,2,86,23,Well
7,9,93,F,27,6,7,79,-14,Severe
10,4,124,F,6,5,5,65,-59,Severe
10,4,124,M,102,13,6,162,38,Well
8,6,102,F,37,7,3,87,-15,Severe
5,2,62,M,72,10,4,124,62,Well
13,9,165,M,24,6,5,77,-88,Severe
18,0,216,F,5,5,5,65,-151,Severe
8,9,105,M,29,6,8,80,-25,Severe
8,0,96,F,51,8,4,100,4,Good
13,3,159,F,78,11,0,132,-27,Severe
15,3,183,F,74,10,7,127,-56,Severe
18,8,224,F,54,8,7,103,-121,Severe
16,7,199,M,56,8,9,105,-94,Severe
6,9,81,F,59,9,1,109,28,Well
8,0,96,F,60,9,2,110,14,Well
13,10,166,F,3,5,3,63,-103,Severe
9,1,109,M,87,11,11,143,34,Well
16,9,201,F,87,11,11,143,-58,Severe
5,5,65,M,12,5,9,69,4,Good
9,1,109,M,57,8,10,106,-3,Mild
15,8,188,F,65,9,8,116,-72,Severe
12,11,155,F,96,12,10,154,-1,Mild
17,2,206,M,77,10,11,131,-75,Severe
17,5,209,F,32,6,10,82,-127,Severe
6,9,81,F,46,7,11,95,14,Well
16,10,202,F,67,9,10,118,-84,Severe
5,9,69,M,38,7,4,88,19,Well
7,7,91,F,17,6,0,72,-19,Severe
14,7,175,M,14,5,10,70,-105,Severe
15,7,187,F,99,13,1,157,-30,Severe
16,3,195,M,69,10,1,121,-74,Severe
12,3,147,F,98,13,0,156,9,Well
16,5,197,M,70,10,2,122,-75,Severe
14,6,174,M,22,6,3,75,-99,Severe
15,5,185,M,96,12,10,154,-31,Severe
17,1,205,F,37,7,3,87,-118,Severe
8,5,101,M,72,10,4,124,23,Well
12,7,151,F,33,6,11,83,-68,Severe
13,0,156,F,101,13,4,160,4,Good
7,10,94,F,110,14,3,171,77,Well
18,4,220,M,60,9,2,110,-110,Severe
12,11,155,M,84,11,7,139,-16,Severe
11,1,133,F,69,10,1,121,-12,Severe
8,5,101,M,25,6,5,77,-24,Severe
5,4,64,M,26,6,6,78,14,Well
11,9,141,F,73,10,6,126,-15,Severe
13,9,165,F,44,7,9,93,-72,Severe
5,6,66,M,18,6,1,73,7,Well
5,10,70,M,66,9,9,117,47,Well
16,11,203,F,62,9,4,112,-91,Severe
8,1,97,M,48,8,1,97,0,Neutral
9,11,119,F,93,12,6,150,31,Well
9,0,108,M,65,9,8,116,8,Well
5,2,62,M,70,10,2,122,60,Well
17,11,215,F,46,7,11,95,-120,Severe
17,8,212,F,11,5,8,68,-144,Severe
18,1,217,F,19,6,1,73,-144,Severe
7,11,95,F,44,7,9,93,-2,Mild
10,2,122,M,3,5,3,63,-59,Severe
7,3,87,M,93,12,6,150,63,Well
5,4,64,M,103,13,6,162,98,Well
11,3,135,M,103,13,6,162,27,Well
18,3,219,F,32,6,10,82,-137,Severe
12,10,154,M,44,7,9,93,-61,Severe
14,8,176,F,19,6,1,73,-103,Severe
11,8,140,M,88,12,0,144,4,Good
10,10,130,F,76,10,10,130,0,Neutral
12,5,149,F,68,10,0,120,-29,Severe
7,9,93,M,64,9,7,115,22,Well
7,5,89,M,73,10,6,126,37,Well
17,10,214,F,100,13,3,159,-55,Severe
5,11,71,F,91,12,4,148,77,Well
18,2,218,F,73,10,6,126,-92,Severe
17,3,207,F,76,10,10,130,-77,Severe
7,11,95,F,99,13,1,157,62,Well
9,3,111,M,87,11,11,143,32,Well
6,2,74,M,105,13,9,165,91,Well
14,2,170,F,42,7,7,91,-79,Severe
11,3,135,F,36,7,2,86,-49,Severe
16,1,193,M,100,13,3,159,-34,Severe
5,9,69,F,56,8,9,105,36,Well
7,11,95,F,28,6,8,80,-15,Severe
14,9,177,M,29,6,8,80,-97,Severe
16,7,199,M,110,14,3,171,-28,Severe
12,3,147,F,69,10,1,121,-26,Severe
17,9,213,M,89,12,1,145,-68,Severe
14,9,177,F,14,5,10,70,-107,Severe
6,1,73,F,67,9,10,118,45,Well
14,5,173,F,41,7,6,90,-83,Severe
7,4,88,F,25,6,5,77,-11,Severe
9,5,113,F,62,9,4,112,-1,Mild
12,9,153,F,34,7,0,84,-69,Severe
10,3,123,M,105,13,9,165,42,Well
10,0,120,F,79,11,1,133,13,Well
10,3,123,F,23,6,4,76,-47,Severe
11,10,142,F,5,5,5,65,-77,Severe
16,4,196,F,41,7,6,90,-106,Severe
11,8,140,M,67,9,10,118,-22,Severe
8,10,106,F,97,12,11,155,49,Well
9,4,112,F,64,9,7,115,3,Good
6,7,79,M,39,7,5,89,10,Well
10,8,128,F,98,13,0,156,28,Well
5,9,69,F,27,6,7,79,10,Well
5,8,68,M,43,7,8,92,24,Well
18,2,218,F,62,9,4,112,-106,Severe
18,1,217,F,106,13,10,166,-51,Severe
15,6,186,F,51,8,4,100,-86,Severe
7,11,95,F,84,11,7,139,44,Well
18,5,221,M,80,11,3,135,-86,Severe
6,0,72,F,65,9,8,116,44,Well
7,3,87,F,29,6,8,80,-7,Severe
11,5,137,M,6,5,5,65,-72,Severe
14,6,174,M,75,10,9,129,-45,Severe
18,4,220,M,14,5,10,70,-150,Severe
8,3,99,M,70,10,2,122,23,Well
11,10,142,F,50,8,3,99,-43,Severe
18,3,219,M,110,14,3,171,-48,Severe
10,3,123,F,74,10,7,127,4,Good
5,9,69,F,6,5,5,65,-4,Mild
13,4,160,M,92,12,5,149,-11,Severe
10,5,125,M,38,7,4,88,-37,Severe
17,8,212,M,49,8,2,98,-114,Severe
9,1,109,M,8,5,6,66,-43,Severe
14,10,178,M,67,9,10,118,-60,Severe
17,4,208,F,90,12,3,147,-61,Severe
5,9,69,F,66,9,9,117,48,Well
16,11,203,M,34,7,0,84,-119,Severe
6,11,83,M,12,5,9,69,-14,Severe
8,10,106,F,72,10,4,124,18,Well
5,4,64,F,8,5,6,66,2,Good
13,8,164,F,4,5,4,64,-100,Severe
17,11,215,M,26,6,6,78,-137,Severe
15,2,182,F,26,6,6,78,-104,Severe
14,5,173,F,6,5,5,65,-108,Severe
10,11,131,M,101,13,4,160,29,Well
15,10,190,M,51,8,4,100,-90,Severe
7,5,89,M,54,8,7,103,14,Well
13,3,159,F,52,8,5,101,-58,Severe
17,3,207,M,11,5,8,68,-139,Severe
14,5,173,F,17,6,0,72,-101,Severe
9,8,116,M,22,6,3,75,-41,Severe
18,9,225,M,43,7,8,92,-133,Severe
16,0,192,F,51,8,4,100,-92,Severe
13,10,166,F,100,13,3,159,-7,Severe
17,1,205,M,96,12,10,154,-51,Severe
9,11,119,F,101,13,4,160,41,Well
11,0,132,F,3,5,3,63,-69,Severe
18,4,220,F,25,6,5,77,-143,Severe
9,3,111,F,20,6,2,74,-37,Severe
7,10,94,F,56,8,9,105,11,Well
9,6,114,M,74,10,7,127,13,Well
12,11,155,M,51,8,4,100,-55,Severe
16,9,201,F,86,11,10,142,-59,Severe
16,5,197,M,75,10,9,129,-68,Severe
5,8,68,F,50,8,3,99,31,Well
12,10,154,M,85,11,9,141,-13,Severe
9,0,108,M,7,5,6,66,-42,Severe
14,9,177,M,103,13,6,162,-15,Severe
14,3,171,F,28,6,8,80,-91,Severe
12,1,145,M,37,7,3,87,-58,Severe
6,2,74,M,76,10,10,130,56,Well
6,7,79,F,94,12,7,151,72,Well
13,5,161,M,43,7,8,92,-69,Severe
17,0,204,M,91,12,4,148,-56,Severe
8,2,98,F,65,9,8,116,18,Well
12,6,150,M,67,9,10,118,-32,Severe
6,3,75,F,48,8,1,97,22,Well
17,10,214,M,55,8,8,104,-110,Severe
12,2,146,F,43,7,8,92,-54,Severe
14,0,168,M,3,5,3,63,-105,Severe
15,10,190,M,61,9,3,111,-79,Severe
17,6,210,M,76,10,10,130,-80,Severe
15,6,186,F,31,6,9,81,-105,Severe
9,2,110,M,108,14,0,168,58,Well
13,7,163,M,54,8,7,103,-60,Severe
12,3,147,F,22,6,3,75,-72,Severe
10,2,122,F,110,14,3,171,49,Well
5,11,71,M,99,13,1,157,86,Well
13,3,159,M,3,5,3,63,-96,Severe
10,3,123,F,47,8,0,96,-27,Severe
14,5,173,M,21,6,2,74,-99,Severe
10,2,122,M,4,5,4,64,-58,Severe
9,4,112,F,79,11,1,133,21,Well
8,1,97,F,79,11,1,133,36,Well
16,1,193,M,29,6,8,80,-113,Severe
18,1,217,F,32,6,10,82,-135,Severe
13,11,167,M,54,8,7,103,-64,Severe
7,6,90,M,17,6,0,72,-18,Severe
8,9,105,F,51,8,4,100,-5,Mild
5,4,64,M,17,6,0,72,8,Well
12,3,147,F,98,13,0,156,9,Well
18,11,227,M,23,6,4,76,-151,Severe
15,7,187,M,70,10,2,122,-65,Severe
9,7,115,F,3,5,3,63,-52,Severe
8,9,105,M,54,8,7,103,-2,Mild
14,5,173,F,90,12,3,147,-26,Severe
16,2,194,M,109,14,1,169,-25,Severe
15,8,188,M,6,5,5,65,-123,Severe
12,6,150,M,88,12,0,144,-6,Severe
16,11,203,M,79,11,1,133,-70,Severe
9,2,110,F,26,6,6,78,-32,Severe
9,6,114,F,49,8,2,98,-16,Severe
17,11,215,M,97,12,11,155,-60,Severe
8,3,99,M,47,8,0,96,-3,Mild
9,7,115,F,81,11,4,136,21,Well
11,11,143,M,66,9,9,117,-26,Severe
6,3,75,F,24,6,5,77,2,Good
13,9,165,F,28,6,8,80,-85,Severe
12,11,155,M,59,9,1,109,-46,Severe
16,0,192,M,23,6,4,76,-116,Severe
14,10,178,M,44,7,9,93,-85,Severe
14,5,173,M,74,10,7,127,-46,Severe
16,1,193,F,108,14,0,168,-25,Severe
8,8,104,F,99,13,1,157,53,Well
6,4,76,M,48,8,1,97,21,Well
8,0,96,F,56,8,9,105,9,Well
13,9,165,M,30,6,9,81,-84,Severe
7,0,84,M,91,12,4,148,64,Well
14,3,171,M,86,11,10,142,-29,Severe
7,5,89,F,30,6,9,81,-8,Severe
7,2,86,F,67,9,10,118,32,Well
14,6,174,M,106,13,10,166,-8,Severe
9,4,112,M,71,10,3,123,11,Well
8,0,96,F,53,8,6,102,6,Well
5,4,64,M,46,7,11,95,31,Well
18,8,224,M,73,10,6,126,-98,Severe
8,3,99,F,4,5,4,64,-35,Severe
6,4,76,F,19,6,1,73,-3,Mild
8,9,105,M,79,11,1,133,28,Well
5,4,64,M,89,12,1,145,81,Well
8,8,104,M,88,12,0,144,40,Well
6,9,81,M,29,6,8,80,-1,Mild
10,7,127,F,14,5,10,70,-57,Severe
17,6,210,M,63,9,6,114,-96,Severe
13,6,162,M,46,7,11,95,-67,Severe
11,10,142,F,17,6,0,72,-70,Severe
18,2,218,M,46,7,11,95,-123,Severe
11,4,136,M,96,12,10,154,18,Well
5,1,61,M,16,5,11,71,10,Well
13,9,165,M,56,8,9,105,-60,Severe
11,5,137,M,57,8,10,106,-31,Severe
9,8,116,M,109,14,1,169,53,Well
13,8,164,M,68,10,0,120,-44,Severe
6,2,74,F,49,8,2,98,24,Well
5,8,68,M,81,11,4,136,68,Well
17,9,213,M,28,6,8,80,-133,Severe
18,5,221,M,10,5,7,67,-154,Severe
6,0,72,F,73,10,6,126,54,Well
15,3,183,F,15,5,11,71,-112,Severe
6,1,73,M,43,7,8,92,19,Well
14,3,171,F,108,14,0,168,-3,Mild
14,5,173,M,17,6,0,72,-101,Severe
9,3,111,M,77,10,11,131,20,Well
9,3,111,F,45,7,10,94,-17,Severe
6,2,74,M,29,6,8,80,6,Well
8,2,98,M,12,5,9,69,-29,Severe
17,0,204,M,40,7,5,89,-115,Severe
7,6,90,M,21,6,2,74,-16,Severe
7,0,84,M,96,12,10,154,70,Well
10,10,130,F,55,8,8,104,-26,Severe
6,6,78,F,31,6,9,81,3,Good
10,6,126,F,85,11,9,141,15,Well
17,5,209,F,64,9,7,115,-94,Severe
18,9,225,M,76,10,10,130,-95,Severe
6,3,75,M,25,6,5,77,2,Good
12,4,148,M,65,9,8,116,-32,Severe
17,9,213,F,106,13,10,166,-47,Severe
16,11,203,F,16,5,11,71,-132,Severe
11,9,141,F,77,10,11,131,-10,Severe
12,5,149,M,3,5,3,63,-86,Severe
12,3,147,M,30,6,9,81,-66,Severe
12,7,151,M,105,13,9,165,14,Well
12,9,153,M,105,13,9,165,12,Well
11,2,134,M,86,11,10,142,8,Well
12,6,150,F,87,11,11,143,-7,Severe
18,4,220,M,53,8,6,102,-118,Severe
16,3,195,M,86,11,10,142,-53,Severe
6,6,78,M,32,6,10,82,4,Good
18,1,217,F,60,9,2,110,-107,Severe
9,1,109,M,70,10,2,122,13,Well
18,8,224,M,96,12,10,154,-70,Severe
11,7,139,F,44,7,9,93,-46,Severe
18,3,219,F,47,8,0,96,-123,Severe
18,3,219,F,10,5,7,67,-152,Severe
12,11,155,F,79,11,1,133,-22,Severe
16,7,199,M,98,13,0,156,-43,Severe
12,11,155,F,21,6,2,74,-81,Severe
17,7,211,F,81,11,4,136,-75,Severe
15,0,180,F,85,11,9,141,-39,Severe
10,9,129,F,28,6,8,80,-49,Severe
12,4,148,M,20,6,2,74,-74,Severe
13,9,165,M,103,13,6,162,-3,Mild
14,1,169,F,14,5,10,70,-99,Severe
15,5,185,M,106,13,10,166,-19,Severe
10,4,124,M,71,10,3,123,-1,Mild
11,10,142,M,13,5,9,69,-73,Severe
7,3,87,M,99,13,1,157,70,Well
5,1,61,F,95,12,9,153,92,Well
17,8,212,M,56,8,9,105,-107,Severe
8,2,98,M,53,8,6,102,4,Good
12,4,148,M,78,11,0,132,-16,Severe
14,2,170,M,92,12,5,149,-21,Severe
13,7,163,M,77,10,11,131,-32,Severe
15,6,186,F,25,6,5,77,-109,Severe
12,2,146,M,110,14,3,171,25,Well
18,4,220,F,98,13,0,156,-64,Severe
6,0,72,M,103,13,6,162,90,Well
14,6,174,M,26,6,6,78,-96,Severe
7,1,85,M,109,14,1,169,84,Well
16,10,202,M,16,5,11,71,-131,Severe
12,4,148,F,42,7,7,91,-57,Severe
5,4,64,F,3,5,3,63,-1,Mild
17,4,208,F,60,9,2,110,-98,Severe
9,2,110,F,105,13,9,165,55,Well
14,3,171,M,13,5,9,69,-102,Severe
10,1,121,M,94,12,7,151,30,Well
18,7,223,F,23,6,4,76,-147,Severe
13,3,159,M,16,5,11,71,-88,Severe
15,9,189,F,15,5,11,71,-118,Severe
13,1,157,M,73,10,6,126,-31,Severe
12,3,147,F,31,6,9,81,-66,Severe
17,1,205,F,31,6,9,81,-124,Severe
8,7,103,F,96,12,10,154,51,Well
16,1,193,M,61,9,3,111,-82,Severe
9,10,118,F,56,8,9,105,-13,Severe
15,4,184,M,69,10,1,121,-63,Severe
6,5,77,M,97,12,11,155,78,Well
8,6,102,M,100,13,3,159,57,Well
10,7,127,M,82,11,5,137,10,Well
11,3,135,F,13,5,9,69,-66,Severe
11,2,134,F,46,7,11,95,-39,Severe
17,11,215,F,94,12,7,151,-64,Severe
8,3,99,F,2,5,3,63,-36,Severe
5,2,62,M,37,7,3,87,25,Well
14,6,174,M,63,9,6,114,-60,Severe
13,5,161,F,11,5,8,68,-93,Severe
16,1,193,M,66,9,9,117,-76,Severe
10,2,122,M,103,13,6,162,40,Well
15,8,188,F,15,5,11,71,-117,Severe
8,3,99,F,22,6,3,75,-24,Severe
13,6,162,M,88,12,0,144,-18,Severe
18,6,222,M,17,6,0,72,-150,Severe
16,9,201,M,37,7,3,87,-114,Severe
8,3,99,F,35,7,1,85,-14,Severe
12,6,150,F,44,7,9,93,-57,Severe
15,0,180,F,23,6,4,76,-104,Severe
18,11,227,F,83,11,6,138,-89,Severe
6,1,73,F,8,5,6,66,-7,Severe
15,7,187,F,39,7,5,89,-98,Severe
12,3,147,F,23,6,4,76,-71,Severe
8,3,99,F,80,11,3,135,36,Well
11,6,138,M,78,11,0,132,-6,Severe
16,6,198,M,102,13,6,162,-36,Severe
8,0,96,M,88,12,0,144,48,Well
6,4,76,F,64,9,7,115,39,Well
18,3,219,M,79,11,1,133,-86,Severe
16,3,195,M,41,7,6,90,-105,Severe
11,3,135,M,54,8,7,103,-32,Severe
18,11,227,F,30,6,9,81,-146,Severe
14,3,171,M,47,8,0,96,-75,Severe
14,8,176,M,101,13,4,160,-16,Severe
8,2,98,F,9,5,7,67,-31,Severe
12,4,148,M,41,7,6,90,-58,Severe
5,1,61,M,14,5,10,70,9,Well
12,3,147,M,6,5,5,65,-82,Severe
14,6,174,F,21,6,2,74,-100,Severe
13,9,165,M,54,8,7,103,-62,Severe
10,3,123,F,39,7,5,89,-34,Severe
15,3,183,M,80,11,3,135,-48,Severe
11,3,135,M,107,13,11,167,32,Well
10,6,126,M,92,12,5,149,23,Well
12,4,148,F,105,13,9,165,17,Well
17,7,211,F,74,10,7,127,-84,Severe
5,9,69,M,81,11,4,136,67,Well
16,5,197,M,95,12,9,153,-44,Severe
15,6,186,F,37,7,3,87,-99,Severe
12,6,150,M,75,10,9,129,-21,Severe
15,4,184,M,108,14,0,168,-16,Severe
14,1,169,M,29,6,8,80,-89,Severe
6,2,74,F,29,6,8,80,6,Well
15,1,181,F,35,7,1,85,-96,Severe
18,0,216,F,104,13,7,163,-53,Severe
15,5,185,M,79,11,1,133,-52,Severe
15,3,183,F,62,9,4,112,-71,Severe
11,0,132,M,58,9,0,108,-24,Severe
17,11,215,F,105,13,9,165,-50,Severe
17,4,208,F,76,10,10,130,-78,Severe
14,11,179,F,72,10,4,124,-55,Severe
17,3,207,M,13,5,9,69,-138,Severe
13,6,162,M,6,5,5,65,-97,Severe
15,5,185,M,90,12,3,147,-38,Severe
5,7,67,F,66,9,9,117,50,Well
15,10,190,F,30,6,9,81,-109,Severe
12,7,151,F,109,14,1,169,18,Well
15,1,181,F,88,12,0,144,-37,Severe
14,3,171,M,46,7,11,95,-76,Severe
9,2,110,F,15,5,11,71,-39,Severe
8,5,101,M,42,7,7,91,-10,Severe
16,0,192,F,37,7,3,87,-105,Severe
5,5,65,M,8,5,6,66,1,Good
14,1,169,M,54,8,7,103,-66,Severe
6,3,75,F,81,11,4,136,61,Well
16,0,192,M,12,5,9,69,-123,Severe
16,9,201,M,57,8,10,106,-95,Severe
18,5,221,M,41,7,6,90,-131,Severe
18,4,220,F,11,5,8,68,-152,Severe
5,8,68,F,2,5,3,63,-5,Mild
6,2,74,F,19,6,1,73,-1,Mild
16,10,202,F,38,7,4,88,-114,Severe
13,5,161,M,84,11,7,139,-22,Severe
13,11,167,M,37,7,3,87,-80,Severe
16,5,197,M,33,6,11,83,-114,Severe
14,7,175,M,103,13,6,162,-13,Severe
7,3,87,M,102,13,6,162,75,Well
16,0,192,F,14,5,10,70,-122,Severe
15,3,183,M,34,7,0,84,-99,Severe
6,7,79,F,16,5,11,71,-8,Severe
8,2,98,M,14,5,10,70,-28,Severe
12,0,144,M,94,12,7,151,7,Well
15,9,189,M,28,6,8,80,-109,Severe
5,1,61,M,7,5,6,66,5,Good
14,6,174,F,26,6,6,78,-96,Severe
16,4,196,M,11,5,8,68,-128,Severe
14,2,170,F,29,6,8,80,-90,Severe
9,11,119,M,35,7,1,85,-34,Severe
9,3,111,M,9,5,7,67,-44,Severe
14,10,178,M,23,6,4,76,-102,Severe
9,3,111,M,38,7,4,88,-23,Severe
13,5,161,M,97,12,11,155,-6,Severe
16,5,197,M,34,7,0,84,-113,Severe
11,7,139,M,68,10,0,120,-19,Severe
13,3,159,M,45,7,10,94,-65,Severe
16,3,195,M,21,6,2,74,-121,Severe
7,3,87,M,12,5,9,69,-18,Severe
10,11,131,M,6,5,5,65,-66,Severe
9,6,114,M,77,10,11,131,17,Well
10,10,130,F,96,12,10,154,24,Well
18,1,217,F,85,11,9,141,-76,Severe
6,5,77,M,96,12,10,154,77,Well
15,2,182,F,18,6,1,73,-109,Severe
17,3,207,M,78,11,0,132,-75,Severe
10,11,131,M,51,8,4,100,-31,Severe
17,6,210,M,46,7,11,95,-115,Severe
18,9,225,M,103,13,6,162,-63,Severe
13,2,158,M,36,7,2,86,-72,Severe
14,8,176,M,63,9,6,114,-62,Severe
8,9,105,F,21,6,2,74,-31,Severe
12,3,147,M,62,9,4,112,-35,Severe
15,9,189,F,37,7,3,87,-102,Severe
14,2,170,F,13,5,9,69,-101,Severe
13,4,160,M,96,12,10,154,-6,Severe
12,2,146,F,56,8,9,105,-41,Severe
16,10,202,M,82,11,5,137,-65,Severe
12,7,151,F,45,7,10,94,-57,Severe
7,0,84,F,19,6,1,73,-11,Severe
12,6,150,F,66,9,9,117,-33,Severe
16,5,197,M,10,5,7,67,-130,Severe
6,6,78,F,89,12,1,145,67,Well
8,9,105,F,3,5,3,63,-42,Severe
11,1,133,F,73,10,6,126,-7,Severe
12,2,146,F,60,9,2,110,-36,Severe
8,11,107,M,75,10,9,129,22,Well
14,6,174,F,5,5,5,65,-109,Severe
9,5,113,M,81,11,4,136,23,Well
14,3,171,M,35,7,1,85,-86,Severe
12,5,149,M,90,12,3,147,-2,Mild
16,11,203,M,52,8,5,101,-102,Severe
17,6,210,F,62,9,4,112,-98,Severe
17,4,208,M,100,13,3,159,-49,Severe
6,0,72,M,39,7,5,89,17,Well
18,1,217,M,66,9,9,117,-100,Severe
14,1,169,F,40,7,5,89,-80,Severe
13,7,163,M,94,12,7,151,-12,Severe
8,6,102,M,60,9,2,110,8,Well
13,7,163,F,59,9,1,109,-54,Severe
16,2,194,M,2,5,3,63,-131,Severe
12,3,147,F,63,9,6,114,-33,Severe
7,7,91,M,71,10,3,123,32,Well
9,6,114,F,18,6,1,73,-41,Severe
5,6,66,M,52,8,5,101,35,Well
5,2,62,M,51,8,4,100,38,Well
8,4,100,F,48,8,1,97,-3,Mild
15,5,185,M,110,14,3,171,-14,Severe
10,0,120,F,16,5,11,71,-49,Severe
7,2,86,M,25,6,5,77,-9,Severe
8,6,102,M,25,6,5,77,-25,Severe
12,2,146,M,76,10,10,130,-16,Severe
12,3,147,F,89,12,1,145,-2,Mild
6,9,81,M,46,7,11,95,14,Well
11,11,143,M,100,13,3,159,16,Well
17,8,212,M,19,6,1,73,-139,Severe
10,3,123,F,48,8,1,97,-26,Severe
17,9,213,F,2,5,3,63,-150,Severe
13,0,156,M,84,11,7,139,-17,Severe
16,0,192,M,38,7,4,88,-104,Severe
14,10,178,F,90,12,3,147,-31,Severe
17,3,207,F,83,11,6,138,-69,Severe
13,3,159,F,79,11,1,133,-26,Severe
12,6,150,M,51,8,4,100,-50,Severe
16,1,193,M,58,9,0,108,-85,Severe
11,11,143,M,16,5,11,71,-72,Severe
8,0,96,M,76,10,10,130,34,Well
6,2,74,F,69,10,1,121,47,Well
14,0,168,M,28,6,8,80,-88,Severe
5,0,60,M,80,11,3,135,75,Well
12,7,151,F,62,9,4,112,-39,Severe
7,7,91,M,97,12,11,155,64,Well
8,7,103,F,47,8,0,96,-7,Severe
5,11,71,M,17,6,0,72,1,Good
16,9,201,M,85,11,9,141,-60,Severe
17,3,207,F,92,12,5,149,-58,Severe
14,2,170,F,20,6,2,74,-96,Severe
7,3,87,F,87,11,11,143,56,Well
14,11,179,F,82,11,5,137,-42,Severe
7,9,93,M,11,5,8,68,-25,Severe
11,3,135,F,95,12,9,153,18,Well
7,9,93,M,49,8,2,98,5,Good
8,6,102,M,22,6,3,75,-27,Severe
13,3,159,F,94,12,7,151,-8,Severe
14,9,177,M,110,14,3,171,-6,Severe
6,6,78,F,83,11,6,138,60,Well
8,11,107,F,65,9,8,116,9,Well
14,0,168,M,82,11,5,137,-31,Severe
18,10,226,M,8,5,6,66,-160,Severe
10,0,120,M,109,14,1,169,49,Well
12,5,149,F,20,6,2,74,-75,Severe
9,3,111,M,83,11,6,138,27,Well
16,7,199,F,78,11,0,132,-67,Severe
5,3,63,F,4,5,4,64,1,Good
10,7,127,F,85,11,9,141,14,Well
6,3,75,M,95,12,9,153,78,Well
14,2,170,F,84,11,7,139,-31,Severe
16,4,196,M,70,10,2,122,-74,Severe
15,4,184,M,28,6,8,80,-104,Severe
14,0,168,F,8,5,6,66,-102,Severe
5,3,63,F,96,12,10,154,91,Well
16,9,201,F,54,8,7,103,-98,Severe
11,5,137,F,87,11,11,143,6,Well
11,4,136,M,25,6,5,77,-59,Severe
6,7,79,F,21,6,2,74,-5,Mild
17,2,206,F,4,5,4,64,-142,Severe
16,6,198,F,2,5,3,63,-135,Severe
6,2,74,F,36,7,2,86,12,Well
15,7,187,F,18,6,1,73,-114,Severe
16,7,199,M,21,6,2,74,-125,Severe
11,0,132,M,72,10,4,124,-8,Severe
10,3,123,F,73,10,6,126,3,Good
10,2,122,M,11,5,8,68,-54,Severe
6,10,82,M,99,13,1,157,75,Well
11,2,134,M,73,10,6,126,-8,Severe
18,6,222,M,22,6,3,75,-147,Severe
15,3,183,F,77,10,11,131,-52,Severe
5,5,65,M,64,9,7,115,50,Well
5,10,70,M,61,9,3,111,41,Well
9,8,116,F,11,5,8,68,-48,Severe
11,5,137,M,63,9,6,114,-23,Severe
11,8,140,M,19,6,1,73,-67,Severe
18,6,222,F,27,6,7,79,-143,Severe
5,5,65,F,83,11,6,138,73,Well
18,7,223,F,97,12,11,155,-68,Severe
12,3,147,M,16,5,11,71,-76,Severe
9,1,109,F,93,12,6,150,41,Well
14,11,179,M,24,6,5,77,-102,Severe
14,3,171,F,29,6,8,80,-91,Severe
6,9,81,M,56,8,9,105,24,Well
13,6,162,M,95,12,9,153,-9,Severe
13,3,159,M,95,12,9,153,-6,Severe
17,7,211,M,50,8,3,99,-112,Severe
10,2,122,M,24,6,5,77,-45,Severe
5,9,69,F,62,9,4,112,43,Well
5,3,63,M,53,8,6,102,39,Well
17,1,205,M,8,5,6,66,-139,Severe
15,7,187,M,74,10,7,127,-60,Severe
5,4,64,F,59,9,1,109,45,Well
11,3,135,M,108,14,0,168,33,Well
5,6,66,F,52,8,5,101,35,Well
7,8,92,F,108,14,0,168,76,Well
16,9,201,F,45,7,10,94,-107,Severe
14,1,169,F,6,5,5,65,-104,Severe
17,7,211,M,60,9,2,110,-101,Severe
17,6,210,F,45,7,10,94,-116,Severe
9,1,109,F,91,12,4,148,39,Well
14,10,178,F,36,7,2,86,-92,Severe
13,8,164,F,53,8,6,102,-62,Severe
8,3,99,M,90,12,3,147,48,Well
15,10,190,F,106,13,10,166,-24,Severe
16,8,200,F,55,8,8,104,-96,Severe
9,2,110,F,104,13,7,163,53,Well
11,6,138,F,23,6,4,76,-62,Severe
10,9,129,M,33,6,11,83,-46,Severe
14,11,179,M,3,5,3,63,-116,Severe
11,2,134,M,47,8,0,96,-38,Severe
18,4,220,M,70,10,2,122,-98,Severe
9,5,113,M,32,6,10,82,-31,Severe
7,10,94,F,58,9,0,108,14,Well
7,1,85,M,98,13,0,156,71,Well
5,10,70,M,67,9,10,118,48,Well
7,11,95,M,10,5,7,67,-28,Severe
5,1,61,F,94,12,7,151,90,Well
12,10,154,F,34,7,0,84,-70,Severe
8,3,99,M,58,9,0,108,9,Well
11,10,142,F,8,5,6,66,-76,Severe
12,11,155,M,89,12,1,145,-10,Severe
13,3,159,F,43,7,8,92,-67,Severe
9,4,112,F,90,12,3,147,35,Well
7,3,87,F,109,14,1,169,82,Well
6,0,72,F,86,11,10,142,70,Well
11,5,137,F,47,8,0,96,-41,Severe
11,3,135,F,40,7,5,89,-46,Severe
7,5,89,F,20,6,2,74,-15,Severe
17,7,211,M,51,8,4,100,-111,Severe
14,8,176,F,12,5,9,69,-107,Severe
8,10,106,M,44,7,9,93,-13,Severe
12,4,148,F,56,8,9,105,-43,Severe
7,0,84,F,3,5,3,63,-21,Severe
10,9,129,F,72,10,4,124,-5,Mild
18,3,219,M,57,8,10,106,-113,Severe
15,2,182,M,8,5,6,66,-116,Severe
14,6,174,F,38,7,4,88,-86,Severe
9,0,108,M,43,7,8,92,-16,Severe
9,5,113,M,77,10,11,131,18,Well
8,10,106,F,109,14,1,169,63,Well
12,8,152,M,14,5,10,70,-82,Severe
5,8,68,M,83,11,6,138,70,Well
9,2,110,M,18,6,1,73,-37,Severe
17,0,204,M,75,10,9,129,-75,Severe
17,10,214,F,45,7,10,94,-120,Severe
8,1,97,M,42,7,7,91,-6,Severe
18,5,221,F,105,13,9,165,-56,Severe
10,9,129,F,98,13,0,156,27,Well
14,1,169,F,34,7,0,84,-85,Severe
10,7,127,M,80,11,3,135,8,Well
11,10,142,F,3,5,3,63,-79,Severe
12,6,150,M,59,9,1,109,-41,Severe
16,10,202,M,78,11,0,132,-70,Severe
14,10,178,M,40,7,5,89,-89,Severe
15,2,182,F,7,5,6,66,-116,Severe
13,8,164,M,45,7,10,94,-70,Severe
10,6,126,F,74,10,7,127,1,Good
16,0,192,F,44,7,9,93,-99,Severe
5,0,60,M,73,10,6,126,66,Well
9,6,114,M,98,13,0,156,42,Well
14,10,178,F,38,7,4,88,-90,Severe
17,3,207,F,110,14,3,171,-36,Severe
18,10,226,F,36,7,2,86,-140,Severe
10,0,120,F,4,5,4,64,-56,Severe
8,9,105,F,68,10,0,120,15,Well
18,10,226,M,39,7,5,89,-137,Severe
5,3,63,M,91,12,4,148,85,Well
17,8,212,M,65,9,8,116,-96,Severe
7,9,93,F,50,8,3,99,6,Well
13,3,159,F,65,9,8,116,-43,Severe
11,11,143,F,27,6,7,79,-64,Severe
12,1,145,M,89,12,1,145,0,Neutral
9,7,115,M,77,10,11,131,16,Well
15,2,182,F,23,6,4,76,-106,Severe
13,3,159,F,11,5,8,68,-91,Severe
14,7,175,M,25,6,5,77,-98,Severe
7,1,85,M,52,8,5,101,16,Well
13,0,156,F,74,10,7,127,-29,Severe
11,0,132,F,109,14,1,169,37,Well
11,3,135,F,109,14,1,169,34,Well
18,9,225,F,29,6,8,80,-145,Severe
9,7,115,M,84,11,7,139,24,Well
17,3,207,M,89,12,1,145,-62,Severe
12,9,153,F,4,5,4,64,-89,Severe
6,0,72,F,105,13,9,165,93,Well
16,10,202,F,47,8,0,96,-106,Severe
14,1,169,M,35,7,1,85,-84,Severe
15,3,183,F,3,5,3,63,-120,Severe
10,6,126,M,39,7,5,89,-37,Severe
13,8,164,F,108,14,0,168,4,Good
13,8,164,M,73,10,6,126,-38,Severe
17,8,212,F,75,10,9,129,-83,Severe
7,0,84,F,11,5,8,68,-16,Severe
14,7,175,F,98,13,0,156,-19,Severe
6,0,72,F,99,13,1,157,85,Well
17,0,204,M,64,9,7,115,-89,Severe
7,2,86,M,101,13,4,160,74,Well
18,1,217,F,68,10,0,120,-97,Severe
12,0,144,F,20,6,2,74,-70,Severe
14,7,175,F,42,7,7,91,-84,Severe
17,10,214,F,34,7,0,84,-130,Severe
17,9,213,F,57,8,10,106,-107,Severe
18,0,216,M,13,5,9,69,-147,Severe
17,1,205,F,64,9,7,115,-90,Severe
7,6,90,F,67,9,10,118,28,Well
5,6,66,M,50,8,3,99,33,Well
15,1,181,M,57,8,10,106,-75,Severe
17,2,206,M,66,9,9,117,-89,Severe
15,11,191,M,104,13,7,163,-28,Severe
8,1,97,F,25,6,5,77,-20,Severe
9,7,115,M,50,8,3,99,-16,Severe
12,7,151,M,60,9,2,110,-41,Severe
9,1,109,M,72,10,4,124,15,Well
7,9,93,F,103,13,6,162,69,Well
6,7,79,M,102,13,6,162,83,Well
6,5,77,F,62,9,4,112,35,Well
11,6,138,M,66,9,9,117,-21,Severe
8,11,107,M,28,6,8,80,-27,Severe
7,8,92,F,107,13,11,167,75,Well
16,1,193,M,50,8,3,99,-94,Severe
15,1,181,M,53,8,6,102,-79,Severe
5,2,62,F,18,6,1,73,11,Well
11,3,135,M,95,12,9,153,18,Well
7,1,85,F,72,10,4,124,39,Well
9,9,117,F,80,11,3,135,18,Well
8,9,105,F,104,13,7,163,58,Well
9,7,115,M,47,8,0,96,-19,Severe
14,4,172,F,25,6,5,77,-95,Severe
18,5,221,M,71,10,3,123,-98,Severe
17,1,205,F,86,11,10,142,-63,Severe
13,10,166,F,82,11,5,137,-29,Severe
18,0,216,F,71,10,3,123,-93,Severe
15,9,189,M,15,5,11,71,-118,Severe
5,10,70,F,64,9,7,115,45,Well
12,3,147,M,53,8,6,102,-45,Severe
15,0,180,M,60,9,2,110,-70,Severe
7,1,85,M,15,5,11,71,-14,Severe
17,3,207,M,80,11,3,135,-72,Severe
13,9,165,F,74,10,7,127,-38,Severe
16,0,192,F,89,12,1,145,-47,Severe
7,1,85,F,44,7,9,93,8,Well
11,10,142,M,27,6,7,79,-63,Severe
18,5,221,M,4,5,4,64,-157,Severe
12,0,144,F,70,10,2,122,-22,Severe
17,6,210,M,18,6,1,73,-137,Severe
5,9,69,F,21,6,2,74,5,Good
16,6,198,F,56,8,9,105,-93,Severe
12,3,147,M,60,9,2,110,-37,Severe
11,0,132,F,52,8,5,101,-31,Severe
12,2,146,F,57,8,10,106,-40,Severe
8,7,103,F,15,5,11,71,-32,Severe
9,8,116,M,34,7,0,84,-32,Severe
6,7,79,M,9,5,7,67,-12,Severe
14,5,173,M,55,8,8,104,-69,Severe
8,0,96,M,50,8,3,99,3,Good
13,11,167,M,100,13,3,159,-8,Severe
7,8,92,F,93,12,6,150,58,Well
12,3,147,F,74,10,7,127,-20,Severe
17,8,212,M,10,5,7,67,-145,Severe
17,3,207,M,61,9,3,111,-96,Severe
15,8,188,F,42,7,7,91,-97,Severe
15,3,183,M,110,14,3,171,-12,Severe
18,6,222,F,96,12,10,154,-68,Severe
12,7,151,F,50,8,3,99,-52,Severe
16,6,198,F,42,7,7,91,-107,Severe
10,11,131,M,31,6,9,81,-50,Severe
9,7,115,M,12,5,9,69,-46,Severe
6,5,77,F,87,11,11,143,66,Well
10,11,131,M,100,13,3,159,28,Well
8,11,107,M,33,6,11,83,-24,Severe
13,11,167,M,64,9,7,115,-52,Severe
18,7,223,F,87,11,11,143,-80,Severe
12,10,154,M,53,8,6,102,-52,Severe
18,7,223,M,45,7,10,94,-129,Severe
18,3,219,F,104,13,7,163,-56,Severe
18,4,220,F,2,5,3,63,-157,Severe
7,2,86,F,66,9,9,117,31,Well
14,7,175,F,2,5,3,63,-112,Severe
17,11,215,F,35,7,1,85,-130,Severe
9,9,117,M,53,8,6,102,-15,Severe
17,7,211,F,20,6,2,74,-137,Severe
16,3,195,F,91,12,4,148,-47,Severe
8,7,103,F,53,8,6,102,-1,Mild
15,7,187,M,83,11,6,138,-49,Severe
10,3,123,F,93,12,6,150,27,Well
12,8,152,F,67,9,10,118,-34,Severe
15,1,181,F,86,11,10,142,-39,Severe
5,10,70,M,78,11,0,132,62,Well
16,3,195,M,33,6,11,83,-112,Severe
17,3,207,M,76,10,10,130,-77,Severe
15,2,182,M,96,12,10,154,-28,Severe
9,11,119,M,48,8,1,97,-22,Severe
10,8,128,M,38,7,4,88,-40,Severe
14,3,171,M,3,5,3,63,-108,Severe
13,6,162,M,86,11,10,142,-20,Severe
14,3,171,F,46,7,11,95,-76,Severe
9,11,119,M,33,6,11,83,-36,Severe
11,7,139,M,45,7,10,94,-45,Severe
14,2,170,F,105,13,9,165,-5,Mild
10,7,127,M,33,6,11,83,-44,Severe
13,0,156,F,20,6,2,74,-82,Severe
6,3,75,M,9,5,7,67,-8,Severe
15,2,182,F,13,5,9,69,-113,Severe
7,6,90,F,60,9,2,110,20,Well
17,5,209,M,89,12,1,145,-64,Severe
6,0,72,F,62,9,4,112,40,Well
13,9,165,F,46,7,11,95,-70,Severe
10,3,123,M,76,10,10,130,7,Well
7,3,87,F,33,6,11,83,-4,Mild
7,1,85,M,74,10,7,127,42,Well
7,3,87,F,59,9,1,109,22,Well
10,4,124,M,38,7,4,88,-36,Severe
8,10,106,M,2,5,3,63,-43,Severe
6,6,78,F,28,6,8,80,2,Good
15,0,180,F,37,7,3,87,-93,Severe
7,1,85,F,12,5,9,69,-16,Severe
11,10,142,F,73,10,6,126,-16,Severe
18,3,219,F,24,6,5,77,-142,Severe
12,0,144,M,6,5,5,65,-79,Severe
11,5,137,M,95,12,9,153,16,Well
16,5,197,M,66,9,9,117,-80,Severe
8,10,106,F,108,14,0,168,62,Well
10,0,120,F,63,9,6,114,-6,Severe
12,3,147,F,36,7,2,86,-61,Severe
14,5,173,M,18,6,1,73,-100,Severe
15,3,183,M,78,11,0,132,-51,Severe
13,1,157,F,97,12,11,155,-2,Mild
10,10,130,F,107,13,11,167,37,Well
18,4,220,F,97,12,11,155,-65,Severe
11,6,138,F,12,5,9,69,-69,Severe
10,3,123,F,17,6,0,72,-51,Severe
10,9,129,F,15,5,11,71,-58,Severe
6,3,75,F,8,5,6,66,-9,Severe
17,7,211,M,42,7,7,91,-120,Severe
8,3,99,M,82,11,5,137,38,Well
5,3,63,F,107,13,11,167,104,Well
6,3,75,F,30,6,9,81,6,Well
14,3,171,M,63,9,6,114,-57,Severe
14,0,168,M,37,7,3,87,-81,Severe
7,8,92,M,86,11,10,142,50,Well
18,5,221,M,42,7,7,91,-130,Severe
9,4,112,M,28,6,8,80,-32,Severe
15,5,185,M,6,5,5,65,-120,Severe
7,2,86,M,62,9,4,112,26,Well
5,5,65,M,110,14,3,171,106,Well
10,4,124,F,25,6,5,77,-47,Severe
18,11,227,M,39,7,5,89,-138,Severe
7,5,89,F,13,5,9,69,-20,Severe
18,3,219,F,58,9,0,108,-111,Severe
9,4,112,M,3,5,3,63,-49,Severe
17,2,206,F,90,12,3,147,-59,Severe
11,9,141,F,59,9,1,109,-32,Severe
16,2,194,M,95,12,9,153,-41,Severe
8,6,102,M,68,10,0,120,18,Well
13,7,163,F,14,5,10,70,-93,Severe
11,3,135,M,58,9,0,108,-27,Severe
17,9,213,F,95,12,9,153,-60,Severe
13,3,159,M,74,10,7,127,-32,Severe
7,2,86,F,83,11,6,138,52,Well
7,3,87,F,26,6,6,78,-9,Severe
15,0,180,M,2,5,3,63,-117,Severe
5,2,62,M,17,6,0,72,10,Well
17,3,207,F,3,5,3,63,-144,Severe
6,11,83,F,17,6,0,72,-11,Severe
11,1,133,M,85,11,9,141,8,Well
9,11,119,F,19,6,1,73,-46,Severe
16,6,198,M,100,13,3,159,-39,Severe
8,7,103,M,74,10,7,127,24,Well
5,8,68,F,22,6,3,75,7,Well
15,11,191,M,92,12,5,149,-42,Severe
16,3,195,F,22,6,3,75,-120,Severe
14,3,171,M,76,10,10,130,-41,Severe
8,7,103,F,83,11,6,138,35,Well
12,9,153,M,28,6,8,80,-73,Severe
10,8,128,F,67,9,10,118,-10,Severe
9,2,110,F,63,9,6,114,4,Good
5,7,67,F,37,7,3,87,20,Well
10,9,129,F,31,6,9,81,-48,Severe
8,3,99,M,78,11,0,132,33,Well
8,9,105,F,40,7,5,89,-16,Severe
5,2,62,M,20,6,2,74,12,Well
15,10,190,F,28,6,8,80,-110,Severe
8,10,106,M,79,11,1,133,27,Well
6,7,79,M,56,8,9,105,26,Well
17,3,207,M,58,9,0,108,-99,Severe
12,11,155,F,26,6,6,78,-77,Severe
14,1,169,F,32,6,10,82,-87,Severe
16,1,193,F,82,11,5,137,-56,Severe
6,0,72,F,48,8,1,97,25,Well
16,7,199,M,44,7,9,93,-106,Severe
13,7,163,F,5,5,5,65,-98,Severe
8,1,97,F,5,5,5,65,-32,Severe
5,4,64,F,83,11,6,138,74,Well
6,10,82,M,45,7,10,94,12,Well
13,8,164,M,61,9,3,111,-53,Severe
7,3,87,F,91,12,4,148,61,Well
5,1,61,M,45,7,10,94,33,Well
15,0,180,F,78,11,0,132,-48,Severe
14,9,177,M,25,6,5,77,-100,Severe
10,1,121,M,13,5,9,69,-52,Severe
13,0,156,F,56,8,9,105,-51,Severe
5,3,63,M,74,10,7,127,64,Well
13,2,158,F,19,6,1,73,-85,Severe
16,1,193,M,80,11,3,135,-58,Severe
6,7,79,M,44,7,9,93,14,Well
10,4,124,M,49,8,2,98,-26,Severe
8,3,99,F,91,12,4,148,49,Well
15,4,184,M,110,14,3,171,-13,Severe
10,10,130,F,34,7,0,84,-46,Severe
14,11,179,M,109,14,1,169,-10,Severe
11,2,134,F,64,9,7,115,-19,Severe
11,8,140,M,102,13,6,162,22,Well
5,7,67,F,91,12,4,148,81,Well
15,3,183,M,15,5,11,71,-112,Severe
16,3,195,F,59,9,1,109,-86,Severe
16,2,194,F,106,13,10,166,-28,Severe
8,0,96,F,17,6,0,72,-24,Severe
6,1,73,M,49,8,2,98,25,Well
5,8,68,F,94,12,7,151,83,Well
14,0,168,M,85,11,9,141,-27,Severe
14,2,170,F,35,7,1,85,-85,Severe
13,5,161,M,28,6,8,80,-81,Severe
14,4,172,M,12,5,9,69,-103,Severe
8,3,99,M,77,10,11,131,32,Well
5,7,67,F,49,8,2,98,31,Well
8,4,100,M,55,8,8,104,4,Good
5,9,69,F,9,5,7,67,-2,Mild
11,0,132,F,82,11,5,137,5,Good
12,10,154,F,100,13,3,159,5,Good
18,2,218,F,49,8,2,98,-120,Severe
13,9,165,M,71,10,3,123,-42,Severe
8,9,105,F,9,5,7,67,-38,Severe
8,1,97,F,77,10,11,131,34,Well
8,4,100,M,87,11,11,143,43,Well
15,4,184,F,80,11,3,135,-49,Severe
15,4,184,M,46,7,11,95,-89,Severe
8,10,106,M,27,6,7,79,-27,Severe
7,2,86,M,74,10,7,127,41,Well
7,5,89,M,80,11,3,135,46,Well
16,8,200,M,9,5,7,67,-133,Severe
17,6,210,M,42,7,7,91,-119,Severe
15,7,187,M,34,7,0,84,-103,Severe
5,1,61,M,95,12,9,153,92,Well
18,9,225,M,84,11,7,139,-86,Severe
6,6,78,M,37,7,3,87,9,Well
12,11,155,M,34,7,0,84,-71,Severe
14,10,178,M,52,8,5,101,-77,Severe
7,5,89,F,82,11,5,137,48,Well
9,9,117,F,5,5,5,65,-52,Severe
11,7,139,F,51,8,4,100,-39,Severe
17,7,211,M,85,11,9,141,-70,Severe
9,7,115,F,61,9,3,111,-4,Mild
10,2,122,M,100,13,3,159,37,Well
17,9,213,F,77,10,11,131,-82,Severe
16,3,195,M,95,12,9,153,-42,Severe
14,4,172,F,87,11,11,143,-29,Severe
8,4,100,F,79,11,1,133,33,Well
13,2,158,F,24,6,5,77,-81,Severe
17,8,212,F,12,5,9,69,-143,Severe
17,7,211,F,11,5,8,68,-143,Severe
7,9,93,M,33,6,11,83,-10,Severe
5,8,68,M,99,13,1,157,89,Well
17,9,213,F,59,9,1,109,-104,Severe
13,8,164,F,43,7,8,92,-72,Severe
9,2,110,M,96,12,10,154,44,Well
7,3,87,M,73,10,6,126,39,Well
6,6,78,M,104,13,7,163,85,Well
11,5,137,F,67,9,10,118,-19,Severe
16,4,196,M,109,14,1,169,-27,Severe
18,6,222,M,18,6,1,73,-149,Severe
5,0,60,M,72,10,4,124,64,Well
13,6,162,M,73,10,6,126,-36,Severe
5,9,69,M,66,9,9,117,48,Well
17,5,209,M,16,5,11,71,-138,Severe
17,7,211,F,10,5,7,67,-144,Severe
12,0,144,F,103,13,6,162,18,Well
6,10,82,F,36,7,2,86,4,Good
12,9,153,F,90,12,3,147,-6,Severe
13,1,157,F,74,10,7,127,-30,Severe
14,11,179,M,43,7,8,92,-87,Severe
11,8,140,F,102,13,6,162,22,Well
7,0,84,F,65,9,8,116,32,Well
16,5,197,F,36,7,2,86,-111,Severe
17,11,215,F,3,5,3,63,-152,Severe
18,11,227,F,95,12,9,153,-74,Severe
13,10,166,M,10,5,7,67,-99,Severe
9,10,118,F,102,13,6,162,44,Well
8,7,103,M,70,10,2,122,19,Well
16,9,201,M,87,11,11,143,-58,Severe
15,2,182,F,61,9,3,111,-71,Severe
8,0,96,M,43,7,8,92,-4,Mild
6,5,77,F,90,12,3,147,70,Well
6,4,76,F,30,6,9,81,5,Good
18,0,216,F,69,10,1,121,-95,Severe
8,10,106,M,55,8,8,104,-2,Mild
17,1,205,F,40,7,5,89,-116,Severe
18,1,217,F,7,5,6,66,-151,Severe
5,6,66,F,84,11,7,139,73,Well
14,6,174,M,64,9,7,115,-59,Severe
9,9,117,F,3,5,3,63,-54,Severe
17,4,208,M,26,6,6,78,-130,Severe
13,8,164,F,86,11,10,142,-22,Severe
5,0,60,M,87,11,11,143,83,Well
7,7,91,M,102,13,6,162,71,Well
16,6,198,F,36,7,2,86,-112,Severe
11,4,136,F,17,6,0,72,-64,Severe
13,10,166,F,50,8,3,99,-67,Severe
17,6,210,M,19,6,1,73,-137,Severe
11,8,140,M,57,8,10,106,-34,Severe
7,6,90,M,30,6,9,81,-9,Severe
9,5,113,F,12,5,9,69,-44,Severe
15,4,184,F,67,9,10,118,-66,Severe
11,2,134,F,47,8,0,96,-38,Severe
8,11,107,F,108,14,0,168,61,Well
12,4,148,M,49,8,2,98,-50,Severe
17,1,205,M,69,10,1,121,-84,Severe
8,6,102,M,103,13,6,162,60,Well
9,7,115,M,62,9,4,112,-3,Mild
9,7,115,M,29,6,8,80,-35,Severe
7,1,85,F,51,8,4,100,15,Well
11,10,142,F,32,6,10,82,-60,Severe
11,3,135,M,38,7,4,88,-47,Severe
7,4,88,M,44,7,9,93,5,Good
15,10,190,F,47,8,0,96,-94,Severe
5,2,62,M,44,7,9,93,31,Well
5,2,62,M,48,8,1,97,35,Well
5,8,68,M,107,13,11,167,99,Well
10,8,128,F,101,13,4,160,32,Well
11,4,136,M,55,8,8,104,-32,Severe
13,8,164,F,54,8,7,103,-61,Severe
16,2,194,M,73,10,6,126,-68,Severe
9,9,117,M,24,6,5,77,-40,Severe
11,11,143,M,84,11,7,139,-4,Mild
7,11,95,M,103,13,6,162,67,Well
18,3,219,F,76,10,10,130,-89,Severe
10,8,128,F,52,8,5,101,-27,Severe
11,2,134,M,63,9,6,114,-20,Severe
14,1,169,M,48,8,1,97,-72,Severe
12,0,144,F,72,10,4,124,-20,Severe
15,10,190,M,31,6,9,81,-109,Severe
17,3,207,M,11,5,8,68,-139,Severe
12,11,155,F,93,12,6,150,-5,Mild
18,0,216,F,34,7,0,84,-132,Severe
13,4,160,M,90,12,3,147,-13,Severe
12,3,147,M,66,9,9,117,-30,Severe
6,10,82,F,104,13,7,163,81,Well
18,3,219,M,95,12,9,153,-66,Severe
16,0,192,M,31,6,9,81,-111,Severe
5,3,63,M,63,9,6,114,51,Well
13,1,157,M,21,6,2,74,-83,Severe
17,9,213,F,72,10,4,124,-89,Severe
5,10,70,M,52,8,5,101,31,Well
18,6,222,F,65,9,8,116,-106,Severe
13,6,162,M,39,7,5,89,-73,Severe
7,9,93,M,47,8,0,96,3,Good
16,6,198,M,95,12,9,153,-45,Severe
18,4,220,M,77,10,11,131,-89,Severe
14,4,172,M,104,13,7,163,-9,Severe
9,4,112,M,46,7,11,95,-17,Severe
6,3,75,M,2,5,3,63,-12,Severe
18,9,225,M,11,5,8,68,-157,Severe
11,1,133,M,76,10,10,130,-3,Mild
6,8,80,F,81,11,4,136,56,Well
7,11,95,M,26,6,6,78,-17,Severe
11,2,134,F,98,13,0,156,22,Well
6,2,74,M,11,5,8,68,-6,Severe
9,2,110,F,110,14,3,171,61,Well
14,2,170,M,106,13,10,166,-4,Mild
14,8,176,F,58,9,0,108,-68,Severe
12,11,155,F,39,7,5,89,-66,Severe
8,3,99,F,88,12,0,144,45,Well
16,7,199,F,4,5,4,64,-135,Severe
16,3,195,M,52,8,5,101,-94,Severe
11,8,140,M,16,5,11,71,-69,Severe
5,7,67,M,98,13,0,156,89,Well
18,11,227,M,100,13,3,159,-68,Severe
11,11,143,F,87,11,11,143,0,Neutral
12,9,153,F,94,12,7,151,-2,Mild
7,11,95,F,70,10,2,122,27,Well
12,8,152,F,32,6,10,82,-70,Severe
18,3,219,M,44,7,9,93,-126,Severe
7,4,88,M,105,13,9,165,77,Well
15,8,188,M,35,7,1,85,-103,Severe
17,0,204,M,28,6,8,80,-124,Severe
13,11,167,M,14,5,10,70,-97,Severe
15,3,183,F,84,11,7,139,-44,Severe
16,7,199,M,46,7,11,95,-104,Severe
18,5,221,F,67,9,10,118,-103,Severe
8,3,99,F,5,5,5,65,-34,Severe
17,5,209,F,8,5,6,66,-143,Severe
5,8,68,M,62,9,4,112,44,Well
8,1,97,M,15,5,11,71,-26,Severe
17,3,207,F,80,11,3,135,-72,Severe
8,7,103,F,99,13,1,157,54,Well
18,9,225,F,17,6,0,72,-153,Severe
16,3,195,M,48,8,1,97,-98,Severe
15,3,183,M,75,10,9,129,-54,Severe
5,4,64,M,79,11,1,133,69,Well
12,9,153,F,84,11,7,139,-14,Severe
11,4,136,F,79,11,1,133,-3,Mild
18,5,221,F,22,6,3,75,-146,Severe
18,3,219,F,79,11,1,133,-86,Severe
18,10,226,M,65,9,8,116,-110,Severe
18,5,221,M,19,6,1,73,-148,Severe
11,8,140,F,55,8,8,104,-36,Severe
18,2,218,F,51,8,4,100,-118,Severe
18,0,216,M,47,8,0,96,-120,Severe
11,3,135,F,105,13,9,165,30,Well
16,10,202,F,109,14,1,169,-33,Severe
11,9,141,F,22,6,3,75,-66,Severe
11,9,141,F,25,6,5,77,-64,Severe
15,2,182,F,54,8,7,103,-79,Severe
7,6,90,M,4,5,4,64,-26,Severe
12,1,145,M,97,12,11,155,10,Well
10,7,127,F,77,10,11,131,4,Good
9,4,112,M,40,7,5,89,-23,Severe
14,5,173,F,84,11,7,139,-34,Severe
18,7,223,F,79,11,1,133,-90,Severe
18,3,219,M,71,10,3,123,-96,Severe
14,10,178,F,100,13,3,159,-19,Severe
13,7,163,M,93,12,6,150,-13,Severe
5,11,71,M,28,6,8,80,9,Well
13,10,166,M,95,12,9,153,-13,Severe
16,3,195,F,23,6,4,76,-119,Severe
17,0,204,M,87,11,11,143,-61,Severe
8,10,106,M,11,5,8,68,-38,Severe
8,11,107,F,21,6,2,74,-33,Severe
5,3,63,F,95,12,9,153,90,Well
7,11,95,F,24,6,5,77,-18,Severe
13,3,159,F,82,11,5,137,-22,Severe
13,5,161,F,95,12,9,153,-8,Severe
6,5,77,M,39,7,5,89,12,Well
13,9,165,M,59,9,1,109,-56,Severe
15,0,180,M,32,6,10,82,-98,Severe
11,9,141,F,21,6,2,74,-67,Severe
15,10,190,M,93,12,6,150,-40,Severe
11,4,136,M,95,12,9,153,17,Well
12,3,147,M,32,6,10,82,-65,Severe
18,7,223,M,39,7,5,89,-134,Severe
8,11,107,M,84,11,7,139,32,Well
17,3,207,M,29,6,8,80,-127,Severe
16,3,195,M,91,12,4,148,-47,Severe
17,3,207,F,32,6,10,82,-125,Severe
11,0,132,M,52,8,5,101,-31,Severe
14,7,175,M,32,6,10,82,-93,Severe
18,8,224,F,45,7,10,94,-130,Severe
10,2,122,F,63,9,6,114,-8,Severe
18,9,225,M,35,7,1,85,-140,Severe
18,1,217,M,37,7,3,87,-130,Severe
16,3,195,M,15,5,11,71,-124,Severe
7,0,84,M,52,8,5,101,17,Well
17,0,204,M,79,11,1,133,-71,Severe
9,7,115,M,7,5,6,66,-49,Severe
7,3,87,F,110,14,3,171,84,Well
12,7,151,F,79,11,1,133,-18,Severe
12,11,155,F,110,14,3,171,16,Well
18,6,222,M,83,11,6,138,-84,Severe
8,10,106,M,101,13,4,160,54,Well
17,6,210,M,104,13,7,163,-47,Severe
17,5,209,M,5,5,5,65,-144,Severe
8,5,101,M,13,5,9,69,-32,Severe
9,7,115,M,10,5,7,67,-48,Severe
13,5,161,M,10,5,7,67,-94,Severe
14,5,173,M,53,8,6,102,-71,Severe
9,6,114,M,51,8,4,100,-14,Severe
9,8,116,M,41,7,6,90,-26,Severe
16,2,194,M,75,10,9,129,-65,Severe
18,8,224,M,38,7,4,88,-136,Severe
7,4,88,F,72,10,4,124,36,Well
9,3,111,M,39,7,5,89,-22,Severe
16,1,193,M,64,9,7,115,-78,Severe
13,3,159,M,2,5,3,63,-96,Severe
10,2,122,F,16,5,11,71,-51,Severe
15,5,185,M,51,8,4,100,-85,Severe
16,6,198,F,66,9,9,117,-81,Severe
12,5,149,F,78,11,0,132,-17,Severe
17,4,208,M,44,7,9,93,-115,Severe
17,9,213,M,7,5,6,66,-147,Severe
10,8,128,F,85,11,9,141,13,Well
7,2,86,M,59,9,1,109,23,Well
15,0,180,F,87,11,11,143,-37,Severe
12,6,150,M,22,6,3,75,-75,Severe
17,2,206,F,61,9,3,111,-95,Severe
6,0,72,F,42,7,7,91,19,Well
8,1,97,F,102,13,6,162,65,Well
13,7,163,M,45,7,10,94,-69,Severe
8,6,102,F,19,6,1,73,-29,Severe
10,1,121,F,16,5,11,71,-50,Severe
9,10,118,F,81,11,4,136,18,Well
8,1,97,M,66,9,9,117,20,Well
17,2,206,M,14,5,10,70,-136,Severe
17,8,212,F,46,7,11,95,-117,Severe
12,2,146,F,109,14,1,169,23,Well
18,9,225,M,50,8,3,99,-126,Severe
9,9,117,M,88,12,0,144,27,Well
18,0,216,M,77,10,11,131,-85,Severe
9,5,113,M,66,9,9,117,4,Good
12,9,153,M,70,10,2,122,-31,Severe
10,5,125,F,42,7,7,91,-34,Severe
8,8,104,F,55,8,8,104,0,Neutral
14,3,171,M,33,6,11,83,-88,Severe
15,2,182,F,96,12,10,154,-28,Severe
9,5,113,M,59,9,1,109,-4,Mild
8,10,106,F,91,12,4,148,42,Well
13,1,157,M,33,6,11,83,-74,Severe
9,0,108,F,8,5,6,66,-42,Severe
9,3,111,M,33,6,11,83,-28,Severe
14,11,179,F,29,6,8,80,-99,Severe
5,6,66,M,101,13,4,160,94,Well
8,4,100,M,57,8,10,106,6,Well
8,4,100,F,77,10,11,131,31,Well
8,9,105,F,26,6,6,78,-27,Severe
5,4,64,F,14,5,10,70,6,Well
11,10,142,M,16,5,11,71,-71,Severe
16,3,195,F,57,8,10,106,-89,Severe
11,0,132,F,49,8,2,98,-34,Severe
16,2,194,F,70,10,2,122,-72,Severe
17,7,211,F,14,5,10,70,-141,Severe
7,11,95,F,78,11,0,132,37,Well
10,4,124,M,92,12,5,149,25,Well
17,9,213,M,22,6,3,75,-138,Severe
8,5,101,F,85,11,9,141,40,Well
11,10,142,F,101,13,4,160,18,Well
8,6,102,M,80,11,3,135,33,Well
5,7,67,F,43,7,8,92,25,Well
6,8,80,F,59,9,1,109,29,Well
5,0,60,M,84,11,7,139,79,Well
6,2,74,F,17,6,0,72,-2,Mild
16,9,201,F,31,6,9,81,-120,Severe
15,4,184,F,89,12,1,145,-39,Severe
17,1,205,F,26,6,6,78,-127,Severe
14,11,179,M,61,9,3,111,-68,Severe
10,7,127,F,9,5,7,67,-60,Severe
14,9,177,F,23,6,4,76,-101,Severe
10,8,128,M,53,8,6,102,-26,Severe
10,0,120,F,80,11,3,135,15,Well
10,11,131,F,47,8,0,96,-35,Severe
14,3,171,F,56,8,9,105,-66,Severe
14,1,169,F,47,8,0,96,-73,Severe
5,6,66,F,91,12,4,148,82,Well
6,1,73,M,10,5,7,67,-6,Severe
13,6,162,F,71,10,3,123,-39,Severe
15,2,182,M,12,5,9,69,-113,Severe
6,2,74,M,55,8,8,104,30,Well
7,4,88,M,53,8,6,102,14,Well
7,9,93,F,36,7,2,86,-7,Severe
18,2,218,F,105,13,9,165,-53,Severe
10,2,122,M,95,12,9,153,31,Well
6,6,78,F,66,9,9,117,39,Well
8,8,104,M,83,11,6,138,34,Well
16,3,195,M,60,9,2,110,-85,Severe
12,6,150,M,31,6,9,81,-69,Severe
11,11,143,F,2,5,3,63,-80,Severe
7,7,91,F,23,6,4,76,-15,Severe
5,8,68,F,40,7,5,89,21,Well
13,3,159,M,19,6,1,73,-86,Severe
10,10,130,F,31,6,9,81,-49,Severe
17,5,209,M,92,12,5,149,-60,Severe
14,11,179,F,5,5,5,65,-114,Severe
6,6,78,F,85,11,9,141,63,Well
12,5,149,F,91,12,4,148,-1,Mild
18,6,222,M,51,8,4,100,-122,Severe
17,11,215,M,109,14,1,169,-46,Severe
13,3,159,M,68,10,0,120,-39,Severe
10,1,121,F,98,13,0,156,35,Well
6,2,74,F,54,8,7,103,29,Well
16,4,196,F,39,7,5,89,-107,Severe
10,3,123,M,37,7,3,87,-36,Severe
5,2,62,F,7,5,6,66,4,Good
17,4,208,F,85,11,9,141,-67,Severe
11,4,136,M,82,11,5,137,1,Good
6,2,74,M,84,11,7,139,65,Well
16,6,198,F,58,9,0,108,-90,Severe
13,8,164,M,99,13,1,157,-7,Severe
18,7,223,F,14,5,10,70,-153,Severe
7,2,86,M,104,13,7,163,77,Well
6,3,75,M,68,10,0,120,45,Well
16,5,197,M,80,11,3,135,-62,Severe
5,8,68,F,20,6,2,74,6,Well
10,2,122,F,4,5,4,64,-58,Severe
13,11,167,F,104,13,7,163,-4,Mild
7,9,93,M,72,10,4,124,31,Well
16,1,193,M,108,14,0,168,-25,Severe
17,0,204,F,76,10,10,130,-74,Severe
9,3,111,F,99,13,1,157,46,Well
17,7,211,F,32,6,10,82,-129,Severe
6,0,72,M,31,6,9,81,9,Well
11,6,138,M,106,13,10,166,28,Well
11,5,137,M,107,13,11,167,30,Well
17,5,209,M,74,10,7,127,-82,Severe
12,2,146,M,33,6,11,83,-63,Severe
17,3,207,M,6,5,5,65,-142,Severe
14,2,170,M,69,10,1,121,-49,Severe
12,3,147,M,78,11,0,132,-15,Severe
10,0,120,M,39,7,5,89,-31,Severe
8,4,100,F,31,6,9,81,-19,Severe
18,1,217,M,64,9,7,115,-102,Severe
18,11,227,M,74,10,7,127,-100,Severe
18,3,219,M,2,5,3,63,-156,Severe
8,9,105,M,98,13,0,156,51,Well
12,5,149,F,84,11,7,139,-10,Severe
6,11,83,F,35,7,1,85,2,Good
9,5,113,F,35,7,1,85,-28,Severe
6,1,73,M,57,8,10,106,33,Well
17,3,207,M,64,9,7,115,-92,Severe
17,7,211,F,58,9,0,108,-103,Severe
10,11,131,F,63,9,6,114,-17,Severe
9,2,110,F,46,7,11,95,-15,Severe
14,4,172,M,67,9,10,118,-54,Severe
14,5,173,F,89,12,1,145,-28,Severe
11,10,142,F,60,9,2,110,-32,Severe
12,6,150,F,9,5,7,67,-83,Severe
10,11,131,M,60,9,2,110,-21,Severe
17,9,213,M,59,9,1,109,-104,Severe
14,10,178,F,4,5,4,64,-114,Severe
7,11,95,F,9,5,7,67,-28,Severe
9,3,111,F,91,12,4,148,37,Well
11,4,136,F,76,10,10,130,-6,Severe
18,1,217,M,90,12,3,147,-70,Severe
14,3,171,F,103,13,6,162,-9,Severe
5,11,71,M,79,11,1,133,62,Well
5,6,66,F,90,12,3,147,81,Well
15,4,184,M,61,9,3,111,-73,Severe
12,5,149,M,68,10,0,120,-29,Severe
11,9,141,F,83,11,6,138,-3,Mild
9,5,113,F,46,7,11,95,-18,Severe
6,0,72,F,47,8,0,96,24,Well
7,7,91,M,57,8,10,106,15,Well
6,3,75,F,29,6,8,80,5,Good
8,9,105,F,100,13,3,159,54,Well
11,9,141,F,94,12,7,151,10,Well
7,0,84,M,59,9,1,109,25,Well
10,5,125,M,64,9,7,115,-10,Severe
18,6,222,M,56,8,9,105,-117,Severe
8,11,107,F,70,10,2,122,15,Well
12,6,150,M,36,7,2,86,-64,Severe
14,0,168,M,107,13,11,167,-1,Mild
10,6,126,F,101,13,4,160,34,Well
12,8,152,F,94,12,7,151,-1,Mild
12,9,153,F,97,12,11,155,2,Good
16,10,202,M,80,11,3,135,-67,Severe
7,11,95,F,106,13,10,166,71,Well
15,6,186,F,41,7,6,90,-96,Severe
17,3,207,M,95,12,9,153,-54,Severe
5,10,70,F,93,12,6,150,80,Well
6,5,77,M,78,11,0,132,55,Well
16,1,193,F,55,8,8,104,-89,Severe
12,8,152,M,59,9,1,109,-43,Severe
12,7,151,M,79,11,1,133,-18,Severe
9,3,111,F,17,6,0,72,-39,Severe
5,6,66,M,78,11,0,132,66,Well
14,9,177,M,14,5,10,70,-107,Severe
16,0,192,M,14,5,10,70,-122,Severe
15,3,183,M,100,13,3,159,-24,Severe
5,10,70,F,87,11,11,143,73,Well
16,3,195,F,59,9,1,109,-86,Severe
16,4,196,M,47,8,0,96,-100,Severe
11,11,143,M,87,11,11,143,0,Neutral
7,7,91,M,73,10,6,126,35,Well
9,5,113,M,100,13,3,159,46,Well
16,2,194,F,24,6,5,77,-117,Severe
16,8,200,M,35,7,1,85,-115,Severe
7,4,88,M,12,5,9,69,-19,Severe
9,8,116,M,32,6,10,82,-34,Severe
12,6,150,M,20,6,2,74,-76,Severe
13,7,163,M,56,8,9,105,-58,Severe
8,5,101,M,19,6,1,73,-28,Severe
14,4,172,M,63,9,6,114,-58,Severe
11,11,143,M,47,8,0,96,-47,Severe
8,5,101,M,89,12,1,145,44,Well
15,8,188,F,10,5,7,67,-121,Severe
9,10,118,F,44,7,9,93,-25,Severe
15,11,191,F,54,8,7,103,-88,Severe
13,3,159,F,88,12,0,144,-15,Severe
14,3,171,F,58,9,0,108,-63,Severe
5,9,69,M,3,5,3,63,-6,Severe
16,3,195,F,96,12,10,154,-41,Severe
13,3,159,F,76,10,10,130,-29,Severe
6,4,76,F,33,6,11,83,7,Well
6,7,79,F,87,11,11,143,64,Well
16,3,195,M,55,8,8,104,-91,Severe
11,11,143,F,82,11,5,137,-6,Severe
15,6,186,F,107,13,11,167,-19,Severe
6,2,74,F,41,7,6,90,16,Well
14,4,172,F,105,13,9,165,-7,Severe
13,2,158,M,96,12,10,154,-4,Mild
16,11,203,F,17,6,0,72,-131,Severe
7,0,84,F,104,13,7,163,79,Well
15,3,183,F,28,6,8,80,-103,Severe
12,5,149,M,97,12,11,155,6,Well
5,0,60,M,56,8,9,105,45,Well
5,5,65,M,75,10,9,129,64,Well
11,3,135,F,56,8,9,105,-30,Severe
6,1,73,F,102,13,6,162,89,Well
5,4,64,F,10,5,7,67,3,Good
7,2,86,M,92,12,5,149,63,Well
17,2,206,F,35,7,1,85,-121,Severe
14,2,170,F,26,6,6,78,-92,Severe
18,8,224,M,32,6,10,82,-142,Severe
8,3,99,F,97,12,11,155,56,Well
10,5,125,F,29,6,8,80,-45,Severe
12,9,153,M,25,6,5,77,-76,Severe
16,10,202,F,12,5,9,69,-133,Severe
9,3,111,M,57,8,10,106,-5,Mild
16,11,203,M,92,12,5,149,-54,Severe
7,2,86,M,35,7,1,85,-1,Mild
11,2,134,M,92,12,5,149,15,Well
17,1,205,M,73,10,6,126,-79,Severe
14,1,169,M,31,6,9,81,-88,Severe
11,10,142,F,67,9,10,118,-24,Severe
12,6,150,F,106,13,10,166,16,Well
7,7,91,F,86,11,10,142,51,Well
7,6,90,F,21,6,2,74,-16,Severe
12,3,147,F,26,6,6,78,-69,Severe
7,5,89,M,81,11,4,136,47,Well
13,2,158,M,92,12,5,149,-9,Severe
9,11,119,M,85,11,9,141,22,Well
5,6,66,F,18,6,1,73,7,Well
16,2,194,F,100,13,3,159,-35,Severe
6,10,82,F,7,5,6,66,-16,Severe
10,11,131,F,52,8,5,101,-30,Severe
16,8,200,F,46,7,11,95,-105,Severe
18,3,219,M,29,6,8,80,-139,Severe
8,11,107,M,104,13,7,163,56,Well
11,7,139,M,26,6,6,78,-61,Severe
6,0,72,F,59,9,1,109,37,Well
8,8,104,F,102,13,6,162,58,Well
13,11,167,M,85,11,9,141,-26,Severe
9,5,113,M,35,7,1,85,-28,Severe
7,1,85,M,96,12,10,154,69,Well
18,6,222,F,79,11,1,133,-89,Severe
18,4,220,M,30,6,9,81,-139,Severe
18,1,217,M,39,7,5,89,-128,Severe
12,7,151,F,3,5,3,63,-88,Severe
11,7,139,M,59,9,1,109,-30,Severe
17,3,207,M,101,13,4,160,-47,Severe
7,11,95,M,21,6,2,74,-21,Severe
16,3,195,M,58,9,0,108,-87,Severe
11,3,135,M,10,5,7,67,-68,Severe
8,4,100,M,92,12,5,149,49,Well
6,2,74,F,37,7,3,87,13,Well
12,8,152,M,90,12,3,147,-5,Mild
15,5,185,F,45,7,10,94,-91,Severe
6,11,83,F,10,5,7,67,-16,Severe
8,7,103,M,75,10,9,129,26,Well
15,9,189,M,9,5,7,67,-122,Severe
5,4,64,M,48,8,1,97,33,Well
16,10,202,M,97,12,11,155,-47,Severe
6,3,75,M,58,9,0,108,33,Well
16,5,197,F,71,10,3,123,-74,Severe
6,9,81,M,15,5,11,71,-10,Severe
5,0,60,M,88,12,0,144,84,Well
17,8,212,F,85,11,9,141,-71,Severe
5,11,71,F,19,6,1,73,2,Good
13,0,156,M,65,9,8,116,-40,Severe
11,11,143,M,67,9,10,118,-25,Severe
13,11,167,M,3,5,3,63,-104,Severe
11,8,140,F,39,7,5,89,-51,Severe
5,8,68,F,62,9,4,112,44,Well
18,1,217,F,30,6,9,81,-136,Severe
14,0,168,M,9,5,7,67,-101,Severe
10,9,129,M,110,14,3,171,42,Well
10,0,120,M,6,5,5,65,-55,Severe
11,9,141,M,69,10,1,121,-20,Severe
17,3,207,M,20,6,2,74,-133,Severe
9,3,111,F,92,12,5,149,38,Well
9,2,110,M,84,11,7,139,29,Well
5,4,64,M,19,6,1,73,9,Well
9,3,111,F,8,5,6,66,-45,Severe
9,11,119,M,87,11,11,143,24,Well
17,11,215,F,55,8,8,104,-111,Severe
8,0,96,M,15,5,11,71,-25,Severe
13,3,159,M,37,7,3,87,-72,Severe
8,4,100,M,22,6,3,75,-25,Severe
11,5,137,M,61,9,3,111,-26,Severe
8,11,107,M,12,5,9,69,-38,Severe
10,0,120,F,86,11,10,142,22,Well
9,3,111,F,105,13,9,165,54,Well
9,2,110,F,12,5,9,69,-41,Severe
12,1,145,F,17,6,0,72,-73,Severe
5,0,60,M,44,7,9,93,33,Well
11,4,136,M,4,5,4,64,-72,Severe
18,1,217,M,6,5,5,65,-152,Severe
6,0,72,M,75,10,9,129,57,Well
18,1,217,M,78,11,0,132,-85,Severe
8,3,99,F,94,12,7,151,52,Well
6,2,74,M,28,6,8,80,6,Well
11,1,133,F,79,11,1,133,0,Neutral
15,1,181,M,74,10,7,127,-54,Severe
6,7,79,M,52,8,5,101,22,Well
18,5,221,M,101,13,4,160,-61,Severe
6,5,77,M,107,13,11,167,90,Well
5,3,63,M,6,5,5,65,2,Good
11,0,132,M,62,9,4,112,-20,Severe
9,3,111,F,56,8,9,105,-6,Severe
12,11,155,F,12,5,9,69,-86,Severe
9,4,112,M,50,8,3,99,-13,Severe
18,5,221,M,107,13,11,167,-54,Severe
16,2,194,F,108,14,0,168,-26,Severe
5,7,67,F,53,8,6,102,35,Well
18,9,225,M,23,6,4,76,-149,Severe
14,1,169,M,18,6,1,73,-96,Severe
9,3,111,M,49,8,2,98,-13,Severe
8,6,102,M,3,5,3,63,-39,Severe
12,11,155,F,37,7,3,87,-68,Severe
10,3,123,M,63,9,6,114,-9,Severe
10,11,131,M,28,6,8,80,-51,Severe
17,3,207,M,21,6,2,74,-133,Severe
7,5,89,F,2,5,3,63,-26,Severe
12,3,147,M,63,9,6,114,-33,Severe
5,0,60,M,81,11,4,136,76,Well
5,3,63,M,98,13,0,156,93,Well
14,11,179,M,75,10,9,129,-50,Severe
12,5,149,F,56,8,9,105,-44,Severe
9,3,111,F,21,6,2,74,-37,Severe
13,7,163,M,81,11,4,136,-27,Severe
16,10,202,M,13,5,9,69,-133,Severe
9,10,118,M,25,6,5,77,-41,Severe
10,9,129,F,48,8,1,97,-32,Severe
6,9,81,M,26,6,6,78,-3,Mild
8,7,103,F,25,6,5,77,-26,Severe
17,8,212,M,53,8,6,102,-110,Severe
5,5,65,F,36,7,2,86,21,Well
9,3,111,F,23,6,4,76,-35,Severe
15,9,189,M,58,9,0,108,-81,Severe
7,3,87,F,70,10,2,122,35,Well
10,3,123,F,40,7,5,89,-34,Severe
13,7,163,F,3,5,3,63,-100,Severe
6,7,79,F,44,7,9,93,14,Well
11,1,133,F,96,12,10,154,21,Well
15,3,183,F,94,12,7,151,-32,Severe
12,11,155,F,86,11,10,142,-13,Severe
10,6,126,M,82,11,5,137,11,Well
8,8,104,M,78,11,0,132,28,Well
7,9,93,F,100,13,3,159,66,Well
11,9,141,M,48,8,1,97,-44,Severe
8,4,100,M,28,6,8,80,-20,Severe
10,8,128,M,56,8,9,105,-23,Severe
6,7,79,M,104,13,7,163,84,Well
8,4,100,M,18,6,1,73,-27,Severe
9,7,115,F,12,5,9,69,-46,Severe
14,11,179,F,25,6,5,77,-102,Severe
13,0,156,F,110,14,3,171,15,Well
6,11,83,M,63,9,6,114,31,Well
12,9,153,F,91,12,4,148,-5,Mild
8,6,102,F,87,11,11,143,41,Well
15,11,191,M,54,8,7,103,-88,Severe
13,6,162,F,89,12,1,145,-17,Severe
18,8,224,F,7,5,6,66,-158,Severe
13,3,159,M,87,11,11,143,-16,Severe
14,4,172,M,80,11,3,135,-37,Severe
14,2,170,M,27,6,7,79,-91,Severe
14,10,178,F,50,8,3,99,-79,Severe
15,3,183,F,10,5,7,67,-116,Severe
11,9,141,F,28,6,8,80,-61,Severe
16,1,193,M,22,6,3,75,-118,Severe
18,3,219,M,45,7,10,94,-125,Severe
8,2,98,M,69,10,1,121,23,Well
11,0,132,M,53,8,6,102,-30,Severe
16,10,202,M,89,12,1,145,-57,Severe
15,7,187,M,11,5,8,68,-119,Severe
17,10,214,F,42,7,7,91,-123,Severe
14,11,179,M,27,6,7,79,-100,Severe
13,1,157,F,73,10,6,126,-31,Severe
7,10,94,M,99,13,1,157,63,Well
18,8,224,M,65,9,8,116,-108,Severe
14,2,170,M,93,12,6,150,-20,Severe
18,7,223,F,77,10,11,131,-92,Severe
10,3,123,M,77,10,11,131,8,Well
11,10,142,M,50,8,3,99,-43,Severe
12,2,146,M,5,5,5,65,-81,Severe
5,10,70,F,73,10,6,126,56,Well
15,6,186,M,69,10,1,121,-65,Severe
7,5,89,F,87,11,11,143,54,Well
13,11,167,M,36,7,2,86,-81,Severe
13,6,162,F,99,13,1,157,-5,Mild
18,3,219,F,9,5,7,67,-152,Severe
15,7,187,F,16,5,11,71,-116,Severe
16,8,200,F,11,5,8,68,-132,Severe
10,9,129,M,36,7,2,86,-43,Severe
5,2,62,F,81,11,4,136,74,Well
10,8,128,F,76,10,10,130,2,Good
7,3,87,M,86,11,10,142,55,Well
17,3,207,F,109,14,1,169,-38,Severe
14,6,174,F,33,6,11,83,-91,Severe
8,1,97,F,97,12,11,155,58,Well
9,4,112,M,105,13,9,165,53,Well
18,5,221,F,85,11,9,141,-80,Severe
16,5,197,F,31,6,9,81,-116,Severe
11,1,133,F,66,9,9,117,-16,Severe
11,0,132,F,93,12,6,150,18,Well
11,3,135,F,100,13,3,159,24,Well
8,11,107,M,30,6,9,81,-26,Severe
17,4,208,F,64,9,7,115,-93,Severe
5,7,67,M,80,11,3,135,68,Well
7,4,88,F,12,5,9,69,-19,Severe
9,11,119,F,109,14,1,169,50,Well
6,6,78,M,68,10,0,120,42,Well
16,3,195,M,31,6,9,81,-114,Severe
15,7,187,F,86,11,10,142,-45,Severe
16,0,192,M,104,13,7,163,-29,Severe
12,1,145,F,77,10,11,131,-14,Severe
7,8,92,M,68,10,0,120,28,Well
6,3,75,M,104,13,7,163,88,Well
14,2,170,F,15,5,11,71,-99,Severe
14,3,171,M,105,13,9,165,-6,Severe
8,1,97,F,7,5,6,66,-31,Severe
17,2,206,F,105,13,9,165,-41,Severe
12,3,147,F,59,9,1,109,-38,Severe
15,2,182,F,29,6,8,80,-102,Severe
6,11,83,F,49,8,2,98,15,Well
12,7,151,M,57,8,10,106,-45,Severe
11,2,134,M,22,6,3,75,-59,Severe
15,4,184,M,38,7,4,88,-96,Severe
9,1,109,F,65,9,8,116,7,Well
5,11,71,F,12,5,9,69,-2,Mild
18,4,220,F,84,11,7,139,-81,Severe
12,6,150,F,59,9,1,109,-41,Severe
7,2,86,F,87,11,11,143,57,Well
7,11,95,M,46,7,11,95,0,Neutral
5,1,61,F,74,10,7,127,66,Well
13,0,156,M,26,6,6,78,-78,Severe
8,9,105,M,23,6,4,76,-29,Severe
9,0,108,F,83,11,6,138,30,Well
16,6,198,F,95,12,9,153,-45,Severe
18,3,219,M,6,5,5,65,-154,Severe
11,7,139,F,102,13,6,162,23,Well
13,11,167,F,30,6,9,81,-86,Severe
14,6,174,M,80,11,3,135,-39,Severe
15,3,183,M,98,13,0,156,-27,Severe
7,5,89,F,93,12,6,150,61,Well
18,11,227,M,101,13,4,160,-67,Severe
7,3,87,F,82,11,5,137,50,Well
14,4,172,F,66,9,9,117,-55,Severe
8,2,98,M,83,11,6,138,40,Well
14,4,172,F,32,6,10,82,-90,Severe
5,2,62,M,60,9,2,110,48,Well
18,2,218,F,41,7,6,90,-128,Severe
12,5,149,F,6,5,5,65,-84,Severe
16,11,203,F,98,13,0,156,-47,Severe
12,7,151,F,22,6,3,75,-76,Severe
10,1,121,M,56,8,9,105,-16,Severe
16,3,195,M,93,12,6,150,-45,Severe
9,1,109,M,52,8,5,101,-8,Severe
8,3,99,F,104,13,7,163,64,Well
18,5,221,F,94,12,7,151,-70,Severe
14,9,177,M,74,10,7,127,-50,Severe
13,8,164,F,79,11,1,133,-31,Severe
16,1,193,F,104,13,7,163,-30,Severe
7,1,85,M,64,9,7,115,30,Well
14,11,179,M,79,11,1,133,-46,Severe
11,0,132,F,57,8,10,106,-26,Severe
9,2,110,M,13,5,9,69,-41,Severe
5,11,71,M,18,6,1,73,2,Good
5,3,63,M,61,9,3,111,48,Well
9,6,114,M,92,12,5,149,35,Well
13,0,156,F,3,5,3,63,-93,Severe
8,1,97,M,31,6,9,81,-16,Severe
11,4,136,M,9,5,7,67,-69,Severe
8,4,100,M,51,8,4,100,0,Neutral
11,5,137,M,35,7,1,85,-52,Severe
10,9,129,F,53,8,6,102,-27,Severe
11,0,132,F,33,6,11,83,-49,Severe
8,11,107,F,41,7,6,90,-17,Severe
17,1,205,M,40,7,5,89,-116,Severe
5,0,60,F,37,7,3,87,27,Well
5,11,71,F,109,14,1,169,98,Well
16,5,197,F,65,9,8,116,-81,Severe
6,5,77,M,26,6,6,78,1,Good
10,6,126,M,64,9,7,115,-11,Severe
6,3,75,M,82,11,5,137,62,Well
17,0,204,F,95,12,9,153,-51,Severe
7,1,85,F,78,11,0,132,47,Well
5,3,63,M,24,6,5,77,14,Well
6,11,83,M,21,6,2,74,-9,Severe
9,6,114,F,55,8,8,104,-10,Severe
16,3,195,F,67,9,10,118,-77,Severe
11,3,135,F,109,14,1,169,34,Well
11,2,134,M,59,9,1,109,-25,Severe
8,9,105,M,34,7,0,84,-21,Severe
10,1,121,M,12,5,9,69,-52,Severe
6,1,73,F,103,13,6,162,89,Well
15,5,185,M,50,8,3,99,-86,Severe
15,3,183,F,70,10,2,122,-61,Severe
17,0,204,F,31,6,9,81,-123,Severe
7,0,84,M,40,7,5,89,5,Good
12,2,146,M,42,7,7,91,-55,Severe
15,10,190,F,25,6,5,77,-113,Severe
5,8,68,F,103,13,6,162,94,Well
7,7,91,F,8,5,6,66,-25,Severe
16,0,192,M,100,13,3,159,-33,Severe
15,3,183,F,62,9,4,112,-71,Severe
13,6,162,F,36,7,2,86,-76,Severe
12,8,152,M,74,10,7,127,-25,Severe
9,3,111,F,26,6,6,78,-33,Severe
12,3,147,F,55,8,8,104,-43,Severe
12,8,152,F,107,13,11,167,15,Well
16,0,192,M,49,8,2,98,-94,Severe
10,3,123,F,28,6,8,80,-43,Severe
6,2,74,F,13,5,9,69,-5,Mild
9,10,118,F,7,5,6,66,-52,Severe
10,3,123,M,62,9,4,112,-11,Severe
18,6,222,F,3,5,3,63,-159,Severe
7,1,85,M,99,13,1,157,72,Well
16,9,201,F,42,7,7,91,-110,Severe
18,6,222,M,102,13,6,162,-60,Severe
12,8,152,F,65,9,8,116,-36,Severe
9,0,108,F,31,6,9,81,-27,Severe
15,1,181,M,71,10,3,123,-58,Severe
15,10,190,F,29,6,8,80,-110,Severe
12,7,151,M,46,7,11,95,-56,Severe
6,11,83,M,97,12,11,155,72,Well
17,6,210,F,11,5,8,68,-142,Severe
13,9,165,F,56,8,9,105,-60,Severe
15,3,183,M,85,11,9,141,-42,Severe
13,11,167,M,45,7,10,94,-73,Severe
13,5,161,F,104,13,7,163,2,Good
15,7,187,F,15,5,11,71,-116,Severe
7,3,87,M,53,8,6,102,15,Well
16,8,200,F,90,12,3,147,-53,Severe
6,11,83,M,95,12,9,153,70,Well
5,6,66,M,2,5,3,63,-3,Mild
6,2,74,F,93,12,6,150,76,Well
15,0,180,F,96,12,10,154,-26,Severe
17,7,211,F,63,9,6,114,-97,Severe
15,0,180,M,77,10,11,131,-49,Severe
6,10,82,M,108,14,0,168,86,Well
11,4,136,M,26,6,6,78,-58,Severe
7,11,95,M,82,11,5,137,42,Well
8,3,99,M,89,12,1,145,46,Well
14,3,171,M,108,14,0,168,-3,Mild
12,3,147,F,100,13,3,159,12,Well
9,3,111,F,78,11,0,132,21,Well
10,8,128,F,50,8,3,99,-29,Severe
15,8,188,F,24,6,5,77,-111,Severe
12,9,153,M,26,6,6,78,-75,Severe
9,0,108,F,36,7,2,86,-22,Severe
8,0,96,M,10,5,7,67,-29,Severe
14,8,176,F,7,5,6,66,-110,Severe
7,2,86,F,97,12,11,155,69,Well
10,1,121,F,94,12,7,151,30,Well
7,10,94,M,26,6,6,78,-16,Severe
12,0,144,M,76,10,10,130,-14,Severe
12,11,155,M,92,12,5,149,-6,Severe
12,6,150,M,35,7,1,85,-65,Severe
12,7,151,F,2,5,3,63,-88,Severe
14,11,179,F,50,8,3,99,-80,Severe
14,3,171,F,16,5,11,71,-100,Severe
15,8,188,F,29,6,8,80,-108,Severe
13,7,163,M,64,9,7,115,-48,Severe
14,9,177,F,107,13,11,167,-10,Severe
17,10,214,F,5,5,5,65,-149,Severe
8,2,98,F,78,11,0,132,34,Well
9,11,119,F,21,6,2,74,-45,Severe
11,2,134,M,42,7,7,91,-43,Severe
16,6,198,M,33,6,11,83,-115,Severe
8,11,107,M,65,9,8,116,9,Well
18,3,219,F,60,9,2,110,-109,Severe
5,2,62,F,15,5,11,71,9,Well
7,11,95,F,86,11,10,142,47,Well
6,0,72,M,14,5,10,70,-2,Mild
11,10,142,F,52,8,5,101,-41,Severe
6,1,73,M,108,14,0,168,95,Well
7,3,87,F,58,9,0,108,21,Well
8,5,101,M,63,9,6,114,13,Well
10,5,125,F,56,8,9,105,-20,Severe
14,6,174,M,97,12,11,155,-19,Severe
17,7,211,F,49,8,2,98,-113,Severe
17,8,212,F,67,9,10,118,-94,Severe
14,3,171,F,2,5,3,63,-108,Severe
9,1,109,M,99,13,1,157,48,Well
10,4,124,F,40,7,5,89,-35,Severe
6,4,76,F,82,11,5,137,61,Well
7,7,91,F,95,12,9,153,62,Well
7,4,88,F,68,10,0,120,32,Well
10,10,130,M,47,8,0,96,-34,Severe
12,2,146,F,89,12,1,145,-1,Mild
13,3,159,M,29,6,8,80,-79,Severe
18,8,224,M,45,7,10,94,-130,Severe
8,5,101,M,48,8,1,97,-4,Mild
7,1,85,F,83,11,6,138,53,Well
11,1,133,M,73,10,6,126,-7,Severe
9,0,108,F,46,7,11,95,-13,Severe
10,9,129,M,73,10,6,126,-3,Mild
13,6,162,F,96,12,10,154,-8,Severe
14,9,177,F,105,13,9,165,-12,Severe
10,2,122,M,82,11,5,137,15,Well
8,2,98,M,57,8,10,106,8,Well
14,11,179,M,9,5,7,67,-112,Severe
7,0,84,F,47,8,0,96,12,Well
8,9,105,F,75,10,9,129,24,Well
18,9,225,M,58,9,0,108,-117,Severe
5,7,67,M,36,7,2,86,19,Well
14,7,175,F,47,8,0,96,-79,Severe
6,3,75,F,46,7,11,95,20,Well
14,3,171,M,87,11,11,143,-28,Severe
14,11,179,M,103,13,6,162,-17,Severe
9,8,116,F,27,6,7,79,-37,Severe
5,1,61,F,62,9,4,112,51,Well
11,7,139,M,108,14,0,168,29,Well
5,1,61,F,64,9,7,115,54,Well
9,11,119,M,100,13,3,159,40,Well
15,3,183,M,64,9,7,115,-68,Severe
18,0,216,M,62,9,4,112,-104,Severe
5,10,70,F,85,11,9,141,71,Well
18,3,219,F,43,7,8,92,-127,Severe
13,6,162,M,5,5,5,65,-97,Severe
17,6,210,M,9,5,7,67,-143,Severe
5,0,60,M,71,10,3,123,63,Well
15,3,183,M,19,6,1,73,-110,Severe
16,5,197,F,107,13,11,167,-30,Severe
6,9,81,M,50,8,3,99,18,Well
16,5,197,M,93,12,6,150,-47,Severe
13,3,159,F,91,12,4,148,-11,Severe
9,5,113,M,91,12,4,148,35,Well
13,4,160,M,26,6,6,78,-82,Severe
7,1,85,F,89,12,1,145,60,Well
16,4,196,M,31,6,9,81,-115,Severe
14,2,170,F,33,6,11,83,-87,Severe
12,5,149,M,33,6,11,83,-66,Severe
18,3,219,F,47,8,0,96,-123,Severe
16,0,192,M,21,6,2,74,-118,Severe
5,4,64,F,33,6,11,83,19,Well
13,5,161,M,36,7,2,86,-75,Severe
8,3,99,F,83,11,6,138,39,Well
17,3,207,M,5,5,5,65,-142,Severe
12,3,147,M,38,7,4,88,-59,Severe
15,0,180,M,51,8,4,100,-80,Severe
7,9,93,M,84,11,7,139,46,Well
10,8,128,M,70,10,2,122,-6,Severe
18,1,217,F,51,8,4,100,-117,Severe
6,5,77,F,39,7,5,89,12,Well
8,4,100,F,80,11,3,135,35,Well
15,0,180,F,9,5,7,67,-113,Severe
8,1,97,F,15,5,11,71,-26,Severe
18,5,221,F,60,9,2,110,-111,Severe
11,6,138,F,76,10,10,130,-8,Severe
6,8,80,M,21,6,2,74,-6,Severe
6,1,73,M,65,9,8,116,43,Well
14,6,174,M,74,10,7,127,-47,Severe
6,5,77,M,50,8,3,99,22,Well
6,10,82,F,23,6,4,76,-6,Severe
9,1,109,F,66,9,9,117,8,Well
10,6,126,M,61,9,3,111,-15,Severe
16,1,193,M,28,6,8,80,-113,Severe
18,11,227,F,23,6,4,76,-151,Severe
8,5,101,F,4,5,4,64,-37,Severe
11,3,135,F,10,5,7,67,-68,Severe
6,4,76,F,23,6,4,76,0,Neutral
8,2,98,M,43,7,8,92,-6,Severe
13,7,163,M,30,6,9,81,-82,Severe
17,0,204,M,12,5,9,69,-135,Severe
6,10,82,M,101,13,4,160,78,Well
10,7,127,M,74,10,7,127,0,Neutral
6,10,82,M,5,5,5,65,-17,Severe
6,11,83,F,29,6,8,80,-3,Mild
6,8,80,M,90,12,3,147,67,Well
13,5,161,F,6,5,5,65,-96,Severe
10,5,125,F,61,9,3,111,-14,Severe
7,10,94,F,107,13,11,167,73,Well
9,11,119,M,94,12,7,151,32,Well
10,1,121,F,75,10,9,129,8,Well
16,2,194,M,31,6,9,81,-113,Severe
14,3,171,F,72,10,4,124,-47,Severe
10,3,123,M,30,6,9,81,-42,Severe
15,1,181,M,33,6,11,83,-98,Severe
10,9,129,M,4,5,4,64,-65,Severe
17,3,207,M,65,9,8,116,-91,Severe
7,3,87,M,96,12,10,154,67,Well
16,9,201,M,21,6,2,74,-127,Severe
6,2,74,M,99,13,1,157,83,Well
18,6,222,M,108,14,0,168,-54,Severe
11,11,143,M,26,6,6,78,-65,Severe
15,8,188,M,20,6,2,74,-114,Severe
16,11,203,F,76,10,10,130,-73,Severe
10,6,126,M,109,14,1,169,43,Well
10,10,130,M,75,10,9,129,-1,Mild
11,6,138,F,29,6,8,80,-58,Severe
13,1,157,M,30,6,9,81,-76,Severe
13,0,156,M,22,6,3,75,-81,Severe
9,6,114,F,101,13,4,160,46,Well
7,5,89,M,65,9,8,116,27,Well
10,8,128,M,42,7,7,91,-37,Severe
8,11,107,M,88,12,0,144,37,Well
17,11,215,M,82,11,5,137,-78,Severe
8,4,100,M,88,12,0,144,44,Well
14,9,177,F,67,9,10,118,-59,Severe
17,8,212,F,2,5,3,63,-149,Severe
10,1,121,F,100,13,3,159,38,Well
14,7,175,F,78,11,0,132,-43,Severe
14,2,170,M,6,5,5,65,-105,Severe
17,9,213,F,20,6,2,74,-139,Severe
8,6,102,F,10,5,7,67,-35,Severe
5,0,60,F,75,10,9,129,69,Well
18,3,219,F,78,11,0,132,-87,Severe
12,3,147,F,49,8,2,98,-49,Severe
13,1,157,F,8,5,6,66,-91,Severe
6,11,83,F,47,8,0,96,13,Well
11,10,142,M,104,13,7,163,21,Well
17,7,211,M,101,13,4,160,-51,Severe
14,9,177,F,69,10,1,121,-56,Severe
5,3,63,M,69,10,1,121,58,Well
18,9,225,F,79,11,1,133,-92,Severe
18,5,221,F,18,6,1,73,-148,Severe
7,6,90,M,69,10,1,121,31,Well
10,0,120,M,63,9,6,114,-6,Severe
9,3,111,F,19,6,1,73,-38,Severe
7,1,85,F,77,10,11,131,46,Well
17,9,213,M,85,11,9,141,-72,Severe
17,3,207,F,28,6,8,80,-127,Severe
9,9,117,F,83,11,6,138,21,Well
11,9,141,F,3,5,3,63,-78,Severe
8,3,99,M,40,7,5,89,-10,Severe
5,4,64,F,45,7,10,94,30,Well
14,7,175,F,72,10,4,124,-51,Severe
10,8,128,M,68,10,0,120,-8,Severe
15,11,191,M,59,9,1,109,-82,Severe
9,11,119,F,74,10,7,127,8,Well
16,7,199,F,94,12,7,151,-48,Severe
13,0,156,M,37,7,3,87,-69,Severe
6,3,75,F,9,5,7,67,-8,Severe
11,2,134,M,76,10,10,130,-4,Mild
17,11,215,F,11,5,8,68,-147,Severe
14,2,170,F,27,6,7,79,-91,Severe
18,11,227,M,87,11,11,143,-84,Severe
8,5,101,M,51,8,4,100,-1,Mild
17,4,208,M,56,8,9,105,-103,Severe
16,10,202,F,29,6,8,80,-122,Severe
15,9,189,M,7,5,6,66,-123,Severe
10,4,124,M,89,12,1,145,21,Well
12,6,150,M,83,11,6,138,-12,Severe
5,2,62,M,75,10,9,129,67,Well
9,6,114,F,87,11,11,143,29,Well
5,5,65,M,88,12,0,144,79,Well
13,2,158,M,6,5,5,65,-93,Severe
6,3,75,F,49,8,2,98,23,Well
17,4,208,F,104,13,7,163,-45,Severe
16,8,200,M,29,6,8,80,-120,Severe
7,10,94,F,31,6,9,81,-13,Severe
14,1,169,M,50,8,3,99,-70,Severe
12,5,149,M,36,7,2,86,-63,Severe
14,11,179,F,13,5,9,69,-110,Severe
17,0,204,F,79,11,1,133,-71,Severe
16,10,202,F,103,13,6,162,-40,Severe
16,7,199,M,55,8,8,104,-95,Severe
9,5,113,M,62,9,4,112,-1,Mild
5,4,64,F,109,14,1,169,105,Well
17,3,207,F,109,14,1,169,-38,Severe
14,2,170,F,28,6,8,80,-90,Severe
8,9,105,M,24,6,5,77,-28,Severe
15,2,182,M,99,13,1,157,-25,Severe
13,0,156,F,24,6,5,77,-79,Severe
8,9,105,M,59,9,1,109,4,Good
14,1,169,M,61,9,3,111,-58,Severe
6,4,76,F,52,8,5,101,25,Well
11,7,139,M,67,9,10,118,-21,Severe
17,5,209,M,95,12,9,153,-56,Severe
6,8,80,F,36,7,2,86,6,Well
18,9,225,M,59,9,1,109,-116,Severe
12,3,147,F,108,14,0,168,21,Well
5,10,70,F,98,13,0,156,86,Well
17,2,206,M,31,6,9,81,-125,Severe
9,1,109,F,50,8,3,99,-10,Severe
17,8,212,M,60,9,2,110,-102,Severe
12,9,153,M,3,5,3,63,-90,Severe
6,2,74,F,32,6,10,82,8,Well
8,11,107,M,26,6,6,78,-29,Severe
8,8,104,F,78,11,0,132,28,Well
8,10,106,M,57,8,10,106,0,Neutral
17,3,207,F,54,8,7,103,-104,Severe
9,11,119,M,107,13,11,167,48,Well
7,1,85,F,107,13,11,167,82,Well
10,3,123,F,56,8,9,105,-18,Severe
8,1,97,F,24,6,5,77,-20,Severe
14,5,173,M,42,7,7,91,-82,Severe
15,2,182,M,75,10,9,129,-53,Severe
13,3,159,M,44,7,9,93,-66,Severe
7,10,94,M,52,8,5,101,7,Well
9,10,118,F,91,12,4,148,30,Well
11,11,143,F,67,9,10,118,-25,Severe
12,0,144,M,96,12,10,154,10,Well
14,6,174,F,19,6,1,73,-101,Severe
5,7,67,F,56,8,9,105,38,Well
12,8,152,M,80,11,3,135,-17,Severe
5,2,62,F,54,8,7,103,41,Well
17,6,210,F,23,6,4,76,-134,Severe
14,8,176,M,9,5,7,67,-109,Severe
6,10,82,F,59,9,1,109,27,Well
16,5,197,F,34,7,0,84,-113,Severe
5,2,62,M,35,7,1,85,23,Well
6,2,74,M,57,8,10,106,32,Well
7,6,90,F,2,5,3,63,-27,Severe
15,1,181,M,63,9,6,114,-67,Severe
10,0,120,M,99,13,1,157,37,Well
10,11,131,M,54,8,7,103,-28,Severe
8,3,99,F,45,7,10,94,-5,Mild
6,9,81,M,23,6,4,76,-5,Mild
7,3,87,F,22,6,3,75,-12,Severe
11,3,135,M,66,9,9,117,-18,Severe
8,6,102,M,46,7,11,95,-7,Severe
8,1,97,M,23,6,4,76,-21,Severe
15,6,186,F,78,11,0,132,-54,Severe
9,8,116,F,77,10,11,131,15,Well
11,6,138,M,37,7,3,87,-51,Severe
7,7,91,F,10,5,7,67,-24,Severe
15,2,182,F,100,13,3,159,-23,Severe
5,5,65,M,46,7,11,95,30,Well
11,9,141,M,101,13,4,160,19,Well
8,5,101,F,70,10,2,122,21,Well
15,7,187,F,42,7,7,91,-96,Severe
5,9,69,F,81,11,4,136,67,Well
12,3,147,M,52,8,5,101,-46,Severe
13,10,166,F,81,11,4,136,-30,Severe
9,4,112,F,47,8,0,96,-16,Severe
12,10,154,F,23,6,4,76,-78,Severe
7,0,84,M,92,12,5,149,65,Well
17,2,206,F,52,8,5,101,-105,Severe
13,6,162,F,35,7,1,85,-77,Severe
12,0,144,M,68,10,0,120,-24,Severe
11,11,143,M,4,5,4,64,-79,Severe
14,3,171,M,106,13,10,166,-5,Mild
13,7,163,M,50,8,3,99,-64,Severe
17,6,210,M,62,9,4,112,-98,Severe
10,0,120,F,85,11,9,141,21,Well
12,2,146,F,82,11,5,137,-9,Severe
12,3,147,F,88,12,0,144,-3,Mild
12,1,145,F,98,13,0,156,11,Well
6,1,73,F,20,6,2,74,1,Good
7,1,85,M,56,8,9,105,20,Well
16,3,195,F,24,6,5,77,-118,Severe
9,4,112,F,81,11,4,136,24,Well
17,9,213,F,85,11,9,141,-72,Severe
14,8,176,M,35,7,1,85,-91,Severe
15,3,183,F,99,13,1,157,-26,Severe
9,9,117,F,47,8,0,96,-21,Severe
15,10,190,M,107,13,11,167,-23,Severe
10,1,121,F,2,5,3,63,-58,Severe
8,7,103,F,89,12,1,145,42,Well
9,2,110,M,16,5,11,71,-39,Severe
7,10,94,M,29,6,8,80,-14,Severe
9,8,116,M,43,7,8,92,-24,Severe
10,11,131,M,10,5,7,67,-64,Severe
11,2,134,F,101,13,4,160,26,Well
15,8,188,F,85,11,9,141,-47,Severe
18,8,224,F,43,7,8,92,-132,Severe
9,10,118,M,47,8,0,96,-22,Severe
14,3,171,F,94,12,7,151,-20,Severe
5,5,65,F,48,8,1,97,32,Well
17,11,215,M,71,10,3,123,-92,Severe
14,8,176,F,14,5,10,70,-106,Severe
11,11,143,M,46,7,11,95,-48,Severe
14,9,177,F,56,8,9,105,-72,Severe
11,6,138,M,17,6,0,72,-66,Severe
9,10,118,F,3,5,3,63,-55,Severe
6,5,77,M,24,6,5,77,0,Neutral
9,3,111,M,19,6,1,73,-38,Severe
17,2,206,F,30,6,9,81,-125,Severe
8,2,98,M,109,14,1,169,71,Well
9,3,111,M,73,10,6,126,15,Well
8,9,105,M,46,7,11,95,-10,Severe
16,9,201,M,82,11,5,137,-64,Severe
17,3,207,M,90,12,3,147,-60,Severe
15,1,181,F,55,8,8,104,-77,Severe
9,11,119,M,65,9,8,116,-3,Mild
8,0,96,M,25,6,5,77,-19,Severe
5,6,66,M,73,10,6,126,60,Well
14,1,169,F,90,12,3,147,-22,Severe
12,4,148,M,80,11,3,135,-13,Severe
9,3,111,F,65,9,8,116,5,Good
18,9,225,M,91,12,4,148,-77,Severe
13,8,164,F,82,11,5,137,-27,Severe
8,3,99,M,110,14,3,171,72,Well
7,5,89,M,97,12,11,155,66,Well
5,3,63,M,83,11,6,138,75,Well
7,0,84,F,64,9,7,115,31,Well
5,3,63,F,87,11,11,143,80,Well
15,3,183,M,43,7,8,92,-91,Severe
5,2,62,F,80,11,3,135,73,Well
16,4,196,F,55,8,8,104,-92,Severe
17,3,207,F,73,10,6,126,-81,Severe
7,3,87,M,99,13,1,157,70,Well
6,11,83,F,72,10,4,124,41,Well
13,7,163,F,36,7,2,86,-77,Severe
6,0,72,M,26,6,6,78,6,Well
6,4,76,F,88,12,0,144,68,Well
6,8,80,F,44,7,9,93,13,Well
15,8,188,M,38,7,4,88,-100,Severe
10,9,129,F,84,11,7,139,10,Well
9,0,108,M,104,13,7,163,55,Well
18,6,222,F,66,9,9,117,-105,Severe
7,8,92,M,51,8,4,100,8,Well
11,0,132,F,38,7,4,88,-44,Severe
5,9,69,M,18,6,1,73,4,Good
18,7,223,M,109,14,1,169,-54,Severe
5,5,65,M,38,7,4,88,23,Well
5,5,65,F,85,11,9,141,76,Well
6,0,72,M,99,13,1,157,85,Well
11,8,140,F,64,9,7,115,-25,Severe
10,1,121,F,7,5,6,66,-55,Severe
7,10,94,M,91,12,4,148,54,Well
9,3,111,F,35,7,1,85,-26,Severe
16,9,201,F,47,8,0,96,-105,Severe
10,11,131,F,37,7,3,87,-44,Severe
5,8,68,F,90,12,3,147,79,Well
15,7,187,F,102,13,6,162,-25,Severe
14,7,175,M,88,12,0,144,-31,Severe
5,0,60,F,2,5,3,63,3,Good
5,9,69,M,75,10,9,129,60,Well
13,5,161,F,74,10,7,127,-34,Severe
8,9,105,M,58,9,0,108,3,Good
5,10,70,F,104,13,7,163,93,Well
10,3,123,M,66,9,9,117,-6,Severe
6,2,74,F,109,14,1,169,95,Well
5,5,65,M,59,9,1,109,44,Well
5,1,61,M,33,6,11,83,22,Well
12,7,151,F,34,7,0,84,-67,Severe
17,4,208,F,12,5,9,69,-139,Severe
8,1,97,M,93,12,6,150,53,Well
17,3,207,F,98,13,0,156,-51,Severe
6,3,75,M,35,7,1,85,10,Well
10,0,120,M,76,10,10,130,10,Well
18,3,219,M,68,10,0,120,-99,Severe
8,11,107,M,108,14,0,168,61,Well
14,6,174,F,12,5,9,69,-105,Severe
17,7,211,F,26,6,6,78,-133,Severe
15,1,181,F,23,6,4,76,-105,Severe
17,6,210,M,47,8,0,96,-114,Severe
18,0,216,M,81,11,4,136,-80,Severe
18,10,226,F,40,7,5,89,-137,Severe
15,11,191,M,82,11,5,137,-54,Severe
6,9,81,F,11,5,8,68,-13,Severe
8,0,96,F,73,10,6,126,30,Well
10,9,129,M,101,13,4,160,31,Well
8,4,100,F,37,7,3,87,-13,Severe
13,4,160,F,100,13,3,159,-1,Mild
15,3,183,F,35,7,1,85,-98,Severe
16,3,195,F,33,6,11,83,-112,Severe
7,8,92,M,52,8,5,101,9,Well
14,9,177,F,41,7,6,90,-87,Severe
11,0,132,F,90,12,3,147,15,Well
7,10,94,F,18,6,1,73,-21,Severe
18,5,221,F,106,13,10,166,-55,Severe
6,3,75,M,45,7,10,94,19,Well
5,6,66,M,68,10,0,120,54,Well
9,5,113,F,67,9,10,118,5,Good
12,3,147,M,26,6,6,78,-69,Severe
9,3,111,M,104,13,7,163,52,Well
10,3,123,F,90,12,3,147,24,Well
17,8,212,F,23,6,4,76,-136,Severe
18,10,226,F,35,7,1,85,-141,Severe
17,0,204,M,35,7,1,85,-119,Severe
17,1,205,M,84,11,7,139,-66,Severe
10,10,130,M,69,10,1,121,-9,Severe
12,3,147,F,70,10,2,122,-25,Severe
13,1,157,M,68,10,0,120,-37,Severe
17,9,213,M,95,12,9,153,-60,Severe
11,10,142,M,18,6,1,73,-69,Severe
17,6,210,M,78,11,0,132,-78,Severe
11,11,143,F,69,10,1,121,-22,Severe
8,10,106,F,95,12,9,153,47,Well
9,7,115,M,75,10,9,129,14,Well
18,1,217,M,98,13,0,156,-61,Severe
8,2,98,M,67,9,10,118,20,Well
18,6,222,M,81,11,4,136,-86,Severe
17,3,207,F,52,8,5,101,-106,Severe
15,8,188,M,32,6,10,82,-106,Severe
18,5,221,F,50,8,3,99,-122,Severe
7,0,84,M,6,5,5,65,-19,Severe
15,4,184,M,52,8,5,101,-83,Severe
9,1,109,M,18,6,1,73,-36,Severe
9,2,110,F,4,5,4,64,-46,Severe
9,8,116,F,96,12,10,154,38,Well
5,6,66,F,32,6,10,82,16,Well
17,1,205,M,82,11,5,137,-68,Severe
11,1,133,M,92,12,5,149,16,Well
6,11,83,M,100,13,3,159,76,Well
10,5,125,F,86,11,10,142,17,Well
8,10,106,M,21,6,2,74,-32,Severe
13,3,159,M,59,9,1,109,-50,Severe
7,7,91,F,109,14,1,169,78,Well
14,3,171,M,31,6,9,81,-90,Severe
17,3,207,F,46,7,11,95,-112,Severe
13,0,156,F,4,5,4,64,-92,Severe
8,5,101,M,91,12,4,148,47,Well
10,7,127,M,49,8,2,98,-29,Severe
18,1,217,F,86,11,10,142,-75,Severe
18,8,224,M,19,6,1,73,-151,Severe
10,6,126,F,60,9,2,110,-16,Severe
7,11,95,F,18,6,1,73,-22,Severe
9,4,112,F,17,6,0,72,-40,Severe
11,5,137,M,82,11,5,137,0,Neutral
9,7,115,F,95,12,9,153,38,Well
13,10,166,M,87,11,11,143,-23,Severe
12,5,149,M,85,11,9,141,-8,Severe
16,6,198,F,53,8,6,102,-96,Severe
14,3,171,F,61,9,3,111,-60,Severe
9,6,114,F,19,6,1,73,-41,Severe
8,7,103,F,105,13,9,165,62,Well
6,11,83,M,69,10,1,121,38,Well
11,9,141,M,22,6,3,75,-66,Severe
11,5,137,F,90,12,3,147,10,Well
15,1,181,M,7,5,6,66,-115,Severe
7,4,88,M,16,5,11,71,-17,Severe
7,4,88,F,75,10,9,129,41,Well
11,4,136,M,14,5,10,70,-66,Severe
18,11,227,M,19,6,1,73,-154,Severe
13,6,162,F,100,13,3,159,-3,Mild
7,5,89,M,50,8,3,99,10,Well
15,0,180,F,41,7,6,90,-90,Severe
8,10,106,M,78,11,0,132,26,Well
10,7,127,F,31,6,9,81,-46,Severe
10,7,127,M,96,12,10,154,27,Well
13,4,160,M,110,14,3,171,11,Well
7,11,95,M,86,11,10,142,47,Well
7,4,88,F,36,7,2,86,-2,Mild
9,0,108,M,87,11,11,143,35,Well
18,10,226,F,108,14,0,168,-58,Severe
16,1,193,M,70,10,2,122,-71,Severe
11,7,139,F,58,9,0,108,-31,Severe
15,3,183,F,45,7,10,94,-89,Severe
17,8,212,M,98,13,0,156,-56,Severe
12,0,144,F,52,8,5,101,-43,Severe
13,9,165,F,21,6,2,74,-91,Severe
7,3,87,M,64,9,7,115,28,Well
15,5,185,M,54,8,7,103,-82,Severe
9,11,119,M,67,9,10,118,-1,Mild
18,9,225,F,85,11,9,141,-84,Severe
6,5,77,F,41,7,6,90,13,Well
13,5,161,F,7,5,6,66,-95,Severe
12,8,152,F,38,7,4,88,-64,Severe
9,3,111,F,75,10,9,129,18,Well
8,11,107,M,72,10,4,124,17,Well
8,11,107,F,44,7,9,93,-14,Severe
12,1,145,M,61,9,3,111,-34,Severe
13,0,156,F,5,5,5,65,-91,Severe
13,8,164,M,62,9,4,112,-52,Severe
18,6,222,F,110,14,3,171,-51,Severe
8,6,102,F,92,12,5,149,47,Well
6,0,72,M,19,6,1,73,1,Good
5,7,67,F,88,12,0,144,77,Well
16,6,198,M,105,13,9,165,-33,Severe
12,6,150,F,104,13,7,163,13,Well
5,5,65,F,44,7,9,93,28,Well
14,2,170,F,71,10,3,123,-47,Severe
18,2,218,F,54,8,7,103,-115,Severe
10,9,129,M,31,6,9,81,-48,Severe
6,10,82,F,95,12,9,153,71,Well
6,6,78,M,29,6,8,80,2,Good
11,1,133,F,11,5,8,68,-65,Severe
9,1,109,M,102,13,6,162,53,Well
13,9,165,F,45,7,10,94,-71,Severe
18,3,219,M,107,13,11,167,-52,Severe
5,1,61,F,18,6,1,73,12,Well
7,2,86,F,102,13,6,162,76,Well
16,6,198,M,11,5,8,68,-130,Severe
5,0,60,F,38,7,4,88,28,Well
5,1,61,F,16,5,11,71,10,Well
5,8,68,M,57,8,10,106,38,Well
17,5,209,F,76,10,10,130,-79,Severe
9,2,110,F,9,5,7,67,-43,Severe
5,11,71,M,22,6,3,75,4,Good
10,11,131,M,9,5,7,67,-64,Severe
9,0,108,F,71,10,3,123,15,Well
14,9,177,M,28,6,8,80,-97,Severe
16,1,193,F,9,5,7,67,-126,Severe
17,9,213,M,11,5,8,68,-145,Severe
13,3,159,M,14,5,10,70,-89,Severe
15,9,189,F,84,11,7,139,-50,Severe
16,5,197,M,28,6,8,80,-117,Severe
14,10,178,F,103,13,6,162,-16,Severe
13,5,161,M,63,9,6,114,-47,Severe
5,2,62,F,30,6,9,81,19,Well
8,4,100,M,106,13,10,166,66,Well
15,0,180,M,70,10,2,122,-58,Severe
16,9,201,F,15,5,11,71,-130,Severe
13,1,157,F,46,7,11,95,-62,Severe
14,4,172,M,102,13,6,162,-10,Severe
12,5,149,M,22,6,3,75,-74,Severe
14,6,174,F,76,10,10,130,-44,Severe
17,3,207,M,39,7,5,89,-118,Severe
8,11,107,M,76,10,10,130,23,Well
5,0,60,F,86,11,10,142,82,Well
11,3,135,M,81,11,4,136,1,Good
15,7,187,F,22,6,3,75,-112,Severe
7,3,87,M,27,6,7,79,-8,Severe
12,3,147,M,7,5,6,66,-81,Severe
7,4,88,F,16,5,11,71,-17,Severe
6,1,73,F,14,5,10,70,-3,Mild
5,11,71,M,47,8,0,96,25,Well
6,1,73,M,63,9,6,114,41,Well
7,11,95,F,34,7,0,84,-11,Severe
17,11,215,F,37,7,3,87,-128,Severe
8,2,98,F,11,5,8,68,-30,Severe
13,1,157,M,92,12,5,149,-8,Severe
12,10,154,M,27,6,7,79,-75,Severe
13,1,157,F,105,13,9,165,8,Well
12,11,155,F,97,12,11,155,0,Neutral
18,0,216,M,58,9,0,108,-108,Severe
5,8,68,F,78,11,0,132,64,Well
9,11,119,M,76,10,10,130,11,Well
11,3,135,F,4,5,4,64,-71,Severe
7,10,94,M,44,7,9,93,-1,Mild
17,7,211,M,26,6,6,78,-133,Severe
8,2,98,F,3,5,3,63,-35,Severe
13,2,158,F,102,13,6,162,4,Good
14,2,170,M,102,13,6,162,-8,Severe
9,9,117,M,10,5,7,67,-50,Severe
15,9,189,M,88,12,0,144,-45,Severe
10,3,123,F,13,5,9,69,-54,Severe
16,9,201,M,14,5,10,70,-131,Severe
15,6,186,M,59,9,1,109,-77,Severe
7,4,88,F,73,10,6,126,38,Well
11,11,143,F,35,7,1,85,-58,Severe
12,11,155,F,32,6,10,82,-73,Severe
15,11,191,F,44,7,9,93,-98,Severe
12,5,149,F,21,6,2,74,-75,Severe
14,0,168,F,21,6,2,74,-94,Severe
14,2,170,M,67,9,10,118,-52,Severe
7,3,87,F,87,11,11,143,56,Well
5,3,63,F,79,11,1,133,70,Well
11,10,142,M,100,13,3,159,17,Well
14,3,171,F,98,13,0,156,-15,Severe
5,3,63,M,60,9,2,110,47,Well
5,9,69,F,106,13,10,166,97,Well
12,4,148,F,16,5,11,71,-77,Severe
9,4,112,M,76,10,10,130,18,Well
5,11,71,F,65,9,8,116,45,Well
12,10,154,M,55,8,8,104,-50,Severe
9,9,117,F,96,12,10,154,37,Well
7,3,87,F,55,8,8,104,17,Well
10,8,128,M,77,10,11,131,3,Good
8,11,107,M,98,13,0,156,49,Well
16,10,202,M,42,7,7,91,-111,Severe
12,6,150,M,38,7,4,88,-62,Severe
6,2,74,M,92,12,5,149,75,Well
17,1,205,F,10,5,7,67,-138,Severe
16,2,194,F,91,12,4,148,-46,Severe
10,6,126,M,8,5,6,66,-60,Severe
17,0,204,M,48,8,1,97,-107,Severe
17,3,207,M,33,6,11,83,-124,Severe
9,4,112,F,66,9,9,117,5,Good
16,2,194,M,56,8,9,105,-89,Severe
7,7,91,F,70,10,2,122,31,Well
12,2,146,M,88,12,0,144,-2,Mild
13,5,161,F,42,7,7,91,-70,Severe
10,2,122,F,53,8,6,102,-20,Severe
10,2,122,F,14,5,10,70,-52,Severe
12,2,146,M,70,10,2,122,-24,Severe
16,3,195,F,31,6,9,81,-114,Severe
11,7,139,F,3,5,3,63,-76,Severe
7,2,86,M,11,5,8,68,-18,Severe
5,4,64,M,14,5,10,70,6,Well
9,10,118,F,8,5,6,66,-52,Severe
9,6,114,F,13,5,9,69,-45,Severe
5,10,70,M,6,5,5,65,-5,Mild
17,8,212,M,91,12,4,148,-64,Severe
7,8,92,M,48,8,1,97,5,Good
10,1,121,F,73,10,6,126,5,Good
6,9,81,F,6,5,5,65,-16,Severe
14,4,172,F,78,11,0,132,-40,Severe
16,6,198,M,13,5,9,69,-129,Severe
18,10,226,M,85,11,9,141,-85,Severe
7,3,87,F,76,10,10,130,43,Well
15,9,189,M,66,9,9,117,-72,Severe
15,3,183,M,88,12,0,144,-39,Severe
15,2,182,F,28,6,8,80,-102,Severe
11,6,138,M,54,8,7,103,-35,Severe
5,11,71,M,104,13,7,163,92,Well
16,7,199,M,9,5,7,67,-132,Severe
8,6,102,M,7,5,6,66,-36,Severe
6,0,72,F,46,7,11,95,23,Well
7,6,90,F,14,5,10,70,-20,Severe
6,10,82,F,65,9,8,116,34,Well
5,1,61,M,18,6,1,73,12,Well
17,10,214,F,66,9,9,117,-97,Severe
9,3,111,F,98,13,0,156,45,Well
10,11,131,F,33,6,11,83,-48,Severe
14,7,175,M,106,13,10,166,-9,Severe
16,11,203,F,41,7,6,90,-113,Severe
8,8,104,M,99,13,1,157,53,Well
14,9,177,M,109,14,1,169,-8,Severe
10,7,127,M,53,8,6,102,-25,Severe
9,0,108,F,101,13,4,160,52,Well
16,9,201,F,82,11,5,137,-64,Severe
16,10,202,M,24,6,5,77,-125,Severe
13,7,163,M,26,6,6,78,-85,Severe
12,3,147,F,106,13,10,166,19,Well
16,7,199,M,93,12,6,150,-49,Severe
11,3,135,M,104,13,7,163,28,Well
8,3,99,M,97,12,11,155,56,Well
6,0,72,M,72,10,4,124,52,Well
18,7,223,F,53,8,6,102,-121,Severe
10,2,122,F,98,13,0,156,34,Well
17,7,211,F,93,12,6,150,-61,Severe
10,4,124,F,16,5,11,71,-53,Severe
12,1,145,F,58,9,0,108,-37,Severe
16,3,195,F,25,6,5,77,-118,Severe
7,6,90,M,49,8,2,98,8,Well
15,0,180,M,84,11,7,139,-41,Severe
14,9,177,F,9,5,7,67,-110,Severe
5,5,65,M,24,6,5,77,12,Well
10,3,123,M,43,7,8,92,-31,Severe
11,6,138,M,63,9,6,114,-24,Severe
11,9,141,M,62,9,4,112,-29,Severe
16,8,200,F,6,5,5,65,-135,Severe
16,10,202,F,90,12,3,147,-55,Severe
16,5,197,F,88,12,0,144,-53,Severe
11,0,132,F,76,10,10,130,-2,Mild
11,0,132,M,5,5,5,65,-67,Severe
9,5,113,F,66,9,9,117,4,Good
17,7,211,F,31,6,9,81,-130,Severe
15,0,180,M,34,7,0,84,-96,Severe
14,10,178,M,71,10,3,123,-55,Severe
9,11,119,M,22,6,3,75,-44,Severe
13,3,159,M,45,7,10,94,-65,Severe
9,10,118,F,79,11,1,133,15,Well
6,10,82,F,17,6,0,72,-10,Severe
6,0,72,M,51,8,4,100,28,Well
11,0,132,M,18,6,1,73,-59,Severe
15,7,187,M,109,14,1,169,-18,Severe
16,11,203,M,65,9,8,116,-87,Severe
15,8,188,M,5,5,5,65,-123,Severe
14,3,171,M,100,13,3,159,-12,Severe
5,8,68,F,69,10,1,121,53,Well
9,10,118,M,14,5,10,70,-48,Severe
13,5,161,F,4,5,4,64,-97,Severe
12,7,151,F,68,10,0,120,-31,Severe
14,1,169,M,21,6,2,74,-95,Severe
13,1,157,M,55,8,8,104,-53,Severe
12,11,155,M,48,8,1,97,-58,Severe
18,5,221,F,69,10,1,121,-100,Severe
15,0,180,F,74,10,7,127,-53,Severe
10,5,125,M,83,11,6,138,13,Well
14,2,170,F,62,9,4,112,-58,Severe
14,6,174,F,8,5,6,66,-108,Severe
18,6,222,M,59,9,1,109,-113,Severe
17,0,204,F,54,8,7,103,-101,Severe
9,8,116,M,60,9,2,110,-6,Severe
16,6,198,F,64,9,7,115,-83,Severe
10,5,125,F,50,8,3,99,-26,Severe
12,3,147,M,56,8,9,105,-42,Severe
10,1,121,F,67,9,10,118,-3,Mild
5,2,62,M,74,10,7,127,65,Well
11,3,135,F,43,7,8,92,-43,Severe
14,11,179,F,16,5,11,71,-108,Severe
13,11,167,F,92,12,5,149,-18,Severe
12,1,145,M,79,11,1,133,-12,Severe
17,11,215,F,30,6,9,81,-134,Severe
13,3,159,M,40,7,5,89,-70,Severe
8,5,101,M,24,6,5,77,-24,Severe
17,4,208,F,66,9,9,117,-91,Severe
18,5,221,F,9,5,7,67,-154,Severe
12,4,148,F,20,6,2,74,-74,Severe
7,4,88,M,17,6,0,72,-16,Severe
11,2,134,F,22,6,3,75,-59,Severe
18,7,223,F,9,5,7,67,-156,Severe
9,3,111,F,24,6,5,77,-34,Severe
16,3,195,F,36,7,2,86,-109,Severe
11,5,137,F,78,11,0,132,-5,Mild
5,7,67,F,106,13,10,166,99,Well
14,8,176,F,90,12,3,147,-29,Severe
12,3,147,M,85,11,9,141,-6,Severe
13,1,157,M,8,5,6,66,-91,Severe
14,1,169,M,63,9,6,114,-55,Severe
6,4,76,F,55,8,8,104,28,Well
18,1,217,M,52,8,5,101,-116,Severe
17,1,205,F,63,9,6,114,-91,Severe
10,6,126,M,20,6,2,74,-52,Severe
17,2,206,M,93,12,6,150,-56,Severe
6,0,72,M,17,6,0,72,0,Neutral
13,8,164,M,96,12,10,154,-10,Severe
14,9,177,M,60,9,2,110,-67,Severe
15,11,191,F,97,12,11,155,-36,Severe
9,11,119,M,99,13,1,157,38,Well
9,2,110,F,97,12,11,155,45,Well
11,10,142,M,74,10,7,127,-15,Severe
17,10,214,M,85,11,9,141,-73,Severe
14,7,175,F,96,12,10,154,-21,Severe
11,4,136,M,41,7,6,90,-46,Severe
13,7,163,M,36,7,2,86,-77,Severe
10,3,123,F,107,13,11,167,44,Well
12,9,153,F,6,5,5,65,-88,Severe
10,3,123,F,48,8,1,97,-26,Severe
17,7,211,M,66,9,9,117,-94,Severe
12,7,151,M,8,5,6,66,-85,Severe
16,1,193,F,110,14,3,171,-22,Severe
9,3,111,F,92,12,5,149,38,Well
18,4,220,M,81,11,4,136,-84,Severe
17,4,208,M,25,6,5,77,-131,Severe
6,10,82,F,66,9,9,117,35,Well
14,3,171,M,4,5,4,64,-107,Severe
13,3,159,M,91,12,4,148,-11,Severe
13,11,167,M,94,12,7,151,-16,Severe
9,0,108,M,17,6,0,72,-36,Severe
10,11,131,F,45,7,10,94,-37,Severe
5,3,63,F,50,8,3,99,36,Well
16,6,198,F,54,8,7,103,-95,Severe
17,10,214,M,96,12,10,154,-60,Severe
17,0,204,M,10,5,7,67,-137,Severe
18,2,218,M,48,8,1,97,-121,Severe
8,0,96,F,40,7,5,89,-7,Severe
9,1,109,F,73,10,6,126,17,Well
17,3,207,F,96,12,10,154,-53,Severe
13,1,157,M,41,7,6,90,-67,Severe
9,2,110,F,47,8,0,96,-14,Severe
5,7,67,M,58,9,0,108,41,Well
7,8,92,M,94,12,7,151,59,Well
12,6,150,F,24,6,5,77,-73,Severe
16,3,195,F,15,5,11,71,-124,Severe
5,6,66,M,100,13,3,159,93,Well
6,7,79,M,50,8,3,99,20,Well
10,9,129,M,109,14,1,169,40,Well
17,11,215,M,80,11,3,135,-80,Severe
18,10,226,M,67,9,10,118,-108,Severe
10,7,127,M,19,6,1,73,-54,Severe
5,6,66,F,99,13,1,157,91,Well
11,2,134,F,88,12,0,144,10,Well
9,11,119,M,46,7,11,95,-24,Severe
16,1,193,F,61,9,3,111,-82,Severe
5,6,66,M,33,6,11,83,17,Well
5,9,69,F,45,7,10,94,25,Well
10,11,131,M,48,8,1,97,-34,Severe
7,3,87,M,33,6,11,83,-4,Mild
15,2,182,F,3,5,3,63,-119,Severe
17,10,214,F,11,5,8,68,-146,Severe
16,3,195,F,62,9,4,112,-83,Severe
11,4,136,M,59,9,1,109,-27,Severe
13,2,158,M,60,9,2,110,-48,Severe
18,3,219,M,43,7,8,92,-127,Severe
14,1,169,F,92,12,5,149,-20,Severe
14,1,169,M,44,7,9,93,-76,Severe
9,3,111,M,39,7,5,89,-22,Severe
9,11,119,M,37,7,3,87,-32,Severe
11,11,143,M,98,13,0,156,13,Well
11,7,139,F,81,11,4,136,-3,Mild
13,8,164,M,31,6,9,81,-83,Severe
18,3,219,M,36,7,2,86,-133,Severe
5,2,62,M,19,6,1,73,11,Well
10,8,128,F,16,5,11,71,-57,Severe
15,7,187,F,34,7,0,84,-103,Severe
6,7,79,M,47,8,0,96,17,Well
9,8,116,F,78,11,0,132,16,Well
9,5,113,F,41,7,6,90,-23,Severe
5,8,68,F,23,6,4,76,8,Well
15,11,191,F,93,12,6,150,-41,Severe
10,10,130,F,28,6,8,80,-50,Severe
17,6,210,M,35,7,1,85,-125,Severe
7,4,88,F,99,13,1,157,69,Well
11,5,137,F,104,13,7,163,26,Well
8,3,99,M,110,14,3,171,72,Well
18,1,217,M,85,11,9,141,-76,Severe
18,11,227,F,77,10,11,131,-96,Severe
10,6,126,M,86,11,10,142,16,Well
17,3,207,M,63,9,6,114,-93,Severe
14,8,176,F,57,8,10,106,-70,Severe
7,5,89,M,106,13,10,166,77,Well
5,3,63,M,25,6,5,77,14,Well
18,2,218,F,46,7,11,95,-123,Severe
5,5,65,M,44,7,9,93,28,Well
17,3,207,F,68,10,0,120,-87,Severe
12,0,144,F,37,7,3,87,-57,Severe
10,3,123,F,27,6,7,79,-44,Severe
17,0,204,M,44,7,9,93,-111,Severe
8,4,100,F,58,9,0,108,8,Well
13,8,164,M,90,12,3,147,-17,Severe
10,3,123,F,79,11,1,133,10,Well
13,11,167,F,110,14,3,171,4,Good
6,2,74,M,53,8,6,102,28,Well
6,3,75,F,83,11,6,138,63,Well
9,5,113,M,42,7,7,91,-22,Severe
16,7,199,F,12,5,9,69,-130,Severe
16,9,201,F,53,8,6,102,-99,Severe
12,9,153,M,52,8,5,101,-52,Severe
9,6,114,M,48,8,1,97,-17,Severe
13,3,159,F,20,6,2,74,-85,Severe
9,7,115,M,31,6,9,81,-34,Severe
8,1,97,M,61,9,3,111,14,Well
11,3,135,M,83,11,6,138,3,Good
10,0,120,F,13,5,9,69,-51,Severe
15,1,181,M,46,7,11,95,-86,Severe
8,7,103,M,26,6,6,78,-25,Severe
14,2,170,F,99,13,1,157,-13,Severe
9,1,109,F,27,6,7,79,-30,Severe
13,0,156,F,73,10,6,126,-30,Severe
15,4,184,F,30,6,9,81,-103,Severe
11,7,139,F,94,12,7,151,12,Well
13,2,158,M,3,5,3,63,-95,Severe
14,1,169,F,57,8,10,106,-63,Severe
9,2,110,M,21,6,2,74,-36,Severe
6,4,76,F,99,13,1,157,81,Well
17,9,213,F,102,13,6,162,-51,Severe
5,4,64,F,79,11,1,133,69,Well
11,6,138,F,44,7,9,93,-45,Severe
7,9,93,M,32,6,10,82,-11,Severe
9,4,112,F,26,6,6,78,-34,Severe
9,8,116,F,54,8,7,103,-13,Severe
7,6,90,M,80,11,3,135,45,Well
13,9,165,F,26,6,6,78,-87,Severe
9,3,111,M,60,9,2,110,-1,Mild
17,1,205,F,85,11,9,141,-64,Severe
6,4,76,F,107,13,11,167,91,Well
5,2,62,F,46,7,11,95,33,Well
5,1,61,F,67,9,10,118,57,Well
6,8,80,M,11,5,8,68,-12,Severe
9,8,116,M,42,7,7,91,-25,Severe
15,0,180,F,12,5,9,69,-111,Severe
10,3,123,M,108,14,0,168,45,Well
11,4,136,F,5,5,5,65,-71,Severe
17,8,212,F,74,10,7,127,-85,Severe
8,0,96,F,106,13,10,166,70,Well
9,4,112,F,33,6,11,83,-29,Severe
18,8,224,F,92,12,5,149,-75,Severe
14,5,173,F,46,7,11,95,-78,Severe
7,11,95,F,8,5,6,66,-29,Severe
9,7,115,F,70,10,2,122,7,Well
6,3,75,F,15,5,11,71,-4,Mild
13,3,159,F,37,7,3,87,-72,Severe
5,7,67,M,60,9,2,110,43,Well
16,5,197,M,106,13,10,166,-31,Severe
7,10,94,M,9,5,7,67,-27,Severe
18,9,225,F,82,11,5,137,-88,Severe
7,5,89,F,11,5,8,68,-21,Severe
5,7,67,F,93,12,6,150,83,Well
12,6,150,M,92,12,5,149,-1,Mild
8,2,98,M,2,5,3,63,-35,Severe
15,2,182,M,3,5,3,63,-119,Severe
17,3,207,M,103,13,6,162,-45,Severe
8,7,103,F,33,6,11,83,-20,Severe
17,1,205,F,89,12,1,145,-60,Severe
16,10,202,M,56,8,9,105,-97,Severe
11,10,142,F,19,6,1,73,-69,Severe
15,6,186,F,76,10,10,130,-56,Severe
12,0,144,F,24,6,5,77,-67,Severe
6,0,72,M,41,7,6,90,18,Well
12,0,144,M,63,9,6,114,-30,Severe
12,0,144,M,4,5,4,64,-80,Severe
18,5,221,F,110,14,3,171,-50,Severe
7,8,92,F,38,7,4,88,-4,Mild
13,1,157,F,50,8,3,99,-58,Severe
14,0,168,F,105,13,9,165,-3,Mild
7,8,92,M,104,13,7,163,71,Well
11,1,133,M,24,6,5,77,-56,Severe
10,11,131,F,94,12,7,151,20,Well
13,6,162,F,81,11,4,136,-26,Severe
10,2,122,M,90,12,3,147,25,Well
17,11,215,M,107,13,11,167,-48,Severe
9,3,111,M,41,7,6,90,-21,Severe
5,10,70,F,45,7,10,94,24,Well
9,3,111,M,66,9,9,117,6,Well
7,8,92,M,29,6,8,80,-12,Severe
7,1,85,M,101,13,4,160,75,Well
10,7,127,F,51,8,4,100,-27,Severe
11,9,141,F,97,12,11,155,14,Well
5,7,67,F,72,10,4,124,57,Well
8,1,97,M,69,10,1,121,24,Well
8,1,97,F,62,9,4,112,15,Well
12,8,152,F,13,5,9,69,-83,Severe
10,7,127,F,92,12,5,149,22,Well
15,10,190,F,23,6,4,76,-114,Severe
17,7,211,F,45,7,10,94,-117,Severe
9,9,117,M,107,13,11,167,50,Well
12,8,152,F,79,11,1,133,-19,Severe
11,8,140,M,47,8,0,96,-44,Severe
17,8,212,M,40,7,5,89,-123,Severe
9,10,118,F,13,5,9,69,-49,Severe
17,5,209,F,84,11,7,139,-70,Severe
9,2,110,M,63,9,6,114,4,Good
9,3,111,M,18,6,1,73,-38,Severe
15,5,185,F,65,9,8,116,-69,Severe
13,2,158,M,72,10,4,124,-34,Severe
7,3,87,M,66,9,9,117,30,Well
9,5,113,M,63,9,6,114,1,Good
11,9,141,F,29,6,8,80,-61,Severe
5,3,63,F,22,6,3,75,12,Well
5,8,68,F,7,5,6,66,-2,Mild
12,5,149,F,96,12,10,154,5,Good
12,4,148,F,80,11,3,135,-13,Severe
18,1,217,F,8,5,6,66,-151,Severe
16,8,200,F,39,7,5,89,-111,Severe
16,0,192,M,109,14,1,169,-23,Severe
13,5,161,F,54,8,7,103,-58,Severe
7,1,85,F,84,11,7,139,54,Well
17,9,213,F,3,5,3,63,-150,Severe
10,4,124,M,34,7,0,84,-40,Severe
8,9,105,M,39,7,5,89,-16,Severe
9,9,117,F,71,10,3,123,6,Well
12,6,150,F,79,11,1,133,-17,Severe
6,1,73,M,80,11,3,135,62,Well
7,5,89,M,8,5,6,66,-23,Severe
11,2,134,F,79,11,1,133,-1,Mild
13,5,161,M,104,13,7,163,2,Good
16,7,199,F,106,13,10,166,-33,Severe
8,3,99,M,21,6,2,74,-25,Severe
16,8,200,M,77,10,11,131,-69,Severe
5,3,63,M,53,8,6,102,39,Well
5,10,70,F,17,6,0,72,2,Good
6,10,82,M,56,8,9,105,23,Well
9,8,116,F,82,11,5,137,21,Well
6,3,75,M,80,11,3,135,60,Well
18,9,225,F,15,5,11,71,-154,Severe
16,3,195,F,66,9,9,117,-78,Severe
6,0,72,M,44,7,9,93,21,Well
15,9,189,M,63,9,6,114,-75,Severe
5,1,61,F,5,5,5,65,4,Good
15,0,180,M,108,14,0,168,-12,Severe
16,4,196,F,104,13,7,163,-33,Severe
18,4,220,F,88,12,0,144,-76,Severe
9,0,108,M,31,6,9,81,-27,Severe
13,3,159,F,15,5,11,71,-88,Severe
11,3,135,F,67,9,10,118,-17,Severe
6,7,79,M,99,13,1,157,78,Well
12,2,146,F,26,6,6,78,-68,Severe
16,0,192,M,69,10,1,121,-71,Severe
10,8,128,M,19,6,1,73,-55,Severe
11,3,135,F,102,13,6,162,27,Well
7,4,88,F,77,10,11,131,43,Well
9,11,119,M,2,5,3,63,-56,Severe
16,2,194,M,96,12,10,154,-40,Severe
9,3,111,M,71,10,3,123,12,Well
10,2,122,M,84,11,7,139,17,Well
13,5,161,F,80,11,3,135,-26,Severe
8,3,99,M,31,6,9,81,-18,Severe
14,3,171,F,21,6,2,74,-97,Severe
16,5,197,F,106,13,10,166,-31,Severe
15,9,189,F,107,13,11,167,-22,Severe
14,7,175,M,89,12,1,145,-30,Severe
17,5,209,F,37,7,3,87,-122,Severe
11,4,136,F,29,6,8,80,-56,Severe
16,4,196,F,69,10,1,121,-75,Severe
17,5,209,F,41,7,6,90,-119,Severe
18,3,219,F,104,13,7,163,-56,Severe
6,0,72,M,70,10,2,122,50,Well
11,0,132,F,47,8,0,96,-36,Severe
9,8,116,F,60,9,2,110,-6,Severe
16,2,194,M,18,6,1,73,-121,Severe
18,7,223,F,44,7,9,93,-130,Severe
9,11,119,M,53,8,6,102,-17,Severe
5,3,63,F,10,5,7,67,4,Good
10,4,124,M,45,7,10,94,-30,Severe
10,3,123,F,36,7,2,86,-37,Severe
7,3,87,M,74,10,7,127,40,Well
14,11,179,M,65,9,8,116,-63,Severe
9,9,117,F,32,6,10,82,-35,Severe
12,10,154,M,98,13,0,156,2,Good
18,1,217,F,58,9,0,108,-109,Severe
14,2,170,M,26,6,6,78,-92,Severe
11,7,139,M,98,13,0,156,17,Well
8,11,107,M,42,7,7,91,-16,Severe
13,7,163,M,84,11,7,139,-24,Severe
17,3,207,F,53,8,6,102,-105,Severe
15,0,180,F,72,10,4,124,-56,Severe
15,1,181,F,13,5,9,69,-112,Severe
7,0,84,F,30,6,9,81,-3,Mild
16,11,203,F,25,6,5,77,-126,Severe
14,4,172,M,78,11,0,132,-40,Severe
10,7,127,M,103,13,6,162,35,Well
10,6,126,F,99,13,1,157,31,Well
9,1,109,F,59,9,1,109,0,Neutral
13,3,159,F,90,12,3,147,-12,Severe
11,3,135,F,51,8,4,100,-35,Severe
8,3,99,M,50,8,3,99,0,Neutral
10,1,121,M,43,7,8,92,-29,Severe
17,3,207,F,19,6,1,73,-134,Severe
8,6,102,F,13,5,9,69,-33,Severe
6,0,72,F,103,13,6,162,90,Well
9,4,112,F,2,5,3,63,-49,Severe
7,0,84,F,100,13,3,159,75,Well
8,5,101,F,73,10,6,126,25,Well
16,3,195,M,94,12,7,151,-44,Severe
5,1,61,F,31,6,9,81,20,Well
12,9,153,M,95,12,9,153,0,Neutral
10,9,129,F,75,10,9,129,0,Neutral
11,5,137,F,24,6,5,77,-60,Severe
10,6,126,F,40,7,5,89,-37,Severe
11,8,140,M,70,10,2,122,-18,Severe
9,3,111,F,88,12,0,144,33,Well
15,7,187,F,11,5,8,68,-119,Severe
5,7,67,M,33,6,11,83,16,Well
16,4,196,F,52,8,5,101,-95,Severe
7,9,93,M,40,7,5,89,-4,Mild
15,11,191,M,7,5,6,66,-125,Severe
15,4,184,F,75,10,9,129,-55,Severe
11,9,141,M,49,8,2,98,-43,Severe
16,5,197,M,88,12,0,144,-53,Severe
14,8,176,F,4,5,4,64,-112,Severe
6,3,75,M,20,6,2,74,-1,Mild
5,9,69,M,29,6,8,80,11,Well
14,7,175,F,32,6,10,82,-93,Severe
7,6,90,M,53,8,6,102,12,Well
16,0,192,F,4,5,4,64,-128,Severe
8,8,104,M,57,8,10,106,2,Good
13,2,158,F,61,9,3,111,-47,Severe
8,3,99,M,76,10,10,130,31,Well
7,10,94,F,73,10,6,126,32,Well
18,5,221,M,83,11,6,138,-83,Severe
14,4,172,M,101,13,4,160,-12,Severe
9,11,119,M,4,5,4,64,-55,Severe
17,8,212,F,71,10,3,123,-89,Severe
15,6,186,M,102,13,6,162,-24,Severe
13,6,162,M,61,9,3,111,-51,Severe
9,11,119,F,3,5,3,63,-56,Severe
11,3,135,M,25,6,5,77,-58,Severe
10,8,128,M,67,9,10,118,-10,Severe
12,0,144,M,82,11,5,137,-7,Severe
15,3,183,M,31,6,9,81,-102,Severe
15,10,190,M,29,6,8,80,-110,Severe
10,4,124,M,22,6,3,75,-49,Severe
7,11,95,F,105,13,9,165,70,Well
10,3,123,F,76,10,10,130,7,Well
12,0,144,F,83,11,6,138,-6,Severe
8,1,97,F,12,5,9,69,-28,Severe
13,8,164,F,101,13,4,160,-4,Mild
10,3,123,M,54,8,7,103,-20,Severe
14,0,168,F,20,6,2,74,-94,Severe
13,2,158,M,105,13,9,165,7,Well
7,5,89,F,35,7,1,85,-4,Mild
7,10,94,M,20,6,2,74,-20,Severe
14,11,179,M,19,6,1,73,-106,Severe
11,3,135,F,93,12,6,150,15,Well
11,5,137,F,91,12,4,148,11,Well
8,1,97,F,64,9,7,115,18,Well
17,10,214,M,69,10,1,121,-93,Severe
11,3,135,M,105,13,9,165,30,Well
15,7,187,F,79,11,1,133,-54,Severe
16,4,196,M,61,9,3,111,-85,Severe
11,8,140,F,61,9,3,111,-29,Severe
7,2,86,M,97,12,11,155,69,Well
8,3,99,F,71,10,3,123,24,Well
12,4,148,F,77,10,11,131,-17,Severe
14,1,169,M,53,8,6,102,-67,Severe
18,6,222,M,5,5,5,65,-157,Severe
11,4,136,F,4,5,4,64,-72,Severe
11,11,143,M,10,5,7,67,-76,Severe
17,6,210,F,109,14,1,169,-41,Severe
6,3,75,F,76,10,10,130,55,Well
18,3,219,M,27,6,7,79,-140,Severe
10,5,125,M,56,8,9,105,-20,Severe
7,11,95,F,55,8,8,104,9,Well
7,11,95,F,81,11,4,136,41,Well
17,9,213,F,26,6,6,78,-135,Severe
5,8,68,F,67,9,10,118,50,Well
16,11,203,F,36,7,2,86,-117,Severe
17,5,209,M,44,7,9,93,-116,Severe
17,8,212,F,65,9,8,116,-96,Severe
9,1,109,F,100,13,3,159,50,Well
17,6,210,M,90,12,3,147,-63,Severe
6,10,82,M,97,12,11,155,73,Well
14,0,168,F,107,13,11,167,-1,Mild
12,5,149,M,94,12,7,151,2,Good
10,1,121,M,77,10,11,131,10,Well
9,3,111,F,60,9,2,110,-1,Mild
13,10,166,M,60,9,2,110,-56,Severe
7,6,90,M,70,10,2,122,32,Well
11,8,140,M,92,12,5,149,9,Well
15,9,189,M,60,9,2,110,-79,Severe
9,9,117,F,82,11,5,137,20,Well
10,7,127,M,28,6,8,80,-47,Severe
14,9,177,M,42,7,7,91,-86,Severe
9,5,113,F,7,5,6,66,-47,Severe
16,11,203,M,6,5,5,65,-138,Severe
13,2,158,F,106,13,10,166,8,Well
15,4,184,F,101,13,4,160,-24,Severe
14,3,171,F,66,9,9,117,-54,Severe
6,7,79,F,35,7,1,85,6,Well
13,9,165,M,20,6,2,74,-91,Severe
17,5,209,F,75,10,9,129,-80,Severe
9,10,118,F,92,12,5,149,31,Well
17,3,207,M,9,5,7,67,-140,Severe
6,8,80,M,16,5,11,71,-9,Severe
10,3,123,F,35,7,1,85,-38,Severe
9,9,117,M,83,11,6,138,21,Well
15,1,181,F,30,6,9,81,-100,Severe
13,2,158,M,18,6,1,73,-85,Severe
13,8,164,F,84,11,7,139,-25,Severe
18,2,218,F,50,8,3,99,-119,Severe
16,2,194,M,47,8,0,96,-98,Severe
9,10,118,M,105,13,9,165,47,Well
16,2,194,F,76,10,10,130,-64,Severe
9,8,116,F,102,13,6,162,46,Well
5,6,66,F,3,5,3,63,-3,Mild
15,10,190,M,11,5,8,68,-122,Severe
14,5,173,F,85,11,9,141,-32,Severe
18,0,216,M,24,6,5,77,-139,Severe
13,2,158,M,103,13,6,162,4,Good
8,0,96,F,102,13,6,162,66,Well
17,11,215,F,10,5,7,67,-148,Severe
10,6,126,M,40,7,5,89,-37,Severe
9,4,112,F,95,12,9,153,41,Well
15,4,184,F,74,10,7,127,-57,Severe
12,3,147,F,50,8,3,99,-48,Severe
12,1,145,F,71,10,3,123,-22,Severe
12,2,146,M,95,12,9,153,7,Well
11,0,132,F,98,13,0,156,24,Well
11,5,137,F,107,13,11,167,30,Well
18,1,217,F,97,12,11,155,-62,Severe
16,2,194,M,110,14,3,171,-23,Severe
14,1,169,F,107,13,11,167,-2,Mild
10,10,130,F,13,5,9,69,-61,Severe
11,10,142,F,71,10,3,123,-19,Severe
6,1,73,M,109,14,1,169,96,Well
7,5,89,F,55,8,8,104,15,Well
7,7,91,M,15,5,11,71,-20,Severe
9,0,108,F,107,13,11,167,59,Well
18,5,221,F,101,13,4,160,-61,Severe
11,10,142,M,87,11,11,143,1,Good
13,2,158,M,53,8,6,102,-56,Severe
18,1,217,F,59,9,1,109,-108,Severe
15,10,190,M,36,7,2,86,-104,Severe
14,9,177,F,35,7,1,85,-92,Severe
17,4,208,M,54,8,7,103,-105,Severe
15,2,182,M,42,7,7,91,-91,Severe
13,0,156,M,108,14,0,168,12,Well
7,1,85,F,27,6,7,79,-6,Severe
7,9,93,M,36,7,2,86,-7,Severe
16,1,193,M,24,6,5,77,-116,Severe
6,1,73,M,88,12,0,144,71,Well
11,7,139,M,27,6,7,79,-60,Severe
18,3,219,F,30,6,9,81,-138,Severe
10,3,123,M,103,13,6,162,39,Well
18,10,226,F,74,10,7,127,-99,Severe
11,3,135,M,55,8,8,104,-31,Severe
16,2,194,F,9,5,7,67,-127,Severe
5,5,65,F,93,12,6,150,85,Well
13,3,159,F,39,7,5,89,-70,Severe
5,3,63,F,5,5,5,65,2,Good
17,6,210,F,107,13,11,167,-43,Severe
16,3,195,F,31,6,9,81,-114,Severe
13,3,159,F,6,5,5,65,-94,Severe
10,8,128,M,83,11,6,138,10,Well
11,5,137,F,61,9,3,111,-26,Severe
18,8,224,F,95,12,9,153,-71,Severe
13,10,166,F,54,8,7,103,-63,Severe
6,4,76,F,51,8,4,100,24,Well
10,10,130,F,45,7,10,94,-36,Severe
18,11,227,F,2,5,3,63,-164,Severe
10,5,125,M,19,6,1,73,-52,Severe
10,0,120,F,57,8,10,106,-14,Severe
15,5,185,F,94,12,7,151,-34,Severe
18,10,226,M,68,10,0,120,-106,Severe
8,0,96,M,4,5,4,64,-32,Severe
12,1,145,F,79,11,1,133,-12,Severe
18,2,218,F,47,8,0,96,-122,Severe
6,1,73,F,44,7,9,93,20,Well
13,1,157,F,48,8,1,97,-60,Severe
14,10,178,F,51,8,4,100,-78,Severe
5,11,71,M,16,5,11,71,0,Neutral
17,0,204,F,19,6,1,73,-131,Severe
10,11,131,M,55,8,8,104,-27,Severe
7,9,93,F,59,9,1,109,16,Well
16,6,198,M,63,9,6,114,-84,Severe
9,5,113,F,64,9,7,115,2,Good
5,2,62,M,67,9,10,118,56,Well
8,3,99,M,51,8,4,100,1,Good
14,9,177,F,13,5,9,69,-108,Severe
8,10,106,F,34,7,0,84,-22,Severe
18,3,219,M,96,12,10,154,-65,Severe
9,7,115,F,57,8,10,106,-9,Severe
6,8,80,M,32,6,10,82,2,Good
5,2,62,F,53,8,6,102,40,Well
14,1,169,F,86,11,10,142,-27,Severe
17,3,207,F,40,7,5,89,-118,Severe
9,1,109,F,98,13,0,156,47,Well
12,4,148,M,10,5,7,67,-81,Severe
5,10,70,M,4,5,4,64,-6,Severe
17,9,213,F,83,11,6,138,-75,Severe
6,5,77,M,19,6,1,73,-4,Mild
16,5,197,F,68,10,0,120,-77,Severe
13,8,164,F,12,5,9,69,-95,Severe
13,5,161,M,6,5,5,65,-96,Severe
14,2,170,M,37,7,3,87,-83,Severe
8,3,99,F,86,11,10,142,43,Well
10,9,129,F,59,9,1,109,-20,Severe
16,8,200,F,37,7,3,87,-113,Severe
12,3,147,M,11,5,8,68,-79,Severe
16,8,200,M,19,6,1,73,-127,Severe
12,0,144,F,42,7,7,91,-53,Severe
18,3,219,M,32,6,10,82,-137,Severe
9,4,112,M,23,6,4,76,-36,Severe
10,0,120,M,25,6,5,77,-43,Severe
11,4,136,F,35,7,1,85,-51,Severe
13,3,159,F,96,12,10,154,-5,Mild
17,2,206,M,3,5,3,63,-143,Severe
13,8,164,M,23,6,4,76,-88,Severe
14,5,173,F,98,13,0,156,-17,Severe
14,3,171,M,75,10,9,129,-42,Severe
9,6,114,F,98,13,0,156,42,Well
13,6,162,F,42,7,7,91,-71,Severe
11,1,133,F,78,11,0,132,-1,Mild
17,2,206,F,83,11,6,138,-68,Severe
5,6,66,M,104,13,7,163,97,Well
8,3,99,F,110,14,3,171,72,Well
15,2,182,M,45,7,10,94,-88,Severe
11,11,143,M,43,7,8,92,-51,Severe
5,6,66,F,51,8,4,100,34,Well
9,3,111,M,75,10,9,129,18,Well
10,0,120,M,86,11,10,142,22,Well
13,3,159,M,65,9,8,116,-43,Severe
11,6,138,F,92,12,5,149,11,Well
17,9,213,M,68,10,0,120,-93,Severe
10,2,122,F,90,12,3,147,25,Well
7,9,93,M,15,5,11,71,-22,Severe
8,3,99,M,81,11,4,136,37,Well
14,2,170,M,51,8,4,100,-70,Severe
11,3,135,M,36,7,2,86,-49,Severe
9,6,114,M,25,6,5,77,-37,Severe
17,10,214,M,74,10,7,127,-87,Severe
14,8,176,F,18,6,1,73,-103,Severe
10,1,121,M,64,9,7,115,-6,Severe
14,11,179,F,6,5,5,65,-114,Severe
13,8,164,M,47,8,0,96,-68,Severe
14,8,176,F,39,7,5,89,-87,Severe
18,5,221,F,88,12,0,144,-77,Severe
16,5,197,F,8,5,6,66,-131,Severe
6,6,78,M,60,9,2,110,32,Well
8,1,97,F,93,12,6,150,53,Well
17,10,214,F,55,8,8,104,-110,Severe
5,4,64,F,17,6,0,72,8,Well
14,1,169,F,61,9,3,111,-58,Severe
10,10,130,F,99,13,1,157,27,Well
13,8,164,M,54,8,7,103,-61,Severe
5,4,64,M,7,5,6,66,2,Good
18,9,225,F,73,10,6,126,-99,Severe
10,10,130,M,7,5,6,66,-64,Severe
7,11,95,M,34,7,0,84,-11,Severe
9,8,116,F,109,14,1,169,53,Well
11,5,137,F,101,13,4,160,23,Well
6,6,78,F,19,6,1,73,-5,Mild
18,7,223,M,97,12,11,155,-68,Severe
10,1,121,F,29,6,8,80,-41,Severe
11,7,139,F,8,5,6,66,-73,Severe
17,11,215,M,3,5,3,63,-152,Severe
15,3,183,M,66,9,9,117,-66,Severe
8,10,106,F,63,9,6,114,8,Well
18,0,216,M,34,7,0,84,-132,Severe
13,1,157,M,81,11,4,136,-21,Severe
5,1,61,M,60,9,2,110,49,Well
11,3,135,F,105,13,9,165,30,Well
8,0,96,M,52,8,5,101,5,Good
11,3,135,M,67,9,10,118,-17,Severe
17,0,204,M,3,5,3,63,-141,Severe
13,1,157,M,7,5,6,66,-91,Severe
17,7,211,F,12,5,9,69,-142,Severe
5,8,68,F,77,10,11,131,63,Well
16,3,195,F,63,9,6,114,-81,Severe
5,7,67,M,103,13,6,162,95,Well
6,9,81,F,93,12,6,150,69,Well
10,9,129,M,93,12,6,150,21,Well
16,3,195,M,60,9,2,110,-85,Severe
18,9,225,F,47,8,0,96,-129,Severe
16,10,202,F,6,5,5,65,-137,Severe
6,3,75,F,96,12,10,154,79,Well
10,10,130,M,49,8,2,98,-32,Severe
15,4,184,F,3,5,3,63,-121,Severe
16,6,198,F,10,5,7,67,-131,Severe
10,11,131,F,53,8,6,102,-29,Severe
18,8,224,F,49,8,2,98,-126,Severe
14,6,174,F,99,13,1,157,-17,Severe
10,8,128,M,14,5,10,70,-58,Severe
8,1,97,M,34,7,0,84,-13,Severe
11,3,135,M,59,9,1,109,-26,Severe
14,10,178,M,104,13,7,163,-15,Severe
12,3,147,M,36,7,2,86,-61,Severe
14,4,172,M,71,10,3,123,-49,Severe
9,0,108,M,34,7,0,84,-24,Severe
9,11,119,F,69,10,1,121,2,Good
11,2,134,M,93,12,6,150,16,Well
13,3,159,M,42,7,7,91,-68,Severe
17,9,213,F,44,7,9,93,-120,Severe
12,1,145,F,100,13,3,159,14,Well
18,9,225,M,87,11,11,143,-82,Severe
10,10,130,M,32,6,10,82,-48,Severe
8,3,99,M,51,8,4,100,1,Good
5,8,68,F,55,8,8,104,36,Well
5,1,61,F,50,8,3,99,38,Well
13,4,160,M,67,9,10,118,-42,Severe
12,3,147,M,68,10,0,120,-27,Severe
17,6,210,M,93,12,6,150,-60,Severe
17,11,215,M,56,8,9,105,-110,Severe
13,0,156,F,28,6,8,80,-76,Severe
10,4,124,F,92,12,5,149,25,Well
16,9,201,F,49,8,2,98,-103,Severe
15,0,180,M,103,13,6,162,-18,Severe
17,0,204,F,89,12,1,145,-59,Severe
8,8,104,F,31,6,9,81,-23,Severe
15,6,186,M,22,6,3,75,-111,Severe
16,11,203,M,108,14,0,168,-35,Severe
8,4,100,M,68,10,0,120,20,Well
6,0,72,M,45,7,10,94,22,Well
16,3,195,F,13,5,9,69,-126,Severe
15,0,180,M,35,7,1,85,-95,Severe
14,10,178,F,56,8,9,105,-73,Severe
17,6,210,M,39,7,5,89,-121,Severe
11,7,139,F,29,6,8,80,-59,Severe
10,3,123,F,46,7,11,95,-28,Severe
8,2,98,F,40,7,5,89,-9,Severe
18,9,225,M,25,6,5,77,-148,Severe
17,6,210,F,65,9,8,116,-94,Severe
18,3,219,F,27,6,7,79,-140,Severe
7,6,90,M,12,5,9,69,-21,Severe
16,7,199,F,72,10,4,124,-75,Severe
14,6,174,M,23,6,4,76,-98,Severe
12,9,153,M,36,7,2,86,-67,Severe
6,3,75,M,40,7,5,89,14,Well
18,11,227,F,70,10,2,122,-105,Severe
14,10,178,F,49,8,2,98,-80,Severe
11,11,143,F,9,5,7,67,-76,Severe
18,11,227,F,11,5,8,68,-159,Severe
8,5,101,F,90,12,3,147,46,Well
9,0,108,F,30,6,9,81,-27,Severe
10,3,123,M,4,5,4,64,-59,Severe
10,4,124,M,66,9,9,117,-7,Severe
14,4,172,F,20,6,2,74,-98,Severe
9,11,119,F,89,12,1,145,26,Well
7,9,93,M,102,13,6,162,69,Well
18,2,218,M,32,6,10,82,-136,Severe
9,3,111,M,63,9,6,114,3,Good
9,1,109,F,42,7,7,91,-18,Severe
14,3,171,M,94,12,7,151,-20,Severe
13,9,165,M,61,9,3,111,-54,Severe
15,5,185,M,100,13,3,159,-26,Severe
7,3,87,M,100,13,3,159,72,Well
10,7,127,M,59,9,1,109,-18,Severe
10,11,131,M,83,11,6,138,7,Well
7,1,85,M,39,7,5,89,4,Good
6,3,75,M,32,6,10,82,7,Well
18,9,225,F,48,8,1,97,-128,Severe
7,0,84,M,76,10,10,130,46,Well
12,9,153,F,63,9,6,114,-39,Severe
8,8,104,M,37,7,3,87,-17,Severe
11,6,138,M,16,5,11,71,-67,Severe
16,10,202,M,98,13,0,156,-46,Severe
10,9,129,M,50,8,3,99,-30,Severe
10,0,120,F,103,13,6,162,42,Well
15,5,185,M,69,10,1,121,-64,Severe
5,10,70,F,19,6,1,73,3,Good
15,6,186,F,32,6,10,82,-104,Severe
14,7,175,F,28,6,8,80,-95,Severe
13,1,157,M,98,13,0,156,-1,Mild
18,11,227,M,10,5,7,67,-160,Severe
16,10,202,M,101,13,4,160,-42,Severe
9,7,115,F,94,12,7,151,36,Well
11,1,133,M,42,7,7,91,-42,Severe
18,6,222,M,74,10,7,127,-95,Severe
16,7,199,M,58,9,0,108,-91,Severe
12,10,154,F,41,7,6,90,-64,Severe
10,2,122,F,8,5,6,66,-56,Severe
10,0,120,F,105,13,9,165,45,Well
11,2,134,M,78,11,0,132,-2,Mild
9,1,109,F,103,13,6,162,53,Well
9,5,113,F,65,9,8,116,3,Good
13,0,156,M,82,11,5,137,-19,Severe
8,4,100,F,36,7,2,86,-14,Severe
12,3,147,M,55,8,8,104,-43,Severe
13,4,160,M,77,10,11,131,-29,Severe
7,3,87,F,72,10,4,124,37,Well
11,7,139,F,42,7,7,91,-48,Severe
6,11,83,M,70,10,2,122,39,Well
17,4,208,F,108,14,0,168,-40,Severe
12,11,155,M,42,7,7,91,-64,Severe
17,2,206,M,65,9,8,116,-90,Severe
7,9,93,M,87,11,11,143,50,Well
5,3,63,F,68,10,0,120,57,Well
5,7,67,F,29,6,8,80,13,Well
16,9,201,M,91,12,4,148,-53,Severe
9,3,111,F,79,11,1,133,22,Well
18,7,223,M,54,8,7,103,-120,Severe
8,0,96,M,102,13,6,162,66,Well
14,6,174,M,24,6,5,77,-97,Severe
17,4,208,M,61,9,3,111,-97,Severe
8,5,101,M,6,5,5,65,-36,Severe
9,3,111,F,109,14,1,169,58,Well
5,11,71,M,44,7,9,93,22,Well
11,3,135,M,53,8,6,102,-33,Severe
13,8,164,M,4,5,4,64,-100,Severe
7,7,91,M,20,6,2,74,-17,Severe
17,4,208,F,83,11,6,138,-70,Severe
14,10,178,F,14,5,10,70,-108,Severe
14,4,172,F,22,6,3,75,-97,Severe
6,3,75,F,94,12,7,151,76,Well
5,7,67,F,38,7,4,88,21,Well
10,10,130,M,33,6,11,83,-47,Severe
9,10,118,F,68,10,0,120,2,Good
9,5,113,F,108,14,0,168,55,Well
12,4,148,M,67,9,10,118,-30,Severe
5,1,61,M,72,10,4,124,63,Well
8,9,105,F,53,8,6,102,-3,Mild
17,8,212,M,4,5,4,64,-148,Severe
13,0,156,F,36,7,2,86,-70,Severe
17,3,207,F,90,12,3,147,-60,Severe
16,10,202,M,55,8,8,104,-98,Severe
7,9,93,F,49,8,2,98,5,Good
15,1,181,M,34,7,0,84,-97,Severe
11,6,138,M,19,6,1,73,-65,Severe
6,5,77,F,2,5,3,63,-14,Severe
13,3,159,M,48,8,1,97,-62,Severe
10,0,120,F,77,10,11,131,11,Well
15,7,187,M,102,13,6,162,-25,Severe
18,7,223,F,36,7,2,86,-137,Severe
13,4,160,M,14,5,10,70,-90,Severe
11,8,140,F,88,12,0,144,4,Good
11,8,140,F,18,6,1,73,-67,Severe
16,3,195,M,40,7,5,89,-106,Severe
7,6,90,F,65,9,8,116,26,Well
9,9,117,M,101,13,4,160,43,Well
6,11,83,F,103,13,6,162,79,Well
14,4,172,M,60,9,2,110,-62,Severe
12,6,150,F,49,8,2,98,-52,Severe
17,2,206,M,43,7,8,92,-114,Severe
14,2,170,F,3,5,3,63,-107,Severe
16,3,195,F,102,13,6,162,-33,Severe
18,6,222,F,48,8,1,97,-125,Severe
13,2,158,M,99,13,1,157,-1,Mild
17,9,213,M,36,7,2,86,-127,Severe
13,6,162,F,88,12,0,144,-18,Severe
6,10,82,M,89,12,1,145,63,Well
5,11,71,M,82,11,5,137,66,Well
14,8,176,F,64,9,7,115,-61,Severe
6,11,83,M,86,11,10,142,59,Well
18,7,223,M,106,13,10,166,-57,Severe
14,5,173,M,101,13,4,160,-13,Severe
18,2,218,F,25,6,5,77,-141,Severe
9,3,111,M,31,6,9,81,-30,Severe
16,11,203,M,86,11,10,142,-61,Severe
16,10,202,F,110,14,3,171,-31,Severe
11,4,136,F,19,6,1,73,-63,Severe
5,11,71,F,51,8,4,100,29,Well
6,10,82,M,64,9,7,115,33,Well
5,5,65,M,104,13,7,163,98,Well
16,4,196,M,91,12,4,148,-48,Severe
12,5,149,F,35,7,1,85,-64,Severe
5,2,62,M,82,11,5,137,75,Well
9,10,118,F,36,7,2,86,-32,Severe
8,8,104,M,23,6,4,76,-28,Severe
12,1,145,M,12,5,9,69,-76,Severe
7,6,90,M,8,5,6,66,-24,Severe
9,11,119,F,106,13,10,166,47,Well
6,11,83,M,2,5,3,63,-20,Severe
8,5,101,F,63,9,6,114,13,Well
9,1,109,M,90,12,3,147,38,Well
12,4,148,M,69,10,1,121,-27,Severe
6,5,77,F,72,10,4,124,47,Well
12,3,147,F,87,11,11,143,-4,Mild
15,6,186,M,89,12,1,145,-41,Severe
7,9,93,F,23,6,4,76,-17,Severe
8,1,97,M,75,10,9,129,32,Well
5,3,63,F,46,7,11,95,32,Well
17,4,208,M,12,5,9,69,-139,Severe
11,10,142,M,71,10,3,123,-19,Severe
14,11,179,F,67,9,10,118,-61,Severe
5,2,62,F,68,10,0,120,58,Well
11,6,138,F,63,9,6,114,-24,Severe
18,8,224,M,109,14,1,169,-55,Severe
5,2,62,M,18,6,1,73,11,Well
8,8,104,F,108,14,0,168,64,Well
15,3,183,F,56,8,9,105,-78,Severe
10,4,124,F,30,6,9,81,-43,Severe
9,7,115,F,32,6,10,82,-33,Severe
6,0,72,M,46,7,11,95,23,Well
14,6,174,F,64,9,7,115,-59,Severe
16,9,201,M,102,13,6,162,-39,Severe
16,9,201,F,64,9,7,115,-86,Severe
5,0,60,M,63,9,6,114,54,Well
12,10,154,F,35,7,1,85,-69,Severe
6,1,73,M,78,11,0,132,59,Well
12,9,153,F,96,12,10,154,1,Good
5,7,67,M,34,7,0,84,17,Well
12,4,148,M,75,10,9,129,-19,Severe
10,0,120,M,102,13,6,162,42,Well
7,5,89,F,72,10,4,124,35,Well
12,0,144,F,6,5,5,65,-79,Severe
6,0,72,F,33,6,11,83,11,Well
15,5,185,M,62,9,4,112,-73,Severe
18,2,218,F,39,7,5,89,-129,Severe
9,10,118,F,86,11,10,142,24,Well
11,10,142,F,72,10,4,124,-18,Severe
5,1,61,F,81,11,4,136,75,Well
6,7,79,M,91,12,4,148,69,Well
8,7,103,M,9,5,7,67,-36,Severe
14,5,173,F,109,14,1,169,-4,Mild
7,1,85,M,26,6,6,78,-7,Severe
9,2,110,M,24,6,5,77,-33,Severe
10,5,125,M,47,8,0,96,-29,Severe
6,3,75,M,101,13,4,160,85,Well
18,10,226,F,76,10,10,130,-96,Severe
17,10,214,M,99,13,1,157,-57,Severe
7,5,89,F,106,13,10,166,77,Well
10,7,127,F,26,6,6,78,-49,Severe
5,5,65,M,101,13,4,160,95,Well
15,4,184,F,19,6,1,73,-111,Severe
15,10,190,F,34,7,0,84,-106,Severe
6,7,79,F,20,6,2,74,-5,Mild
10,3,123,M,56,8,9,105,-18,Severe
11,1,133,M,23,6,4,76,-57,Severe
16,3,195,M,66,9,9,117,-78,Severe
15,9,189,M,103,13,6,162,-27,Severe
10,9,129,F,32,6,10,82,-47,Severe
7,0,84,M,102,13,6,162,78,Well
9,2,110,F,45,7,10,94,-16,Severe
16,4,196,F,11,5,8,68,-128,Severe
7,3,87,F,15,5,11,71,-16,Severe
8,1,97,M,33,6,11,83,-14,Severe
10,7,127,M,43,7,8,92,-35,Severe
13,0,156,M,99,13,1,157,1,Good
7,7,91,M,58,9,0,108,17,Well
6,10,82,M,19,6,1,73,-9,Severe
17,0,204,F,40,7,5,89,-115,Severe
10,6,126,M,90,12,3,147,21,Well
6,6,78,F,25,6,5,77,-1,Mild
9,7,115,F,101,13,4,160,45,Well
5,4,64,F,40,7,5,89,25,Well
6,3,75,M,38,7,4,88,13,Well
10,10,130,F,22,6,3,75,-55,Severe
8,9,105,M,63,9,6,114,9,Well
5,3,63,M,108,14,0,168,105,Well
6,9,81,F,53,8,6,102,21,Well
11,3,135,M,20,6,2,74,-61,Severe
6,8,80,F,4,5,4,64,-16,Severe
5,9,69,M,77,10,11,131,62,Well
9,1,109,F,8,5,6,66,-43,Severe
16,1,193,M,98,13,0,156,-37,Severe
16,5,197,M,84,11,7,139,-58,Severe
6,6,78,M,31,6,9,81,3,Good
11,7,139,F,78,11,0,132,-7,Severe
17,1,205,F,77,10,11,131,-74,Severe
6,7,79,F,41,7,6,90,11,Well
12,6,150,F,18,6,1,73,-77,Severe
12,9,153,M,46,7,11,95,-58,Severe
16,0,192,F,85,11,9,141,-51,Severe
18,0,216,F,70,10,2,122,-94,Severe
5,7,67,F,70,10,2,122,55,Well
18,3,219,M,5,5,5,65,-154,Severe
13,11,167,M,63,9,6,114,-53,Severe
11,1,133,M,58,9,0,108,-25,Severe
16,9,201,M,34,7,0,84,-117,Severe
11,0,132,M,9,5,7,67,-65,Severe
7,7,91,M,24,6,5,77,-14,Severe
17,9,213,F,19,6,1,73,-140,Severe
18,7,223,F,102,13,6,162,-61,Severe
18,11,227,F,74,10,7,127,-100,Severe
5,6,66,M,53,8,6,102,36,Well
5,2,62,M,98,13,0,156,94,Well
13,6,162,M,18,6,1,73,-89,Severe
5,8,68,F,106,13,10,166,98,Well
12,6,150,F,97,12,11,155,5,Good
5,3,63,M,83,11,6,138,75,Well
6,3,75,M,52,8,5,101,26,Well
11,5,137,M,62,9,4,112,-25,Severe
15,11,191,M,70,10,2,122,-69,Severe
10,1,121,M,14,5,10,70,-51,Severe
18,11,227,M,42,7,7,91,-136,Severe
17,8,212,F,19,6,1,73,-139,Severe
11,6,138,F,25,6,5,77,-61,Severe
14,5,173,F,56,8,9,105,-68,Severe
17,3,207,M,73,10,6,126,-81,Severe
12,6,150,F,99,13,1,157,7,Well
13,3,159,F,62,9,4,112,-47,Severe
5,8,68,F,46,7,11,95,27,Well
15,5,185,F,13,5,9,69,-116,Severe
14,9,177,M,62,9,4,112,-65,Severe
7,6,90,M,86,11,10,142,52,Well
11,3,135,M,9,5,7,67,-68,Severe
7,2,86,F,59,9,1,109,23,Well
18,0,216,F,33,6,11,83,-133,Severe
12,11,155,F,18,6,1,73,-82,Severe
7,0,84,F,57,8,10,106,22,Well
14,11,179,M,17,6,0,72,-107,Severe
5,0,60,F,40,7,5,89,29,Well
10,3,123,F,92,12,5,149,26,Well
6,9,81,M,108,14,0,168,87,Well
10,7,127,F,76,10,10,130,3,Good
17,4,208,M,10,5,7,67,-141,Severe
10,5,125,F,9,5,7,67,-58,Severe
12,8,152,F,74,10,7,127,-25,Severe
17,4,208,F,16,5,11,71,-137,Severe
10,2,122,M,70,10,2,122,0,Neutral
10,0,120,M,101,13,4,160,40,Well
9,7,115,F,46,7,11,95,-20,Severe
14,3,171,F,24,6,5,77,-94,Severe
13,0,156,M,23,6,4,76,-80,Severe
16,6,198,M,109,14,1,169,-29,Severe
11,3,135,M,101,13,4,160,25,Well
13,1,157,F,91,12,4,148,-9,Severe
15,1,181,M,17,6,0,72,-109,Severe
7,4,88,F,108,14,0,168,80,Well
10,8,128,F,29,6,8,80,-48,Severe
5,0,60,F,73,10,6,126,66,Well
7,6,90,F,28,6,8,80,-10,Severe
11,2,134,M,99,13,1,157,23,Well
12,10,154,M,108,14,0,168,14,Well
17,11,215,F,56,8,9,105,-110,Severe
17,2,206,F,98,13,0,156,-50,Severe
5,5,65,M,54,8,7,103,38,Well
8,9,105,F,37,7,3,87,-18,Severe
5,11,71,M,74,10,7,127,56,Well
6,11,83,F,105,13,9,165,82,Well
15,3,183,F,55,8,8,104,-79,Severe
17,3,207,F,25,6,5,77,-130,Severe
10,7,127,M,15,5,11,71,-56,Severe
16,0,192,M,51,8,4,100,-92,Severe
16,3,195,M,75,10,9,129,-66,Severe
15,7,187,M,73,10,6,126,-61,Severe
7,6,90,M,54,8,7,103,13,Well
18,3,219,M,14,5,10,70,-149,Severe
8,4,100,M,46,7,11,95,-5,Mild
18,5,221,M,53,8,6,102,-119,Severe
7,10,94,F,83,11,6,138,44,Well
15,6,186,M,55,8,8,104,-82,Severe
14,7,175,F,86,11,10,142,-33,Severe
10,2,122,F,13,5,9,69,-53,Severe
8,1,97,F,50,8,3,99,2,Good
9,0,108,F,37,7,3,87,-21,Severe
9,0,108,F,29,6,8,80,-28,Severe
10,8,128,F,60,9,2,110,-18,Severe
18,0,216,F,16,5,11,71,-145,Severe
12,0,144,F,12,5,9,69,-75,Severe
18,5,221,F,21,6,2,74,-147,Severe
9,5,113,F,110,14,3,171,58,Well
11,6,138,F,74,10,7,127,-11,Severe
7,8,92,F,48,8,1,97,5,Good
13,2,158,M,104,13,7,163,5,Good
12,6,150,M,11,5,8,68,-82,Severe
6,4,76,F,50,8,3,99,23,Well
6,0,72,F,106,13,10,166,94,Well
7,2,86,M,23,6,4,76,-10,Severe
10,2,122,F,96,12,10,154,32,Well
16,7,199,F,44,7,9,93,-106,Severe
5,7,67,F,26,6,6,78,11,Well
11,3,135,F,39,7,5,89,-46,Severe
10,10,130,F,3,5,3,63,-67,Severe
13,10,166,F,42,7,7,91,-75,Severe
6,7,79,F,78,11,0,132,53,Well
18,3,219,M,55,8,8,104,-115,Severe
9,6,114,M,65,9,8,116,2,Good
13,6,162,M,20,6,2,74,-88,Severe
12,0,144,M,12,5,9,69,-75,Severe
8,4,100,F,16,5,11,71,-29,Severe
10,4,124,F,75,10,9,129,5,Good
12,11,155,M,49,8,2,98,-57,Severe
8,4,100,F,10,5,7,67,-33,Severe
17,3,207,F,67,9,10,118,-89,Severe
18,7,223,F,94,12,7,151,-72,Severe
18,9,225,M,108,14,0,168,-57,Severe
10,2,122,M,43,7,8,92,-30,Severe
10,0,120,F,53,8,6,102,-18,Severe
14,9,177,F,33,6,11,83,-94,Severe
14,2,170,F,103,13,6,162,-8,Severe
14,9,177,F,86,11,10,142,-35,Severe
13,1,157,F,19,6,1,73,-84,Severe
6,2,74,F,65,9,8,116,42,Well
16,6,198,M,80,11,3,135,-63,Severe
16,3,195,M,43,7,8,92,-103,Severe
6,5,77,F,35,7,1,85,8,Well
14,10,178,F,37,7,3,87,-91,Severe
11,9,141,F,89,12,1,145,4,Good
6,7,79,M,54,8,7,103,24,Well
5,3,63,M,58,9,0,108,45,Well
12,11,155,F,2,5,3,63,-92,Severe
5,2,62,F,35,7,1,85,23,Well
17,11,215,F,34,7,0,84,-131,Severe
13,3,159,F,8,5,6,66,-93,Severe
5,1,61,M,108,14,0,168,107,Well
11,3,135,F,28,6,8,80,-55,Severe
7,3,87,F,94,12,7,151,64,Well
18,3,219,F,100,13,3,159,-60,Severe
17,6,210,F,43,7,8,92,-118,Severe
12,10,154,F,19,6,1,73,-81,Severe
8,4,100,M,40,7,5,89,-11,Severe
13,2,158,F,51,8,4,100,-58,Severe
7,9,93,M,57,8,10,106,13,Well
5,9,69,M,19,6,1,73,4,Good
14,6,174,M,29,6,8,80,-94,Severe
14,7,175,M,6,5,5,65,-110,Severe
14,11,179,F,94,12,7,151,-28,Severe
18,5,221,M,33,6,11,83,-138,Severe
15,3,183,F,26,6,6,78,-105,Severe
17,4,208,F,53,8,6,102,-106,Severe
12,2,146,F,32,6,10,82,-64,Severe
12,9,153,M,9,5,7,67,-86,Severe
16,5,197,F,70,10,2,122,-75,Severe
5,8,68,M,48,8,1,97,29,Well
11,11,143,F,74,10,7,127,-16,Severe
15,1,181,M,22,6,3,75,-106,Severe
13,8,164,M,41,7,6,90,-74,Severe
18,5,221,M,109,14,1,169,-52,Severe
5,1,61,F,79,11,1,133,72,Well
9,4,112,M,19,6,1,73,-39,Severe
8,8,104,F,45,7,10,94,-10,Severe
9,7,115,F,52,8,5,101,-14,Severe
10,3,123,F,59,9,1,109,-14,Severe
11,9,141,F,30,6,9,81,-60,Severe
12,4,148,F,90,12,3,147,-1,Mild
11,11,143,F,78,11,0,132,-11,Severe
14,1,169,F,4,5,4,64,-105,Severe
8,3,99,F,93,12,6,150,51,Well
8,5,101,M,96,12,10,154,53,Well
7,4,88,F,82,11,5,137,49,Well
18,8,224,M,85,11,9,141,-83,Severe
15,8,188,M,33,6,11,83,-105,Severe
10,1,121,F,48,8,1,97,-24,Severe
9,3,111,M,93,12,6,150,39,Well
9,3,111,M,65,9,8,116,5,Good
13,5,161,F,12,5,9,69,-92,Severe
15,1,181,F,69,10,1,121,-60,Severe
14,5,173,F,88,12,0,144,-29,Severe
18,6,222,M,66,9,9,117,-105,Severe
11,1,133,M,16,5,11,71,-62,Severe
15,3,183,F,11,5,8,68,-115,Severe
13,7,163,F,19,6,1,73,-90,Severe
9,2,110,F,56,8,9,105,-5,Mild
17,0,204,F,44,7,9,93,-111,Severe
13,5,161,F,25,6,5,77,-84,Severe
5,0,60,M,105,13,9,165,105,Well
14,3,171,F,25,6,5,77,-94,Severe
16,6,198,M,110,14,3,171,-27,Severe
11,6,138,M,10,5,7,67,-71,Severe
11,11,143,F,37,7,3,87,-56,Severe
7,7,91,M,51,8,4,100,9,Well
8,7,103,M,109,14,1,169,66,Well
16,9,201,M,80,11,3,135,-66,Severe
15,0,180,M,13,5,9,69,-111,Severe
12,8,152,F,70,10,2,122,-30,Severe
11,11,143,M,22,6,3,75,-68,Severe
18,4,220,M,84,11,7,139,-81,Severe
12,8,152,M,21,6,2,74,-78,Severe
14,0,168,M,62,9,4,112,-56,Severe
9,1,109,F,35,7,1,85,-24,Severe
17,6,210,M,68,10,0,120,-90,Severe
7,4,88,F,110,14,3,171,83,Well
15,3,183,F,94,12,7,151,-32,Severe
7,1,85,M,105,13,9,165,80,Well
5,10,70,M,13,5,9,69,-1,Mild
5,10,70,F,47,8,0,96,26,Well
7,3,87,F,108,14,0,168,81,Well
9,3,111,F,46,7,11,95,-16,Severe
18,5,221,F,90,12,3,147,-74,Severe
15,5,185,F,83,11,6,138,-47,Severe
13,6,162,M,81,11,4,136,-26,Severe
12,7,151,F,66,9,9,117,-34,Severe
7,10,94,F,6,5,5,65,-29,Severe
8,7,103,F,97,12,11,155,52,Well
8,3,99,F,42,7,7,91,-8,Severe
5,7,67,M,102,13,6,162,95,Well
6,7,79,F,59,9,1,109,30,Well
7,2,86,M,94,12,7,151,65,Well
16,11,203,M,26,6,6,78,-125,Severe
7,9,93,M,4,5,4,64,-29,Severe
13,5,161,M,94,12,7,151,-10,Severe
6,1,73,M,23,6,4,76,3,Good
14,7,175,M,2,5,3,63,-112,Severe
12,7,151,M,38,7,4,88,-63,Severe
8,3,99,M,24,6,5,77,-22,Severe
7,1,85,M,60,9,2,110,25,Well
13,6,162,M,51,8,4,100,-62,Severe
13,2,158,M,23,6,4,76,-82,Severe
9,0,108,M,58,9,0,108,0,Neutral
11,0,132,M,57,8,10,106,-26,Severe
14,11,179,M,15,5,11,71,-108,Severe
17,5,209,M,37,7,3,87,-122,Severe
17,1,205,M,7,5,6,66,-139,Severe
12,3,147,F,107,13,11,167,20,Well
11,8,140,M,78,11,0,132,-8,Severe
18,11,227,M,14,5,10,70,-157,Severe
11,5,137,F,97,12,11,155,18,Well
15,3,183,F,75,10,9,129,-54,Severe
10,11,131,F,30,6,9,81,-50,Severe
9,9,117,M,16,5,11,71,-46,Severe
10,7,127,M,23,6,4,76,-51,Severe
18,7,223,M,38,7,4,88,-135,Severe
15,10,190,M,106,13,10,166,-24,Severe
18,9,225,M,24,6,5,77,-148,Severe
17,1,205,F,81,11,4,136,-69,Severe
16,11,203,F,39,7,5,89,-114,Severe
17,0,204,F,97,12,11,155,-49,Severe
16,10,202,M,31,6,9,81,-121,Severe
18,3,219,F,83,11,6,138,-81,Severe
18,7,223,M,36,7,2,86,-137,Severe
17,3,207,F,38,7,4,88,-119,Severe
12,0,144,M,18,6,1,73,-71,Severe
15,11,191,F,88,12,0,144,-47,Severe
15,7,187,F,92,12,5,149,-38,Severe
13,9,165,M,72,10,4,124,-41,Severe
7,1,85,F,109,14,1,169,84,Well
18,9,225,F,108,14,0,168,-57,Severe
6,9,81,M,37,7,3,87,6,Well
12,11,155,F,45,7,10,94,-61,Severe
16,10,202,F,31,6,9,81,-121,Severe
5,10,70,F,56,8,9,105,35,Well
15,5,185,M,30,6,9,81,-104,Severe
12,6,150,M,7,5,6,66,-84,Severe
12,7,151,M,10,5,7,67,-84,Severe
7,11,95,F,104,13,7,163,68,Well
5,1,61,M,19,6,1,73,12,Well
15,0,180,F,62,9,4,112,-68,Severe
12,8,152,M,86,11,10,142,-10,Severe
11,3,135,F,23,6,4,76,-59,Severe
14,6,174,F,87,11,11,143,-31,Severe
17,8,212,M,34,7,0,84,-128,Severe
13,3,159,M,15,5,11,71,-88,Severe
17,11,215,M,13,5,9,69,-146,Severe
11,3,135,M,56,8,9,105,-30,Severe
8,5,101,F,21,6,2,74,-27,Severe
6,6,78,F,80,11,3,135,57,Well
8,11,107,M,91,12,4,148,41,Well
17,2,206,M,56,8,9,105,-101,Severe
15,4,184,F,4,5,4,64,-120,Severe
15,0,180,F,40,7,5,89,-91,Severe
12,3,147,M,96,12,10,154,7,Well
18,0,216,F,50,8,3,99,-117,Severe
5,8,68,F,41,7,6,90,22,Well
9,11,119,F,51,8,4,100,-19,Severe
18,11,227,F,35,7,1,85,-142,Severe
17,5,209,M,79,11,1,133,-76,Severe
11,0,132,F,71,10,3,123,-9,Severe
9,3,111,F,101,13,4,160,49,Well
17,1,205,M,38,7,4,88,-117,Severe
6,2,74,F,11,5,8,68,-6,Severe
13,0,156,F,79,11,1,133,-23,Severe
7,5,89,M,26,6,6,78,-11,Severe
15,3,183,F,43,7,8,92,-91,Severe
12,4,148,M,72,10,4,124,-24,Severe
10,10,130,M,98,13,0,156,26,Well
11,7,139,M,24,6,5,77,-62,Severe
16,10,202,F,85,11,9,141,-61,Severe
6,6,78,F,21,6,2,74,-4,Mild
16,10,202,M,49,8,2,98,-104,Severe
17,3,207,F,31,6,9,81,-126,Severe
18,8,224,M,6,5,5,65,-159,Severe
6,6,78,M,35,7,1,85,7,Well
11,5,137,M,43,7,8,92,-45,Severe
12,2,146,M,99,13,1,157,11,Well
9,7,115,F,60,9,2,110,-5,Mild
8,7,103,F,68,10,0,120,17,Well
13,5,161,F,27,6,7,79,-82,Severe
10,4,124,M,23,6,4,76,-48,Severe
15,11,191,F,39,7,5,89,-102,Severe
5,3,63,M,82,11,5,137,74,Well
10,3,123,F,44,7,9,93,-30,Severe
18,3,219,F,13,5,9,69,-150,Severe
13,6,162,M,27,6,7,79,-83,Severe
18,9,225,F,8,5,6,66,-159,Severe
6,10,82,M,17,6,0,72,-10,Severe
12,10,154,M,18,6,1,73,-81,Severe
12,9,153,M,81,11,4,136,-17,Severe
8,2,98,M,86,11,10,142,44,Well
9,7,115,F,39,7,5,89,-26,Severe
8,9,105,F,102,13,6,162,57,Well
6,6,78,M,75,10,9,129,51,Well
12,0,144,M,44,7,9,93,-51,Severe
9,8,116,F,89,12,1,145,29,Well
15,7,187,M,37,7,3,87,-100,Severe
17,2,206,F,57,8,10,106,-100,Severe
10,10,130,F,66,9,9,117,-13,Severe
18,4,220,F,29,6,8,80,-140,Severe
14,3,171,M,94,12,7,151,-20,Severe
9,0,108,M,78,11,0,132,24,Well
10,3,123,M,19,6,1,73,-50,Severe
10,8,128,F,95,12,9,153,25,Well
13,5,161,M,31,6,9,81,-80,Severe
7,9,93,M,37,7,3,87,-6,Severe
9,0,108,F,43,7,8,92,-16,Severe
14,1,169,M,65,9,8,116,-53,Severe
18,8,224,M,37,7,3,87,-137,Severe
16,2,194,F,104,13,7,163,-31,Severe
10,3,123,F,49,8,2,98,-25,Severe
16,5,197,M,14,5,10,70,-127,Severe
16,9,201,F,91,12,4,148,-53,Severe
14,1,169,M,36,7,2,86,-83,Severe
14,3,171,M,4,5,4,64,-107,Severe
9,11,119,M,92,12,5,149,30,Well
7,3,87,M,71,10,3,123,36,Well
18,8,224,M,72,10,4,124,-100,Severe
18,5,221,F,3,5,3,63,-158,Severe
6,6,78,M,106,13,10,166,88,Well
7,8,92,M,75,10,9,129,37,Well
18,3,219,M,31,6,9,81,-138,Severe
17,3,207,F,82,11,5,137,-70,Severe
11,5,137,F,19,6,1,73,-64,Severe
11,2,134,M,18,6,1,73,-61,Severe
11,1,133,F,76,10,10,130,-3,Mild
6,6,78,F,53,8,6,102,24,Well
13,5,161,F,77,10,11,131,-30,Severe
5,7,67,F,103,13,6,162,95,Well
8,1,97,M,8,5,6,66,-31,Severe
11,9,141,M,80,11,3,135,-6,Severe
17,4,208,F,31,6,9,81,-127,Severe
7,1,85,F,18,6,1,73,-12,Severe
13,4,160,F,76,10,10,130,-30,Severe
14,3,171,F,110,14,3,171,0,Neutral
14,4,172,M,4,5,4,64,-108,Severe
18,2,218,M,81,11,4,136,-82,Severe
9,0,108,F,67,9,10,118,10,Well
8,0,96,F,32,6,10,82,-14,Severe
8,6,102,F,56,8,9,105,3,Good
16,7,199,F,20,6,2,74,-125,Severe
16,7,199,F,74,10,7,127,-72,Severe
7,7,91,F,35,7,1,85,-6,Severe
7,1,85,M,16,5,11,71,-14,Severe
15,1,181,F,104,13,7,163,-18,Severe
13,6,162,M,29,6,8,80,-82,Severe
9,4,112,F,106,13,10,166,54,Well
8,8,104,M,54,8,7,103,-1,Mild
12,2,146,F,87,11,11,143,-3,Mild
10,1,121,M,52,8,5,101,-20,Severe
14,4,172,F,103,13,6,162,-10,Severe
10,9,129,F,24,6,5,77,-52,Severe
17,1,205,F,50,8,3,99,-106,Severe
18,10,226,F,106,13,10,166,-60,Severe
17,11,215,F,65,9,8,116,-99,Severe
16,6,198,M,56,8,9,105,-93,Severe
15,7,187,M,2,5,3,63,-124,Severe
16,0,192,F,49,8,2,98,-94,Severe
6,4,76,M,94,12,7,151,75,Well
6,3,75,M,92,12,5,149,74,Well
15,3,183,F,60,9,2,110,-73,Severe
6,5,77,M,92,12,5,149,72,Well
15,11,191,M,28,6,8,80,-111,Severe
14,9,177,F,2,5,3,63,-114,Severe
14,11,179,M,74,10,7,127,-52,Severe
12,3,147,F,88,12,0,144,-3,Mild
9,4,112,M,34,7,0,84,-28,Severe
7,9,93,M,18,6,1,73,-20,Severe
5,8,68,M,29,6,8,80,12,Well
7,3,87,M,8,5,6,66,-21,Severe
14,10,178,M,32,6,10,82,-96,Severe
5,6,66,M,3,5,3,63,-3,Mild
17,4,208,M,48,8,1,97,-111,Severe
13,3,159,M,105,13,9,165,6,Well
9,3,111,M,94,12,7,151,40,Well
5,0,60,M,12,5,9,69,9,Well
5,8,68,F,27,6,7,79,11,Well
11,7,139,F,41,7,6,90,-49,Severe
5,2,62,F,104,13,7,163,101,Well
16,0,192,M,28,6,8,80,-112,Severe
6,8,80,M,99,13,1,157,77,Well
12,7,151,F,81,11,4,136,-15,Severe
13,9,165,F,104,13,7,163,-2,Mild
14,6,174,M,7,5,6,66,-108,Severe
14,0,168,F,108,14,0,168,0,Neutral
6,5,77,M,51,8,4,100,23,Well
9,9,117,M,11,5,8,68,-49,Severe
9,5,113,M,3,5,3,63,-50,Severe
16,2,194,M,90,12,3,147,-47,Severe
15,0,180,F,33,6,11,83,-97,Severe
6,10,82,F,41,7,6,90,8,Well
16,3,195,F,64,9,7,115,-80,Severe
18,4,220,M,4,5,4,64,-156,Severe
7,8,92,F,44,7,9,93,1,Good
11,7,139,M,87,11,11,143,4,Good
15,5,185,M,57,8,10,106,-79,Severe
17,7,211,M,107,13,11,167,-44,Severe
5,10,70,M,56,8,9,105,35,Well
8,8,104,F,96,12,10,154,50,Well
9,3,111,M,48,8,1,97,-14,Severe
11,11,143,M,6,5,5,65,-78,Severe
11,0,132,M,48,8,1,97,-35,Severe
15,5,185,F,15,5,11,71,-114,Severe
15,10,190,M,19,6,1,73,-117,Severe
6,3,75,M,40,7,5,89,14,Well
8,8,104,M,105,13,9,165,61,Well
5,7,67,M,76,10,10,130,63,Well
11,3,135,F,85,11,9,141,6,Well
15,3,183,F,75,10,9,129,-54,Severe
10,5,125,M,100,13,3,159,34,Well
10,3,123,M,2,5,3,63,-60,Severe
15,3,183,M,24,6,5,77,-106,Severe
10,10,130,M,80,11,3,135,5,Good
9,7,115,M,54,8,7,103,-12,Severe
6,5,77,F,108,14,0,168,91,Well
8,0,96,M,11,5,8,68,-28,Severe
18,7,223,F,8,5,6,66,-157,Severe
15,0,180,M,110,14,3,171,-9,Severe
18,0,216,F,31,6,9,81,-135,Severe
15,11,191,F,37,7,3,87,-104,Severe
16,3,195,F,88,12,0,144,-51,Severe
17,4,208,F,22,6,3,75,-133,Severe
11,9,141,F,12,5,9,69,-72,Severe
6,2,74,M,62,9,4,112,38,Well
17,10,214,M,7,5,6,66,-148,Severe
12,8,152,F,66,9,9,117,-35,Severe
6,11,83,F,70,10,2,122,39,Well
18,0,216,M,67,9,10,118,-98,Severe
9,0,108,M,8,5,6,66,-42,Severe
5,10,70,M,103,13,6,162,92,Well
13,3,159,M,58,9,0,108,-51,Severe
7,9,93,F,44,7,9,93,0,Neutral
14,3,171,F,70,10,2,122,-49,Severe
18,3,219,F,71,10,3,123,-96,Severe
6,1,73,M,104,13,7,163,90,Well
5,2,62,M,103,13,6,162,100,Well
13,11,167,M,46,7,11,95,-72,Severe
14,9,177,F,46,7,11,95,-82,Severe
14,8,176,F,89,12,1,145,-31,Severe
18,0,216,M,28,6,8,80,-136,Severe
17,7,211,F,53,8,6,102,-109,Severe
17,7,211,M,47,8,0,96,-115,Severe
12,4,148,M,102,13,6,162,14,Well
8,5,101,M,10,5,7,67,-34,Severe
6,11,83,M,73,10,6,126,43,Well
7,1,85,M,102,13,6,162,77,Well
7,3,87,M,20,6,2,74,-13,Severe
15,8,188,F,106,13,10,166,-22,Severe
16,10,202,M,11,5,8,68,-134,Severe
12,4,148,F,40,7,5,89,-59,Severe
12,6,150,M,109,14,1,169,19,Well
7,0,84,F,68,10,0,120,36,Well
11,7,139,F,30,6,9,81,-58,Severe
18,11,227,F,5,5,5,65,-162,Severe
12,3,147,F,41,7,6,90,-57,Severe
16,1,193,M,6,5,5,65,-128,Severe
5,9,69,M,36,7,2,86,17,Well
11,3,135,F,23,6,4,76,-59,Severe
15,5,185,F,48,8,1,97,-88,Severe
16,3,195,M,74,10,7,127,-68,Severe
9,3,111,F,45,7,10,94,-17,Severe
11,4,136,F,37,7,3,87,-49,Severe
8,11,107,M,69,10,1,121,14,Well
6,2,74,M,35,7,1,85,11,Well
17,10,214,F,53,8,6,102,-112,Severe
16,2,194,M,72,10,4,124,-70,Severe
5,2,62,M,34,7,0,84,22,Well
13,0,156,M,39,7,5,89,-67,Severe
10,4,124,M,32,6,10,82,-42,Severe
10,5,125,F,39,7,5,89,-36,Severe
13,3,159,M,81,11,4,136,-23,Severe
12,0,144,F,50,8,3,99,-45,Severe
18,9,225,M,82,11,5,137,-88,Severe
12,3,147,F,33,6,11,83,-64,Severe
13,5,161,F,101,13,4,160,-1,Mild
17,8,212,F,38,7,4,88,-124,Severe
16,4,196,M,50,8,3,99,-97,Severe
11,11,143,M,2,5,3,63,-80,Severe
10,8,128,M,51,8,4,100,-28,Severe
15,6,186,M,74,10,7,127,-59,Severe
16,9,201,M,40,7,5,89,-112,Severe
14,3,171,F,39,7,5,89,-82,Severe
11,9,141,F,15,5,11,71,-70,Severe
17,1,205,M,17,6,0,72,-133,Severe
9,9,117,F,48,8,1,97,-20,Severe
11,7,139,F,31,6,9,81,-58,Severe
11,3,135,M,83,11,6,138,3,Good
14,3,171,M,56,8,9,105,-66,Severe
12,11,155,M,99,13,1,157,2,Good
6,3,75,M,49,8,2,98,23,Well
6,3,75,M,79,11,1,133,58,Well
8,10,106,M,56,8,9,105,-1,Mild
6,9,81,M,21,6,2,74,-7,Severe
18,11,227,F,47,8,0,96,-131,Severe
12,9,153,F,61,9,3,111,-42,Severe
15,2,182,F,39,7,5,89,-93,Severe
16,1,193,F,24,6,5,77,-116,Severe
18,3,219,F,4,5,4,64,-155,Severe
11,3,135,M,3,5,3,63,-72,Severe
15,0,180,F,39,7,5,89,-91,Severe
18,10,226,M,59,9,1,109,-117,Severe
6,1,73,M,27,6,7,79,6,Well
13,4,160,F,13,5,9,69,-91,Severe
9,7,115,M,49,8,2,98,-17,Severe
15,1,181,F,39,7,5,89,-92,Severe
16,9,201,F,50,8,3,99,-102,Severe
8,3,99,F,26,6,6,78,-21,Severe
14,3,171,F,58,9,0,108,-63,Severe
16,9,201,F,13,5,9,69,-132,Severe
11,4,136,F,52,8,5,101,-35,Severe
14,2,170,M,68,10,0,120,-50,Severe
13,0,156,F,53,8,6,102,-54,Severe
14,2,170,M,23,6,4,76,-94,Severe
15,3,183,M,14,5,10,70,-113,Severe
5,8,68,F,43,7,8,92,24,Well
18,7,223,F,27,6,7,79,-144,Severe
5,3,63,F,100,13,3,159,96,Well
11,4,136,M,19,6,1,73,-63,Severe
17,0,204,F,90,12,3,147,-57,Severe
8,3,99,M,78,11,0,132,33,Well
11,5,137,F,88,12,0,144,7,Well
15,3,183,F,25,6,5,77,-106,Severe
15,8,188,F,90,12,3,147,-41,Severe
14,10,178,F,43,7,8,92,-86,Severe
7,3,87,M,94,12,7,151,64,Well
18,9,225,F,41,7,6,90,-135,Severe
15,0,180,M,4,5,4,64,-116,Severe
12,8,152,M,37,7,3,87,-65,Severe
17,7,211,M,75,10,9,129,-82,Severe
9,4,112,M,32,6,10,82,-30,Severe
12,3,147,M,2,5,3,63,-84,Severe
10,6,126,M,34,7,0,84,-42,Severe
9,0,108,F,103,13,6,162,54,Well
16,3,195,M,105,13,9,165,-30,Severe
18,10,226,M,47,8,0,96,-130,Severe
8,5,101,M,108,14,0,168,67,Well
18,6,222,M,46,7,11,95,-127,Severe
10,9,129,F,103,13,6,162,33,Well
7,1,85,F,106,13,10,166,81,Well
17,8,212,M,29,6,8,80,-132,Severe
18,9,225,F,99,13,1,157,-68,Severe
9,3,111,M,46,7,11,95,-16,Severe
15,4,184,F,97,12,11,155,-29,Severe
16,0,192,M,40,7,5,89,-103,Severe
15,10,190,M,102,13,6,162,-28,Severe
6,0,72,F,21,6,2,74,2,Good
8,5,101,F,8,5,6,66,-35,Severe
18,3,219,F,50,8,3,99,-120,Severe
11,7,139,M,104,13,7,163,24,Well
13,4,160,F,43,7,8,92,-68,Severe
7,11,95,M,92,12,5,149,54,Well
13,0,156,M,11,5,8,68,-88,Severe
12,2,146,F,50,8,3,99,-47,Severe
5,10,70,M,96,12,10,154,84,Well
8,7,103,F,58,9,0,108,5,Good
18,3,219,F,76,10,10,130,-89,Severe
15,4,184,F,26,6,6,78,-106,Severe
6,3,75,F,50,8,3,99,24,Well
7,4,88,F,28,6,8,80,-8,Severe
12,0,144,M,78,11,0,132,-12,Severe
16,6,198,F,48,8,1,97,-101,Severe
17,8,212,F,29,6,8,80,-132,Severe
13,2,158,F,46,7,11,95,-63,Severe
14,5,173,M,96,12,10,154,-19,Severe
11,5,137,F,75,10,9,129,-8,Severe
17,1,205,M,32,6,10,82,-123,Severe
18,6,222,M,68,10,0,120,-102,Severe
5,0,60,M,42,7,7,91,31,Well
16,7,199,M,97,12,11,155,-44,Severe
15,9,189,F,74,10,7,127,-62,Severe
9,2,110,F,92,12,5,149,39,Well
17,4,208,M,81,11,4,136,-72,Severe
10,4,124,M,7,5,6,66,-58,Severe
13,3,159,M,91,12,4,148,-11,Severe
18,11,227,F,101,13,4,160,-67,Severe
13,7,163,F,110,14,3,171,8,Well
13,10,166,F,26,6,6,78,-88,Severe
18,11,227,F,27,6,7,79,-148,Severe
16,3,195,M,70,10,2,122,-73,Severe
8,6,102,M,89,12,1,145,43,Well
16,9,201,M,107,13,11,167,-34,Severe
12,9,153,M,93,12,6,150,-3,Mild
5,6,66,F,25,6,5,77,11,Well
5,6,66,M,41,7,6,90,24,Well
16,6,198,M,59,9,1,109,-89,Severe
12,9,153,M,43,7,8,92,-61,Severe
8,5,101,M,44,7,9,93,-8,Severe
18,7,223,F,34,7,0,84,-139,Severe
16,6,198,M,27,6,7,79,-119,Severe
18,1,217,M,63,9,6,114,-103,Severe
7,3,87,F,34,7,0,84,-3,Mild
9,4,112,M,72,10,4,124,12,Well
9,7,115,F,44,7,9,93,-22,Severe
14,4,172,M,52,8,5,101,-71,Severe
6,0,72,F,74,10,7,127,55,Well
7,10,94,F,62,9,4,112,18,Well
10,2,122,M,102,13,6,162,40,Well
10,3,123,F,75,10,9,129,6,Well
5,9,69,F,105,13,9,165,96,Well
5,10,70,M,29,6,8,80,10,Well
10,5,125,F,64,9,7,115,-10,Severe
13,10,166,M,77,10,11,131,-35,Severe
9,9,117,F,81,11,4,136,19,Well
7,5,89,M,46,7,11,95,6,Well
14,5,173,F,13,5,9,69,-104,Severe
12,6,150,M,69,10,1,121,-29,Severe
15,7,187,M,40,7,5,89,-98,Severe
9,9,117,M,44,7,9,93,-24,Severe
16,4,196,M,74,10,7,127,-69,Severe
16,3,195,M,21,6,2,74,-121,Severe
16,10,202,F,46,7,11,95,-107,Severe
9,9,117,M,28,6,8,80,-37,Severe
17,11,215,F,99,13,1,157,-58,Severe
6,3,75,F,18,6,1,73,-2,Mild
5,3,63,F,80,11,3,135,72,Well
6,10,82,F,96,12,10,154,72,Well
16,11,203,F,56,8,9,105,-98,Severe
12,11,155,M,87,11,11,143,-12,Severe
16,1,193,M,101,13,4,160,-33,Severe
12,1,145,M,13,5,9,69,-76,Severe
9,0,108,M,96,12,10,154,46,Well
18,5,221,F,84,11,7,139,-82,Severe
11,3,135,F,57,8,10,106,-29,Severe
12,4,148,F,59,9,1,109,-39,Severe
16,7,199,M,108,14,0,168,-31,Severe
18,8,224,F,4,5,4,64,-160,Severe
13,3,159,M,49,8,2,98,-61,Severe
16,7,199,M,6,5,5,65,-134,Severe
15,7,187,M,59,9,1,109,-78,Severe
12,7,151,M,45,7,10,94,-57,Severe
17,10,214,F,21,6,2,74,-140,Severe
15,5,185,F,89,12,1,145,-40,Severe
12,3,147,M,88,12,0,144,-3,Mild
13,5,161,F,78,11,0,132,-29,Severe
17,4,208,M,24,6,5,77,-131,Severe
5,9,69,F,92,12,5,149,80,Well
7,2,86,F,82,11,5,137,51,Well
14,7,175,F,13,5,9,69,-106,Severe
18,1,217,M,71,10,3,123,-94,Severe
8,6,102,M,56,8,9,105,3,Good
15,1,181,F,95,12,9,153,-28,Severe
11,8,140,M,59,9,1,109,-31,Severe
7,4,88,M,63,9,6,114,26,Well
6,0,72,M,30,6,9,81,9,Well
13,6,162,F,7,5,6,66,-96,Severe
6,9,81,F,36,7,2,86,5,Good
13,6,162,F,16,5,11,71,-91,Severe
16,7,199,F,67,9,10,118,-81,Severe
18,3,219,F,25,6,5,77,-142,Severe
10,2,122,M,26,6,6,78,-44,Severe
17,4,208,M,19,6,1,73,-135,Severe
11,8,140,F,104,13,7,163,23,Well
12,8,152,F,64,9,7,115,-37,Severe
18,5,221,F,103,13,6,162,-59,Severe
10,6,126,M,63,9,6,114,-12,Severe
11,8,140,M,32,6,10,82,-58,Severe
12,8,152,M,53,8,6,102,-50,Severe
14,3,171,F,100,13,3,159,-12,Severe
5,1,61,F,108,14,0,168,107,Well
11,6,138,M,85,11,9,141,3,Good
9,2,110,F,28,6,8,80,-30,Severe
15,9,189,F,55,8,8,104,-85,Severe
10,0,120,F,12,5,9,69,-51,Severe
12,6,150,F,93,12,6,150,0,Neutral
16,1,193,F,84,11,7,139,-54,Severe
7,8,92,F,34,7,0,84,-8,Severe
18,1,217,F,34,7,0,84,-133,Severe
14,3,171,M,67,9,10,118,-53,Severe
8,10,106,F,21,6,2,74,-32,Severe
18,5,221,M,14,5,10,70,-151,Severe
7,11,95,F,77,10,11,131,36,Well
14,3,171,F,12,5,9,69,-102,Severe
15,7,187,M,79,11,1,133,-54,Severe
5,2,62,F,29,6,8,80,18,Well
15,5,185,F,20,6,2,74,-111,Severe
18,4,220,F,21,6,2,74,-146,Severe
7,7,91,F,39,7,5,89,-2,Mild
8,7,103,M,30,6,9,81,-22,Severe
16,7,199,F,23,6,4,76,-123,Severe
15,2,182,F,65,9,8,116,-66,Severe
10,7,127,F,82,11,5,137,10,Well
16,5,197,M,7,5,6,66,-131,Severe
17,5,209,F,78,11,0,132,-77,Severe
9,6,114,F,61,9,3,111,-3,Mild
15,4,184,F,55,8,8,104,-80,Severe
16,10,202,M,72,10,4,124,-78,Severe
10,7,127,F,44,7,9,93,-34,Severe
10,9,129,F,71,10,3,123,-6,Severe
13,7,163,M,13,5,9,69,-94,Severe
11,0,132,F,41,7,6,90,-42,Severe
11,7,139,F,91,12,4,148,9,Well
12,3,147,F,71,10,3,123,-24,Severe
8,5,101,F,55,8,8,104,3,Good
14,4,172,M,47,8,0,96,-76,Severe
11,6,138,M,90,12,3,147,9,Well
18,3,219,F,93,12,6,150,-69,Severe
8,3,99,M,27,6,7,79,-20,Severe
9,8,116,F,90,12,3,147,31,Well
5,5,65,F,84,11,7,139,74,Well
17,6,210,M,69,10,1,121,-89,Severe
7,11,95,M,85,11,9,141,46,Well
13,3,159,F,98,13,0,156,-3,Mild
17,4,208,M,70,10,2,122,-86,Severe
6,3,75,F,92,12,5,149,74,Well
6,8,80,F,88,12,0,144,64,Well
8,8,104,F,101,13,4,160,56,Well
5,3,63,F,57,8,10,106,43,Well
8,6,102,F,16,5,11,71,-31,Severe
6,2,74,F,3,5,3,63,-11,Severe
15,10,190,M,42,7,7,91,-99,Severe
18,2,218,F,9,5,7,67,-151,Severe
9,3,111,F,86,11,10,142,31,Well
9,3,111,M,84,11,7,139,28,Well
12,10,154,M,100,13,3,159,5,Good
13,0,156,M,35,7,1,85,-71,Severe
6,3,75,M,94,12,7,151,76,Well
8,11,107,M,110,14,3,171,64,Well
11,8,140,F,13,5,9,69,-71,Severe
11,4,136,F,47,8,0,96,-40,Severe
14,5,173,M,102,13,6,162,-11,Severe
6,2,74,M,14,5,10,70,-4,Mild
7,3,87,M,37,7,3,87,0,Neutral
17,0,204,M,61,9,3,111,-93,Severe
16,8,200,M,6,5,5,65,-135,Severe
9,7,115,F,4,5,4,64,-51,Severe
9,0,108,F,73,10,6,126,18,Well
17,11,215,M,42,7,7,91,-124,Severe
13,11,167,M,43,7,8,92,-75,Severe
13,10,166,M,66,9,9,117,-49,Severe
7,9,93,M,38,7,4,88,-5,Mild
15,5,185,M,52,8,5,101,-84,Severe
5,3,63,M,98,13,0,156,93,Well
14,3,171,M,81,11,4,136,-35,Severe
15,0,180,M,31,6,9,81,-99,Severe
6,1,73,M,21,6,2,74,1,Good
10,3,123,M,67,9,10,118,-5,Mild
11,0,132,F,42,7,7,91,-41,Severe
17,8,212,F,89,12,1,145,-67,Severe
15,3,183,M,24,6,5,77,-106,Severe
5,1,61,F,41,7,6,90,29,Well
11,5,137,M,52,8,5,101,-36,Severe
9,8,116,M,12,5,9,69,-47,Severe
9,3,111,F,62,9,4,112,1,Good
13,4,160,M,6,5,5,65,-95,Severe
9,10,118,M,92,12,5,149,31,Well
15,11,191,F,80,11,3,135,-56,Severe
16,2,194,M,35,7,1,85,-109,Severe
6,9,81,F,16,5,11,71,-10,Severe
13,7,163,M,83,11,6,138,-25,Severe
6,7,79,F,39,7,5,89,10,Well
14,4,172,F,106,13,10,166,-6,Severe
17,3,207,M,36,7,2,86,-121,Severe
16,4,196,M,107,13,11,167,-29,Severe
11,6,138,M,96,12,10,154,16,Well
14,3,171,F,80,11,3,135,-36,Severe
13,3,159,F,32,6,10,82,-77,Severe
14,10,178,M,11,5,8,68,-110,Severe
14,6,174,F,14,5,10,70,-104,Severe
10,0,120,F,82,11,5,137,17,Well
5,7,67,F,50,8,3,99,32,Well
14,10,178,M,73,10,6,126,-52,Severe
13,1,157,M,6,5,5,65,-92,Severe
11,0,132,M,24,6,5,77,-55,Severe
10,5,125,M,52,8,5,101,-24,Severe
7,2,86,F,8,5,6,66,-20,Severe
15,2,182,M,82,11,5,137,-45,Severe
6,3,75,M,47,8,0,96,21,Well
9,3,111,M,108,14,0,168,57,Well
10,2,122,F,51,8,4,100,-22,Severe
10,3,123,M,51,8,4,100,-23,Severe
15,1,181,F,46,7,11,95,-86,Severe
16,1,193,F,18,6,1,73,-120,Severe
9,2,110,F,16,5,11,71,-39,Severe
13,0,156,M,24,6,5,77,-79,Severe
9,5,113,M,70,10,2,122,9,Well
18,11,227,M,99,13,1,157,-70,Severe
9,8,116,F,61,9,3,111,-5,Mild
6,1,73,M,87,11,11,143,70,Well
10,8,128,F,92,12,5,149,21,Well
7,10,94,F,89,12,1,145,51,Well
18,3,219,M,36,7,2,86,-133,Severe
5,11,71,F,41,7,6,90,19,Well
7,0,84,F,81,11,4,136,52,Well
15,8,188,M,98,13,0,156,-32,Severe
13,2,158,F,29,6,8,80,-78,Severe
17,3,207,M,107,13,11,167,-40,Severe
18,7,223,F,7,5,6,66,-157,Severe
5,6,66,F,14,5,10,70,4,Good
17,0,204,M,21,6,2,74,-130,Severe
14,1,169,F,85,11,9,141,-28,Severe
15,2,182,M,58,9,0,108,-74,Severe
18,11,227,F,59,9,1,109,-118,Severe
14,4,172,F,94,12,7,151,-21,Severe
6,10,82,M,95,12,9,153,71,Well
12,6,150,F,50,8,3,99,-51,Severe
12,7,151,F,30,6,9,81,-70,Severe
9,3,111,F,67,9,10,118,7,Well
14,11,179,M,94,12,7,151,-28,Severe
6,2,74,F,91,12,4,148,74,Well
5,3,63,F,16,5,11,71,8,Well
7,3,87,M,93,12,6,150,63,Well
8,7,103,F,9,5,7,67,-36,Severe
6,9,81,M,103,13,6,162,81,Well
13,11,167,F,8,5,6,66,-101,Severe
8,11,107,M,94,12,7,151,44,Well
6,2,74,F,79,11,1,133,59,Well
9,0,108,M,6,5,5,65,-43,Severe
6,10,82,F,64,9,7,115,33,Well
18,3,219,M,94,12,7,151,-68,Severe
11,8,140,M,38,7,4,88,-52,Severe
16,3,195,M,66,9,9,117,-78,Severe
11,1,133,M,96,12,10,154,21,Well
18,9,225,M,92,12,5,149,-76,Severe
11,6,138,M,97,12,11,155,17,Well
10,8,128,M,71,10,3,123,-5,Mild
15,7,187,M,28,6,8,80,-107,Severe
13,11,167,F,23,6,4,76,-91,Severe
9,11,119,F,17,6,0,72,-47,Severe
6,11,83,F,37,7,3,87,4,Good
9,1,109,F,36,7,2,86,-23,Severe
8,11,107,M,22,6,3,75,-32,Severe
9,9,117,M,92,12,5,149,32,Well
12,7,151,F,101,13,4,160,9,Well
10,5,125,F,31,6,9,81,-44,Severe
18,4,220,F,56,8,9,105,-115,Severe
6,3,75,F,44,7,9,93,18,Well
16,10,202,M,9,5,7,67,-135,Severe
16,3,195,M,63,9,6,114,-81,Severe
9,2,110,F,23,6,4,76,-34,Severe
7,9,93,M,9,5,7,67,-26,Severe
10,8,128,F,15,5,11,71,-57,Severe
18,8,224,F,68,10,0,120,-104,Severe
5,9,69,M,22,6,3,75,6,Well
12,7,151,F,35,7,1,85,-66,Severe
11,10,142,M,101,13,4,160,18,Well
17,6,210,F,17,6,0,72,-138,Severe
16,7,199,M,17,6,0,72,-127,Severe
15,2,182,F,63,9,6,114,-68,Severe
12,7,151,M,68,10,0,120,-31,Severe
7,5,89,F,59,9,1,109,20,Well
15,4,184,F,64,9,7,115,-69,Severe
15,2,182,F,42,7,7,91,-91,Severe
14,0,168,M,31,6,9,81,-87,Severe
6,11,83,F,64,9,7,115,32,Well
18,11,227,M,57,8,10,106,-121,Severe
6,5,77,M,68,10,0,120,43,Well
5,7,67,M,17,6,0,72,5,Good
16,6,198,M,38,7,4,88,-110,Severe
17,9,213,M,16,5,11,71,-142,Severe
11,6,138,M,71,10,3,123,-15,Severe
6,10,82,F,55,8,8,104,22,Well
16,11,203,F,52,8,5,101,-102,Severe
18,4,220,M,107,13,11,167,-53,Severe
17,5,209,M,107,13,11,167,-42,Severe
9,6,114,M,76,10,10,130,16,Well
13,2,158,F,5,5,5,65,-93,Severe
10,0,120,F,84,11,7,139,19,Well
9,11,119,F,100,13,3,159,40,Well
13,3,159,M,96,12,10,154,-5,Mild
8,3,99,M,55,8,8,104,5,Good
9,9,117,M,6,5,5,65,-52,Severe
17,7,211,M,68,10,0,120,-91,Severe
7,1,85,M,28,6,8,80,-5,Mild
14,10,178,F,67,9,10,118,-60,Severe
18,8,224,M,83,11,6,138,-86,Severe
18,8,224,M,107,13,11,167,-57,Severe
5,6,66,F,2,5,3,63,-3,Mild
7,8,92,F,53,8,6,102,10,Well
13,3,159,F,110,14,3,171,12,Well
12,0,144,F,69,10,1,121,-23,Severe
16,11,203,F,40,7,5,89,-114,Severe
5,2,62,F,17,6,0,72,10,Well
18,7,223,M,15,5,11,71,-152,Severe
7,9,93,M,71,10,3,123,30,Well
5,11,71,F,61,9,3,111,40,Well
12,3,147,F,59,9,1,109,-38,Severe
16,3,195,M,48,8,1,97,-98,Severe
10,11,131,M,69,10,1,121,-10,Severe
10,6,126,M,38,7,4,88,-38,Severe
12,1,145,M,31,6,9,81,-64,Severe
13,11,167,M,84,11,7,139,-28,Severe
11,1,133,M,33,6,11,83,-50,Severe
14,3,171,M,16,5,11,71,-100,Severe
5,4,64,F,55,8,8,104,40,Well
13,10,166,M,33,6,11,83,-83,Severe
15,1,181,M,109,14,1,169,-12,Severe
15,10,190,M,62,9,4,112,-78,Severe
17,9,213,F,75,10,9,129,-84,Severe
6,1,73,F,43,7,8,92,19,Well
15,9,189,M,81,11,4,136,-53,Severe
8,10,106,M,89,12,1,145,39,Well
10,10,130,F,94,12,7,151,21,Well
8,0,96,F,91,12,4,148,52,Well
18,3,219,M,18,6,1,73,-146,Severe
14,7,175,M,18,6,1,73,-102,Severe
13,0,156,F,100,13,3,159,3,Good
18,2,218,M,86,11,10,142,-76,Severe
6,1,73,M,39,7,5,89,16,Well
10,3,123,F,64,9,7,115,-8,Severe
10,9,129,M,78,11,0,132,3,Good
11,10,142,F,97,12,11,155,13,Well
10,5,125,F,89,12,1,145,20,Well
13,0,156,M,110,14,3,171,15,Well
11,8,140,M,71,10,3,123,-17,Severe
17,3,207,M,83,11,6,138,-69,Severe
9,1,109,M,26,6,6,78,-31,Severe
15,0,180,M,20,6,2,74,-106,Severe
6,2,74,F,96,12,10,154,80,Well
11,10,142,F,47,8,0,96,-46,Severe
10,1,121,F,24,6,5,77,-44,Severe
15,11,191,F,91,12,4,148,-43,Severe
15,4,184,F,70,10,2,122,-62,Severe
12,3,147,M,81,11,4,136,-11,Severe
16,7,199,F,83,11,6,138,-61,Severe
5,10,70,M,31,6,9,81,11,Well
13,7,163,F,85,11,9,141,-22,Severe
10,6,126,M,105,13,9,165,39,Well
5,2,62,F,61,9,3,111,49,Well
7,11,95,F,35,7,1,85,-10,Severe
5,11,71,M,78,11,0,132,61,Well
7,0,84,F,32,6,10,82,-2,Mild
9,4,112,M,86,11,10,142,30,Well
8,0,96,F,36,7,2,86,-10,Severe
14,1,169,F,89,12,1,145,-24,Severe
13,10,166,M,42,7,7,91,-75,Severe
11,3,135,M,44,7,9,93,-42,Severe
7,1,85,M,33,6,11,83,-2,Mild
18,8,224,M,14,5,10,70,-154,Severe
16,6,198,M,88,12,0,144,-54,Severe
8,8,104,M,29,6,8,80,-24,Severe
10,5,125,M,62,9,4,112,-13,Severe
9,10,118,M,90,12,3,147,29,Well
6,3,75,M,60,9,2,110,35,Well
17,3,207,F,44,7,9,93,-114,Severe
8,10,106,F,106,13,10,166,60,Well
11,7,139,F,63,9,6,114,-25,Severe
11,1,133,F,39,7,5,89,-44,Severe
14,9,177,M,21,6,2,74,-103,Severe
17,0,204,M,62,9,4,112,-92,Severe
15,9,189,M,35,7,1,85,-104,Severe
7,4,88,F,60,9,2,110,22,Well
18,2,218,M,18,6,1,73,-145,Severe
8,1,97,M,45,7,10,94,-3,Mild
14,9,177,F,97,12,11,155,-22,Severe
18,7,223,F,96,12,10,154,-69,Severe
16,6,198,F,63,9,6,114,-84,Severe
17,11,215,M,74,10,7,127,-88,Severe
14,9,177,F,75,10,9,129,-48,Severe
14,8,176,M,23,6,4,76,-100,Severe
7,8,92,F,32,6,10,82,-10,Severe
11,0,132,M,7,5,6,66,-66,Severe
17,7,211,F,3,5,3,63,-148,Severe
6,0,72,F,50,8,3,99,27,Well
17,10,214,F,43,7,8,92,-122,Severe
6,11,83,F,85,11,9,141,58,Well
5,9,69,M,65,9,8,116,47,Well
13,3,159,M,14,5,10,70,-89,Severe
10,3,123,M,20,6,2,74,-49,Severe
9,1,109,M,59,9,1,109,0,Neutral
5,3,63,M,90,12,3,147,84,Well
8,8,104,F,13,5,9,69,-35,Severe
15,3,183,F,32,6,10,82,-101,Severe
17,2,206,F,65,9,8,116,-90,Severe
10,1,121,F,92,12,5,149,28,Well
13,9,165,F,97,12,11,155,-10,Severe
17,5,209,F,101,13,4,160,-49,Severe
13,10,166,M,76,10,10,130,-36,Severe
6,2,74,M,100,13,3,159,85,Well
11,1,133,F,99,13,1,157,24,Well
18,4,220,F,40,7,5,89,-131,Severe
11,11,143,F,18,6,1,73,-70,Severe
15,1,181,M,13,5,9,69,-112,Severe
18,0,216,M,53,8,6,102,-114,Severe
18,4,220,F,104,13,7,163,-57,Severe
12,10,154,F,94,12,7,151,-3,Mild
5,7,67,F,89,12,1,145,78,Well
8,11,107,M,47,8,0,96,-11,Severe
9,5,113,F,85,11,9,141,28,Well
14,9,177,F,30,6,9,81,-96,Severe
12,7,151,F,41,7,6,90,-61,Severe
18,10,226,F,69,10,1,121,-105,Severe
16,11,203,F,8,5,6,66,-137,Severe
10,0,120,F,33,6,11,83,-37,Severe
8,4,100,M,5,5,5,65,-35,Severe
13,3,159,M,61,9,3,111,-48,Severe
6,4,76,M,45,7,10,94,18,Well
6,3,75,F,63,9,6,114,39,Well
10,7,127,F,21,6,2,74,-53,Severe
10,10,130,M,77,10,11,131,1,Good
13,2,158,M,5,5,5,65,-93,Severe
8,3,99,F,92,12,5,149,50,Well
11,2,134,M,2,5,3,63,-71,Severe
15,11,191,M,22,6,3,75,-116,Severe
17,9,213,F,67,9,10,118,-95,Severe
15,11,191,F,9,5,7,67,-124,Severe
16,0,192,F,43,7,8,92,-100,Severe
11,8,140,M,108,14,0,168,28,Well
11,9,141,F,55,8,8,104,-37,Severe
11,11,143,F,40,7,5,89,-54,Severe
13,9,165,M,7,5,6,66,-99,Severe
16,1,193,M,69,10,1,121,-72,Severe
16,3,195,M,38,7,4,88,-107,Severe
13,0,156,M,75,10,9,129,-27,Severe
18,4,220,F,71,10,3,123,-97,Severe
15,11,191,F,23,6,4,76,-115,Severe
17,10,214,F,78,11,0,132,-82,Severe
10,9,129,F,38,7,4,88,-41,Severe
5,4,64,M,82,11,5,137,73,Well
9,5,113,F,14,5,10,70,-43,Severe
5,3,63,M,106,13,10,166,103,Well
13,2,158,M,43,7,8,92,-66,Severe
13,4,160,F,10,5,7,67,-93,Severe
17,6,210,F,102,13,6,162,-48,Severe
17,10,214,M,81,11,4,136,-78,Severe
8,4,100,F,68,10,0,120,20,Well
9,8,116,F,62,9,4,112,-4,Mild
16,4,196,M,7,5,6,66,-130,Severe
9,1,109,F,20,6,2,74,-35,Severe
12,11,155,M,82,11,5,137,-18,Severe
16,8,200,F,34,7,0,84,-116,Severe
7,7,91,F,15,5,11,71,-20,Severe
18,6,222,M,58,9,0,108,-114,Severe
13,9,165,M,110,14,3,171,6,Well
9,2,110,F,21,6,2,74,-36,Severe
15,1,181,M,12,5,9,69,-112,Severe
6,6,78,M,25,6,5,77,-1,Mild
18,10,226,F,84,11,7,139,-87,Severe
14,2,170,F,44,7,9,93,-77,Severe
13,11,167,F,19,6,1,73,-94,Severe
9,2,110,F,96,12,10,154,44,Well
18,10,226,F,45,7,10,94,-132,Severe
17,8,212,M,66,9,9,117,-95,Severe
16,6,198,M,82,11,5,137,-61,Severe
18,5,221,F,92,12,5,149,-72,Severe
10,4,124,M,62,9,4,112,-12,Severe
5,6,66,F,44,7,9,93,27,Well
11,1,133,M,74,10,7,127,-6,Severe
13,7,163,M,89,12,1,145,-18,Severe
18,10,226,F,97,12,11,155,-71,Severe
7,7,91,F,57,8,10,106,15,Well
12,4,148,M,13,5,9,69,-79,Severe
13,9,165,M,85,11,9,141,-24,Severe
11,3,135,F,14,5,10,70,-65,Severe
9,7,115,M,5,5,5,65,-50,Severe
6,5,77,M,2,5,3,63,-14,Severe
12,5,149,M,53,8,6,102,-47,Severe
11,10,142,M,43,7,8,92,-50,Severe
5,10,70,F,92,12,5,149,79,Well
16,0,192,M,64,9,7,115,-77,Severe
12,2,146,F,8,5,6,66,-80,Severe
12,1,145,M,24,6,5,77,-68,Severe
14,10,178,M,50,8,3,99,-79,Severe
13,2,158,M,27,6,7,79,-79,Severe
12,3,147,M,44,7,9,93,-54,Severe
13,5,161,M,50,8,3,99,-62,Severe
10,11,131,M,47,8,0,96,-35,Severe
7,8,92,F,26,6,6,78,-14,Severe
10,5,125,M,29,6,8,80,-45,Severe
11,1,133,M,27,6,7,79,-54,Severe
14,3,171,M,42,7,7,91,-80,Severe
8,7,103,F,84,11,7,139,36,Well
6,4,76,M,43,7,8,92,16,Well
5,5,65,F,76,10,10,130,65,Well
15,9,189,F,109,14,1,169,-20,Severe
8,8,104,M,32,6,10,82,-22,Severe
13,9,165,M,5,5,5,65,-100,Severe
9,9,117,F,13,5,9,69,-48,Severe
10,9,129,F,33,6,11,83,-46,Severe
14,3,171,M,71,10,3,123,-48,Severe
17,2,206,F,9,5,7,67,-139,Severe
7,0,84,F,103,13,6,162,78,Well
16,6,198,F,57,8,10,106,-92,Severe
12,11,155,F,67,9,10,118,-37,Severe
15,3,183,M,47,8,0,96,-87,Severe
12,8,152,M,98,13,0,156,4,Good
9,2,110,F,43,7,8,92,-18,Severe
14,3,171,M,53,8,6,102,-69,Severe
11,7,139,M,42,7,7,91,-48,Severe
18,5,221,M,49,8,2,98,-123,Severe
11,2,134,M,109,14,1,169,35,Well
14,0,168,M,78,11,0,132,-36,Severe
14,8,176,M,59,9,1,109,-67,Severe
17,9,213,F,60,9,2,110,-103,Severe
8,11,107,F,68,10,0,120,13,Well
14,3,171,M,52,8,5,101,-70,Severe
5,1,61,F,80,11,3,135,74,Well
17,7,211,F,24,6,5,77,-134,Severe
9,3,111,F,27,6,7,79,-32,Severe
14,0,168,F,68,10,0,120,-48,Severe
11,3,135,F,9,5,7,67,-68,Severe
14,11,179,M,85,11,9,141,-38,Severe
7,3,87,M,82,11,5,137,50,Well
9,11,119,F,18,6,1,73,-46,Severe
18,11,227,M,85,11,9,141,-86,Severe
17,9,213,M,32,6,10,82,-131,Severe
10,4,124,M,55,8,8,104,-20,Severe
8,8,104,M,34,7,0,84,-20,Severe
6,9,81,M,107,13,11,167,86,Well
11,4,136,F,54,8,7,103,-33,Severe
7,7,91,F,4,5,4,64,-27,Severe
9,0,108,F,95,12,9,153,45,Well
12,6,150,F,74,10,7,127,-23,Severe
8,1,97,F,87,11,11,143,46,Well
16,1,193,M,8,5,6,66,-127,Severe
13,10,166,M,35,7,1,85,-81,Severe
7,2,86,F,40,7,5,89,3,Good
7,4,88,M,68,10,0,120,32,Well
14,9,177,F,29,6,8,80,-97,Severe
17,3,207,F,39,7,5,89,-118,Severe
18,2,218,M,5,5,5,65,-153,Severe
17,0,204,F,20,6,2,74,-130,Severe
8,6,102,M,14,5,10,70,-32,Severe
18,2,218,F,90,12,3,147,-71,Severe
14,0,168,F,78,11,0,132,-36,Severe
16,4,196,M,38,7,4,88,-108,Severe
11,1,133,F,26,6,6,78,-55,Severe
6,6,78,M,91,12,4,148,70,Well
5,7,67,F,5,5,5,65,-2,Mild
14,3,171,M,22,6,3,75,-96,Severe
12,0,144,F,48,8,1,97,-47,Severe
7,0,84,F,92,12,5,149,65,Well
13,6,162,F,41,7,6,90,-72,Severe
18,3,219,M,17,6,0,72,-147,Severe
15,3,183,F,46,7,11,95,-88,Severe
6,4,76,M,93,12,6,150,74,Well
11,5,137,F,37,7,3,87,-50,Severe
12,0,144,M,93,12,6,150,6,Well
7,0,84,M,32,6,10,82,-2,Mild
18,3,219,M,100,13,3,159,-60,Severe
12,11,155,M,38,7,4,88,-67,Severe
9,11,119,M,88,12,0,144,25,Well
16,5,197,M,6,5,5,65,-132,Severe
7,3,87,F,49,8,2,98,11,Well
6,4,76,F,63,9,6,114,38,Well
12,7,151,M,6,5,5,65,-86,Severe
16,2,194,F,68,10,0,120,-74,Severe
14,6,174,F,56,8,9,105,-69,Severe
12,1,145,M,105,13,9,165,20,Well
14,3,171,F,95,12,9,153,-18,Severe
17,10,214,F,81,11,4,136,-78,Severe
17,6,210,F,38,7,4,88,-122,Severe
10,4,124,F,20,6,2,74,-50,Severe
14,4,172,F,75,10,9,129,-43,Severe
5,4,64,F,60,9,2,110,46,Well
11,2,134,F,72,10,4,124,-10,Severe
18,3,219,F,61,9,3,111,-108,Severe
14,3,171,M,72,10,4,124,-47,Severe
8,7,103,M,6,5,5,65,-38,Severe
7,6,90,F,41,7,6,90,0,Neutral
5,3,63,F,84,11,7,139,76,Well
5,10,70,F,13,5,9,69,-1,Mild
12,8,152,M,109,14,1,169,17,Well
7,0,84,M,103,13,6,162,78,Well
13,9,165,M,22,6,3,75,-90,Severe
13,5,161,M,69,10,1,121,-40,Severe
5,3,63,F,72,10,4,124,61,Well
14,0,168,M,93,12,6,150,-18,Severe
5,1,61,M,82,11,5,137,76,Well
8,1,97,M,67,9,10,118,21,Well
5,5,65,F,43,7,8,92,27,Well
13,0,156,F,85,11,9,141,-15,Severe
9,7,115,M,67,9,10,118,3,Good
7,4,88,F,85,11,9,141,53,Well
7,7,91,M,105,13,9,165,74,Well
7,4,88,F,70,10,2,122,34,Well
17,8,212,F,15,5,11,71,-141,Severe
9,2,110,M,103,13,6,162,52,Well
6,7,79,F,58,9,0,108,29,Well
12,3,147,M,92,12,5,149,2,Good
18,3,219,M,82,11,5,137,-82,Severe
8,11,107,F,28,6,8,80,-27,Severe
8,4,100,F,26,6,6,78,-22,Severe
18,3,219,F,46,7,11,95,-124,Severe
7,4,88,F,67,9,10,118,30,Well
7,4,88,M,72,10,4,124,36,Well
11,1,133,M,9,5,7,67,-66,Severe
12,10,154,M,78,11,0,132,-22,Severe
11,5,137,M,10,5,7,67,-70,Severe
6,3,75,M,70,10,2,122,47,Well
18,9,225,M,62,9,4,112,-113,Severe
6,8,80,M,83,11,6,138,58,Well
18,1,217,F,55,8,8,104,-113,Severe
8,8,104,M,56,8,9,105,1,Good
10,7,127,F,103,13,6,162,35,Well
7,4,88,F,17,6,0,72,-16,Severe
18,10,226,F,75,10,9,129,-97,Severe
16,1,193,F,46,7,11,95,-98,Severe
11,9,141,M,94,12,7,151,10,Well
14,0,168,M,92,12,5,149,-19,Severe
17,2,206,F,56,8,9,105,-101,Severe
7,10,94,M,102,13,6,162,68,Well
7,5,89,F,43,7,8,92,3,Good
10,3,123,M,20,6,2,74,-49,Severe
16,1,193,F,41,7,6,90,-103,Severe
10,11,131,M,85,11,9,141,10,Well
9,3,111,M,16,5,11,71,-40,Severe
8,3,99,F,54,8,7,103,4,Good
16,4,196,F,16,5,11,71,-125,Severe
16,7,199,F,61,9,3,111,-88,Severe
9,8,116,F,65,9,8,116,0,Neutral
6,8,80,F,17,6,0,72,-8,Severe
13,11,167,M,22,6,3,75,-92,Severe
6,6,78,F,16,5,11,71,-7,Severe
16,9,201,M,65,9,8,116,-85,Severe
9,5,113,M,17,6,0,72,-41,Severe
17,2,206,F,17,6,0,72,-134,Severe
12,2,146,M,43,7,8,92,-54,Severe
14,9,177,M,93,12,6,150,-27,Severe
18,6,222,F,42,7,7,91,-131,Severe
8,6,102,F,22,6,3,75,-27,Severe
6,8,80,F,32,6,10,82,2,Good
6,2,74,F,52,8,5,101,27,Well
5,3,63,F,2,5,3,63,0,Neutral
16,10,202,M,70,10,2,122,-80,Severe
12,3,147,F,30,6,9,81,-66,Severe
17,0,204,M,65,9,8,116,-88,Severe
12,5,149,M,78,11,0,132,-17,Severe
5,4,64,F,56,8,9,105,41,Well
15,3,183,M,53,8,6,102,-81,Severe
11,5,137,M,80,11,3,135,-2,Mild
17,4,208,M,2,5,3,63,-145,Severe
8,3,99,F,56,8,9,105,6,Well
12,6,150,M,98,13,0,156,6,Well
6,10,82,M,46,7,11,95,13,Well
17,6,210,F,108,14,0,168,-42,Severe
12,4,148,M,14,5,10,70,-78,Severe
7,4,88,F,7,5,6,66,-22,Severe
18,0,216,F,9,5,7,67,-149,Severe
5,9,69,M,52,8,5,101,32,Well
5,5,65,M,60,9,2,110,45,Well
6,2,74,M,8,5,6,66,-8,Severe
16,1,193,F,99,13,1,157,-36,Severe
8,7,103,M,54,8,7,103,0,Neutral
5,11,71,M,59,9,1,109,38,Well
12,3,147,F,47,8,0,96,-51,Severe
18,3,219,F,3,5,3,63,-156,Severe
10,1,121,F,33,6,11,83,-38,Severe
5,0,60,M,25,6,5,77,17,Well
9,2,110,M,55,8,8,104,-6,Severe
16,7,199,M,94,12,7,151,-48,Severe
17,6,210,F,58,9,0,108,-102,Severe
6,8,80,F,67,9,10,118,38,Well
10,5,125,F,51,8,4,100,-25,Severe
16,3,195,F,51,8,4,100,-95,Severe
6,9,81,F,77,10,11,131,50,Well
16,0,192,F,78,11,0,132,-60,Severe
15,6,186,F,81,11,4,136,-50,Severe
18,3,219,F,72,10,4,124,-95,Severe
9,10,118,M,75,10,9,129,11,Well
8,3,99,F,52,8,5,101,2,Good
9,6,114,F,110,14,3,171,57,Well
12,0,144,M,54,8,7,103,-41,Severe
8,9,105,M,45,7,10,94,-11,Severe
12,2,146,F,79,11,1,133,-13,Severe
12,0,144,M,43,7,8,92,-52,Severe
8,2,98,F,31,6,9,81,-17,Severe
16,9,201,F,33,6,11,83,-118,Severe
11,0,132,F,100,13,3,159,27,Well
13,3,159,M,32,6,10,82,-77,Severe
18,8,224,M,95,12,9,153,-71,Severe
11,2,134,M,105,13,9,165,31,Well
15,8,188,M,10,5,7,67,-121,Severe
7,0,84,M,104,13,7,163,79,Well
14,1,169,F,78,11,0,132,-37,Severe
6,10,82,M,107,13,11,167,85,Well
10,2,122,F,19,6,1,73,-49,Severe
14,1,169,M,60,9,2,110,-59,Severe
12,5,149,F,82,11,5,137,-12,Severe
17,3,207,M,65,9,8,116,-91,Severe
15,0,180,M,28,6,8,80,-100,Severe
9,9,117,F,42,7,7,91,-26,Severe
18,6,222,F,30,6,9,81,-141,Severe
14,6,174,F,98,13,0,156,-18,Severe
17,5,209,M,58,9,0,108,-101,Severe
7,9,93,F,88,12,0,144,51,Well
18,3,219,F,90,12,3,147,-72,Severe
15,8,188,F,57,8,10,106,-82,Severe
14,2,170,F,55,8,8,104,-66,Severe
14,9,177,M,13,5,9,69,-108,Severe
11,9,141,F,86,11,10,142,1,Good
8,11,107,M,36,7,2,86,-21,Severe
14,11,179,M,108,14,0,168,-11,Severe
5,2,62,F,38,7,4,88,26,Well
10,9,129,F,87,11,11,143,14,Well
6,9,81,F,43,7,8,92,11,Well
17,8,212,F,107,13,11,167,-45,Severe
6,0,72,F,23,6,4,76,4,Good
17,1,205,M,95,12,9,153,-52,Severe
18,4,220,M,93,12,6,150,-70,Severe
16,1,193,M,103,13,6,162,-31,Severe
15,2,182,M,57,8,10,106,-76,Severe
15,9,189,M,79,11,1,133,-56,Severe
7,5,89,F,5,5,5,65,-24,Severe
15,3,183,M,62,9,4,112,-71,Severe
8,10,106,F,32,6,10,82,-24,Severe
5,7,67,F,16,5,11,71,4,Good
10,2,122,F,86,11,10,142,20,Well
13,1,157,F,23,6,4,76,-81,Severe
15,3,183,F,10,5,7,67,-116,Severe
17,11,215,M,50,8,3,99,-116,Severe
5,10,70,F,4,5,4,64,-6,Severe
15,11,191,M,67,9,10,118,-73,Severe
7,2,86,M,52,8,5,101,15,Well
17,10,214,M,66,9,9,117,-97,Severe
8,0,96,F,26,6,6,78,-18,Severe
9,9,117,F,15,5,11,71,-46,Severe
5,3,63,F,101,13,4,160,97,Well
8,6,102,M,83,11,6,138,36,Well
9,4,112,F,55,8,8,104,-8,Severe
14,6,174,M,108,14,0,168,-6,Severe
9,3,111,F,110,14,3,171,60,Well
9,5,113,F,72,10,4,124,11,Well
18,4,220,M,69,10,1,121,-99,Severe
18,6,222,F,18,6,1,73,-149,Severe
12,11,155,F,54,8,7,103,-52,Severe
14,7,175,M,67,9,10,118,-57,Severe
15,10,190,M,64,9,7,115,-75,Severe
13,1,157,M,29,6,8,80,-77,Severe
13,10,166,F,103,13,6,162,-4,Mild
12,2,146,M,8,5,6,66,-80,Severe
14,4,172,F,69,10,1,121,-51,Severe
10,10,130,F,103,13,6,162,32,Well
13,3,159,M,13,5,9,69,-90,Severe
18,11,227,M,32,6,10,82,-145,Severe
8,2,98,F,68,10,0,120,22,Well
14,11,179,F,52,8,5,101,-78,Severe
7,10,94,M,88,12,0,144,50,Well
10,8,128,F,12,5,9,69,-59,Severe
13,11,167,M,76,10,10,130,-37,Severe
10,0,120,F,38,7,4,88,-32,Severe
8,1,97,F,21,6,2,74,-23,Severe
15,6,186,M,68,10,0,120,-66,Severe
9,1,109,M,61,9,3,111,2,Good
8,4,100,M,20,6,2,74,-26,Severe
11,7,139,M,14,5,10,70,-69,Severe
17,5,209,F,104,13,7,163,-46,Severe
13,4,160,M,75,10,9,129,-31,Severe
18,0,216,M,33,6,11,83,-133,Severe
5,6,66,M,39,7,5,89,23,Well
16,10,202,M,105,13,9,165,-37,Severe
9,5,113,F,84,11,7,139,26,Well
7,2,86,M,49,8,2,98,12,Well
18,1,217,M,8,5,6,66,-151,Severe
7,7,91,F,71,10,3,123,32,Well
15,6,186,M,78,11,0,132,-54,Severe
12,3,147,M,85,11,9,141,-6,Severe
14,4,172,M,34,7,0,84,-88,Severe
13,9,165,F,68,10,0,120,-45,Severe
5,3,63,M,75,10,9,129,66,Well
8,4,100,F,34,7,0,84,-16,Severe
11,4,136,F,44,7,9,93,-43,Severe
15,0,180,M,94,12,7,151,-29,Severe
14,6,174,F,89,12,1,145,-29,Severe
16,8,200,F,67,9,10,118,-82,Severe
15,4,184,F,12,5,9,69,-115,Severe
10,3,123,F,54,8,7,103,-20,Severe
16,5,197,F,57,8,10,106,-91,Severe
5,11,71,F,29,6,8,80,9,Well
9,7,115,M,52,8,5,101,-14,Severe
11,11,143,M,96,12,10,154,11,Well
16,7,199,F,95,12,9,153,-46,Severe
9,11,119,F,28,6,8,80,-39,Severe
17,3,207,F,74,10,7,127,-80,Severe
18,3,219,F,63,9,6,114,-105,Severe
13,0,156,M,38,7,4,88,-68,Severe
14,2,170,F,9,5,7,67,-103,Severe
14,8,176,F,15,5,11,71,-105,Severe
15,5,185,F,88,12,0,144,-41,Severe
8,10,106,F,2,5,3,63,-43,Severe
16,10,202,M,12,5,9,69,-133,Severe
7,11,95,F,37,7,3,87,-8,Severe
12,1,145,M,71,10,3,123,-22,Severe
12,5,149,F,66,9,9,117,-32,Severe
14,0,168,M,68,10,0,120,-48,Severe
8,0,96,F,52,8,5,101,5,Good
15,10,190,M,100,13,3,159,-31,Severe
5,5,65,M,53,8,6,102,37,Well
14,8,176,M,95,12,9,153,-23,Severe
13,11,167,F,89,12,1,145,-22,Severe
14,9,177,M,71,10,3,123,-54,Severe
10,11,131,F,41,7,6,90,-41,Severe
13,8,164,M,79,11,1,133,-31,Severe
13,9,165,F,50,8,3,99,-66,Severe
17,8,212,F,25,6,5,77,-135,Severe
17,2,206,M,72,10,4,124,-82,Severe
5,11,71,M,29,6,8,80,9,Well
14,8,176,F,54,8,7,103,-73,Severe
12,5,149,M,2,5,3,63,-86,Severe
18,11,227,F,29,6,8,80,-147,Severe
8,11,107,F,56,8,9,105,-2,Mild
12,6,150,F,103,13,6,162,12,Well
15,9,189,F,52,8,5,101,-88,Severe
17,2,206,M,75,10,9,129,-77,Severe
12,5,149,F,110,14,3,171,22,Well
10,6,126,M,70,10,2,122,-4,Mild
14,5,173,M,31,6,9,81,-92,Severe
9,3,111,F,66,9,9,117,6,Well
12,0,144,F,35,7,1,85,-59,Severe
17,9,213,F,40,7,5,89,-124,Severe
18,6,222,F,98,13,0,156,-66,Severe
17,4,208,M,94,12,7,151,-57,Severe
5,1,61,F,34,7,0,84,23,Well
7,4,88,F,34,7,0,84,-4,Mild
9,7,115,M,73,10,6,126,11,Well
9,3,111,F,47,8,0,96,-15,Severe
13,9,165,F,108,14,0,168,3,Good
15,11,191,M,18,6,1,73,-118,Severe
9,3,111,F,41,7,6,90,-21,Severe
9,11,119,M,62,9,4,112,-7,Severe
12,9,153,M,8,5,6,66,-87,Severe
13,6,162,F,87,11,11,143,-19,Severe
9,6,114,F,57,8,10,106,-8,Severe
15,3,183,M,79,11,1,133,-50,Severe
9,2,110,M,31,6,9,81,-29,Severe
13,4,160,F,22,6,3,75,-85,Severe
14,4,172,F,16,5,11,71,-101,Severe
13,4,160,F,104,13,7,163,3,Good
7,9,93,M,78,11,0,132,39,Well
10,1,121,M,36,7,2,86,-35,Severe
17,8,212,M,96,12,10,154,-58,Severe
16,9,201,F,40,7,5,89,-112,Severe
13,0,156,M,15,5,11,71,-85,Severe
6,0,72,F,35,7,1,85,13,Well
16,6,198,M,6,5,5,65,-133,Severe
9,6,114,M,53,8,6,102,-12,Severe
13,6,162,F,12,5,9,69,-93,Severe
15,5,185,F,67,9,10,118,-67,Severe
9,9,117,M,68,10,0,120,3,Good
17,5,209,F,7,5,6,66,-143,Severe
5,4,64,F,74,10,7,127,63,Well
12,5,149,M,103,13,6,162,13,Well
17,4,208,M,108,14,0,168,-40,Severe
6,0,72,M,110,14,3,171,99,Well
5,11,71,F,27,6,7,79,8,Well
15,11,191,M,69,10,1,121,-70,Severe
14,8,176,F,27,6,7,79,-97,Severe
11,11,143,F,110,14,3,171,28,Well
10,6,126,M,30,6,9,81,-45,Severe
10,5,125,F,46,7,11,95,-30,Severe
9,10,118,F,95,12,9,153,35,Well
13,11,167,F,106,13,10,166,-1,Mild
8,5,101,M,52,8,5,101,0,Neutral
9,5,113,F,77,10,11,131,18,Well
7,1,85,M,55,8,8,104,19,Well
11,3,135,F,16,5,11,71,-64,Severe
12,2,146,M,85,11,9,141,-5,Mild
9,2,110,F,85,11,9,141,31,Well
15,6,186,M,36,7,2,86,-100,Severe
9,7,115,M,22,6,3,75,-40,Severe
15,5,185,F,24,6,5,77,-108,Severe
10,9,129,F,63,9,6,114,-15,Severe
14,6,174,F,29,6,8,80,-94,Severe
10,5,125,F,108,14,0,168,43,Well
8,11,107,F,71,10,3,123,16,Well
6,3,75,M,41,7,6,90,15,Well
15,0,180,F,17,6,0,72,-108,Severe
9,0,108,F,51,8,4,100,-8,Severe
18,2,218,F,60,9,2,110,-108,Severe
13,10,166,F,97,12,11,155,-11,Severe
7,4,88,M,60,9,2,110,22,Well
15,1,181,F,5,5,5,65,-116,Severe
12,6,150,F,29,6,8,80,-70,Severe
15,1,181,M,76,10,10,130,-51,Severe
10,3,123,M,29,6,8,80,-43,Severe
13,3,159,F,10,5,7,67,-92,Severe
14,4,172,F,45,7,10,94,-78,Severe
12,1,145,M,32,6,10,82,-63,Severe
7,7,91,F,6,5,5,65,-26,Severe
16,3,195,F,6,5,5,65,-130,Severe
7,5,89,M,19,6,1,73,-16,Severe
6,7,79,F,74,10,7,127,48,Well
14,0,168,M,76,10,10,130,-38,Severe
5,4,64,M,66,9,9,117,53,Well
9,8,116,M,53,8,6,102,-14,Severe
9,10,118,F,5,5,5,65,-53,Severe
5,1,61,M,97,12,11,155,94,Well
9,1,109,F,104,13,7,163,54,Well
17,11,215,M,78,11,0,132,-83,Severe
11,6,138,F,18,6,1,73,-65,Severe
8,3,99,F,42,7,7,91,-8,Severe
15,2,182,F,33,6,11,83,-99,Severe
15,4,184,F,85,11,9,141,-43,Severe
8,9,105,F,5,5,5,65,-40,Severe
10,11,131,F,58,9,0,108,-23,Severe
6,2,74,F,97,12,11,155,81,Well
7,8,92,F,81,11,4,136,44,Well
13,9,165,M,11,5,8,68,-97,Severe
14,3,171,M,50,8,3,99,-72,Severe
14,7,175,F,45,7,10,94,-81,Severe
9,2,110,F,44,7,9,93,-17,Severe
13,8,164,M,80,11,3,135,-29,Severe
12,3,147,M,43,7,8,92,-55,Severe
8,10,106,F,67,9,10,118,12,Well
7,6,90,M,91,12,4,148,58,Well
17,5,209,M,41,7,6,90,-119,Severe
18,3,219,F,93,12,6,150,-69,Severe
10,3,123,F,44,7,9,93,-30,Severe
11,2,134,F,56,8,9,105,-29,Severe
18,10,226,M,17,6,0,72,-154,Severe
5,8,68,F,28,6,8,80,12,Well
15,5,185,F,30,6,9,81,-104,Severe
17,2,206,F,15,5,11,71,-135,Severe
8,0,96,F,99,13,1,157,61,Well
16,6,198,F,32,6,10,82,-116,Severe
17,9,213,F,100,13,3,159,-54,Severe
5,4,64,F,27,6,7,79,15,Well
8,10,106,M,109,14,1,169,63,Well
6,9,81,F,85,11,9,141,60,Well
14,10,178,M,86,11,10,142,-36,Severe
13,5,161,F,81,11,4,136,-25,Severe
12,0,144,M,64,9,7,115,-29,Severe
7,10,94,F,70,10,2,122,28,Well
17,9,213,M,19,6,1,73,-140,Severe
11,7,139,F,92,12,5,149,10,Well
5,11,71,M,85,11,9,141,70,Well
5,0,60,F,68,10,0,120,60,Well
12,2,146,F,34,7,0,84,-62,Severe
7,11,95,F,73,10,6,126,31,Well
13,10,166,M,59,9,1,109,-57,Severe
7,3,87,F,6,5,5,65,-22,Severe
14,11,179,M,5,5,5,65,-114,Severe
10,10,130,M,110,14,3,171,41,Well
8,1,97,M,91,12,4,148,51,Well
13,1,157,F,70,10,2,122,-35,Severe
17,10,214,F,7,5,6,66,-148,Severe
18,3,219,M,47,8,0,96,-123,Severe
14,3,171,M,60,9,2,110,-61,Severe
16,0,192,M,8,5,6,66,-126,Severe
14,10,178,M,76,10,10,130,-48,Severe
13,6,162,F,44,7,9,93,-69,Severe
10,7,127,M,27,6,7,79,-48,Severe
15,7,187,F,4,5,4,64,-123,Severe
7,0,84,F,38,7,4,88,4,Good
5,6,66,M,109,14,1,169,103,Well
11,7,139,M,62,9,4,112,-27,Severe
6,11,83,M,5,5,5,65,-18,Severe
5,7,67,M,35,7,1,85,18,Well
12,8,152,F,88,12,0,144,-8,Severe
11,10,142,M,53,8,6,102,-40,Severe
17,7,211,F,19,6,1,73,-138,Severe
15,10,190,M,96,12,10,154,-36,Severe
14,9,177,M,39,7,5,89,-88,Severe
17,9,213,F,105,13,9,165,-48,Severe
6,4,76,M,26,6,6,78,2,Good
14,1,169,M,87,11,11,143,-26,Severe
5,7,67,M,41,7,6,90,23,Well
13,9,165,F,77,10,11,131,-34,Severe
17,9,213,F,14,5,10,70,-143,Severe
7,3,87,F,38,7,4,88,1,Good
18,11,227,M,67,9,10,118,-109,Severe
16,2,194,F,53,8,6,102,-92,Severe
10,4,124,M,68,10,0,120,-4,Mild
5,4,64,F,18,6,1,73,9,Well
10,3,123,M,51,8,4,100,-23,Severe
5,7,67,M,27,6,7,79,12,Well
11,9,141,F,31,6,9,81,-60,Severe
14,9,177,M,57,8,10,106,-71,Severe
7,3,87,M,17,6,0,72,-15,Severe
13,0,156,M,103,13,6,162,6,Well
8,6,102,M,54,8,7,103,1,Good
8,1,97,F,40,7,5,89,-8,Severe
12,6,150,F,100,13,3,159,9,Well
7,3,87,M,62,9,4,112,25,Well
15,0,180,M,17,6,0,72,-108,Severe
6,10,82,F,27,6,7,79,-3,Mild
6,0,72,F,72,10,4,124,52,Well
7,7,91,M,96,12,10,154,63,Well
15,10,190,F,107,13,11,167,-23,Severe
7,9,93,F,96,12,10,154,61,Well
15,6,186,M,51,8,4,100,-86,Severe
16,2,194,M,28,6,8,80,-114,Severe
16,4,196,M,17,6,0,72,-124,Severe
11,8,140,F,47,8,0,96,-44,Severe
6,3,75,F,106,13,10,166,91,Well
14,6,174,F,108,14,0,168,-6,Severe
18,8,224,F,24,6,5,77,-147,Severe
8,6,102,M,62,9,4,112,10,Well
6,6,78,F,40,7,5,89,11,Well
13,6,162,F,69,10,1,121,-41,Severe
8,11,107,M,11,5,8,68,-39,Severe
11,1,133,M,2,5,3,63,-70,Severe
17,3,207,F,13,5,9,69,-138,Severe
7,0,84,F,18,6,1,73,-11,Severe
14,0,168,F,55,8,8,104,-64,Severe
11,2,134,M,75,10,9,129,-5,Mild
6,2,74,M,56,8,9,105,31,Well
15,9,189,F,75,10,9,129,-60,Severe
16,0,192,M,4,5,4,64,-128,Severe
11,10,142,F,85,11,9,141,-1,Mild
6,10,82,F,69,10,1,121,39,Well
12,7,151,M,15,5,11,71,-80,Severe
16,9,201,M,52,8,5,101,-100,Severe
18,0,216,F,60,9,2,110,-106,Severe
18,5,221,M,88,12,0,144,-77,Severe
17,4,208,F,56,8,9,105,-103,Severe
12,5,149,F,47,8,0,96,-53,Severe
15,10,190,F,26,6,6,78,-112,Severe
5,4,64,M,5,5,5,65,1,Good
13,3,159,F,28,6,8,80,-79,Severe
5,2,62,F,9,5,7,67,5,Good
11,9,141,M,70,10,2,122,-19,Severe
17,7,211,M,56,8,9,105,-106,Severe
7,2,86,F,88,12,0,144,58,Well
6,8,80,M,4,5,4,64,-16,Severe
11,7,139,M,110,14,3,171,32,Well
13,11,167,F,4,5,4,64,-103,Severe
10,0,120,M,68,10,0,120,0,Neutral
18,7,223,F,107,13,11,167,-56,Severe
16,7,199,F,60,9,2,110,-89,Severe
16,4,196,M,80,11,3,135,-61,Severe
12,0,144,M,83,11,6,138,-6,Severe
10,0,120,F,26,6,6,78,-42,Severe
10,7,127,F,46,7,11,95,-32,Severe
17,8,212,M,23,6,4,76,-136,Severe
17,5,209,M,4,5,4,64,-145,Severe
18,3,219,F,26,6,6,78,-141,Severe
6,11,83,M,19,6,1,73,-10,Severe
17,2,206,F,20,6,2,74,-132,Severe
16,0,192,M,34,7,0,84,-108,Severe
7,0,84,M,17,6,0,72,-12,Severe
10,7,127,F,5,5,5,65,-62,Severe
17,9,213,M,50,8,3,99,-114,Severe
18,3,219,M,38,7,4,88,-131,Severe
11,9,141,F,70,10,2,122,-19,Severe
11,6,138,M,5,5,5,65,-73,Severe
8,1,97,M,13,5,9,69,-28,Severe
13,2,158,F,94,12,7,151,-7,Severe
13,8,164,F,39,7,5,89,-75,Severe
16,9,201,F,37,7,3,87,-114,Severe
5,2,62,M,107,13,11,167,105,Well
5,3,63,F,93,12,6,150,87,Well
10,1,121,M,86,11,10,142,21,Well
17,6,210,M,67,9,10,118,-92,Severe
16,6,198,F,38,7,4,88,-110,Severe
17,0,204,F,32,6,10,82,-122,Severe
10,6,126,F,76,10,10,130,4,Good
15,2,182,F,14,5,10,70,-112,Severe
13,11,167,M,86,11,10,142,-25,Severe
12,1,145,F,4,5,4,64,-81,Severe
14,1,169,M,66,9,9,117,-52,Severe
5,4,64,F,57,8,10,106,42,Well
11,3,135,M,29,6,8,80,-55,Severe
18,3,219,F,43,7,8,92,-127,Severe
10,8,128,M,85,11,9,141,13,Well
13,11,167,M,107,13,11,167,0,Neutral
8,6,102,F,48,8,1,97,-5,Mild
10,5,125,F,69,10,1,121,-4,Mild
18,9,225,M,102,13,6,162,-63,Severe
11,4,136,M,28,6,8,80,-56,Severe
16,2,194,F,2,5,3,63,-131,Severe
13,2,158,F,68,10,0,120,-38,Severe
17,3,207,F,94,12,7,151,-56,Severe
5,9,69,F,28,6,8,80,11,Well
12,4,148,F,85,11,9,141,-7,Severe
15,11,191,M,25,6,5,77,-114,Severe
5,3,63,F,42,7,7,91,28,Well
13,5,161,F,108,14,0,168,7,Well
16,1,193,F,8,5,6,66,-127,Severe
13,4,160,M,18,6,1,73,-87,Severe
7,11,95,F,50,8,3,99,4,Good
12,3,147,M,73,10,6,126,-21,Severe
14,10,178,F,73,10,6,126,-52,Severe
14,4,172,F,51,8,4,100,-72,Severe
14,0,168,M,79,11,1,133,-35,Severe
9,3,111,M,94,12,7,151,40,Well
18,4,220,F,31,6,9,81,-139,Severe
11,0,132,F,5,5,5,65,-67,Severe
18,1,217,F,100,13,3,159,-58,Severe
11,2,134,M,41,7,6,90,-44,Severe
17,4,208,M,22,6,3,75,-133,Severe
14,11,179,M,26,6,6,78,-101,Severe
11,3,135,M,67,9,10,118,-17,Severe
10,2,122,M,23,6,4,76,-46,Severe
16,10,202,M,14,5,10,70,-132,Severe
13,1,157,M,80,11,3,135,-22,Severe
9,3,111,M,84,11,7,139,28,Well
5,4,64,M,90,12,3,147,83,Well
12,2,146,M,41,7,6,90,-56,Severe
11,1,133,F,5,5,5,65,-68,Severe
6,1,73,F,82,11,5,137,64,Well
8,6,102,F,65,9,8,116,14,Well
11,5,137,M,37,7,3,87,-50,Severe
12,7,151,M,48,8,1,97,-54,Severe
14,4,172,M,66,9,9,117,-55,Severe
14,8,176,M,108,14,0,168,-8,Severe
18,1,217,M,25,6,5,77,-140,Severe
16,1,193,F,5,5,5,65,-128,Severe
15,4,184,F,98,13,0,156,-28,Severe
16,5,197,F,5,5,5,65,-132,Severe
11,2,134,F,3,5,3,63,-71,Severe
18,3,219,F,64,9,7,115,-104,Severe
7,7,91,M,11,5,8,68,-23,Severe
12,2,146,F,83,11,6,138,-8,Severe
13,3,159,F,107,13,11,167,8,Well
11,1,133,M,57,8,10,106,-27,Severe
5,7,67,M,87,11,11,143,76,Well
15,8,188,F,26,6,6,78,-110,Severe
13,6,162,M,75,10,9,129,-33,Severe
12,9,153,M,80,11,3,135,-18,Severe
5,7,67,M,48,8,1,97,30,Well
11,8,140,M,99,13,1,157,17,Well
15,9,189,M,50,8,3,99,-90,Severe
14,4,172,M,92,12,5,149,-23,Severe
18,0,216,M,3,5,3,63,-153,Severe
10,5,125,M,44,7,9,93,-32,Severe
14,6,174,F,84,11,7,139,-35,Severe
10,8,128,M,4,5,4,64,-64,Severe
17,9,213,F,63,9,6,114,-99,Severe
18,9,225,F,7,5,6,66,-159,Severe
10,6,126,M,66,9,9,117,-9,Severe
6,4,76,M,74,10,7,127,51,Well
14,5,173,F,9,5,7,67,-106,Severe
12,10,154,F,85,11,9,141,-13,Severe
13,1,157,M,94,12,7,151,-6,Severe
11,2,134,M,50,8,3,99,-35,Severe
13,11,167,M,44,7,9,93,-74,Severe
17,0,204,F,14,5,10,70,-134,Severe
10,0,120,F,37,7,3,87,-33,Severe
14,2,170,M,45,7,10,94,-76,Severe
18,9,225,F,10,5,7,67,-158,Severe
15,7,187,F,64,9,7,115,-72,Severe
12,4,148,F,71,10,3,123,-25,Severe
17,6,210,F,98,13,0,156,-54,Severe
5,10,70,M,75,10,9,129,59,Well
6,7,79,F,6,5,5,65,-14,Severe
8,1,97,M,28,6,8,80,-17,Severe
5,11,71,M,63,9,6,114,43,Well
9,4,112,M,99,13,1,157,45,Well
6,1,73,F,33,6,11,83,10,Well
16,1,193,M,75,10,9,129,-64,Severe
15,6,186,F,33,6,11,83,-103,Severe
17,9,213,F,96,12,10,154,-59,Severe
17,1,205,F,49,8,2,98,-107,Severe
12,7,151,M,110,14,3,171,20,Well
11,1,133,M,100,13,3,159,26,Well
16,2,194,F,83,11,6,138,-56,Severe
13,3,159,M,42,7,7,91,-68,Severe
6,6,78,M,39,7,5,89,11,Well
18,4,220,F,34,7,0,84,-136,Severe
11,8,140,F,107,13,11,167,27,Well
7,9,93,M,61,9,3,111,18,Well
6,7,79,F,8,5,6,66,-13,Severe
7,2,86,M,58,9,0,108,22,Well
7,3,87,M,56,8,9,105,18,Well
8,4,100,M,36,7,2,86,-14,Severe
11,7,139,F,86,11,10,142,3,Good
10,11,131,F,28,6,8,80,-51,Severe
6,1,73,M,52,8,5,101,28,Well
18,2,218,M,4,5,4,64,-154,Severe
16,10,202,F,44,7,9,93,-109,Severe
8,0,96,M,66,9,9,117,21,Well
14,1,169,F,43,7,8,92,-77,Severe
8,0,96,F,57,8,10,106,10,Well
6,10,82,M,84,11,7,139,57,Well
11,10,142,F,22,6,3,75,-67,Severe
10,10,130,M,20,6,2,74,-56,Severe
10,3,123,F,84,11,7,139,16,Well
15,6,186,F,4,5,4,64,-122,Severe
8,4,100,F,6,5,5,65,-35,Severe
13,11,167,F,29,6,8,80,-87,Severe
10,11,131,M,65,9,8,116,-15,Severe
15,8,188,M,12,5,9,69,-119,Severe
9,2,110,F,64,9,7,115,5,Good
11,5,137,F,42,7,7,91,-46,Severe
10,4,124,M,42,7,7,91,-33,Severe
16,4,196,M,8,5,6,66,-130,Severe
9,11,119,F,48,8,1,97,-22,Severe
17,11,215,M,23,6,4,76,-139,Severe
15,7,187,M,32,6,10,82,-105,Severe
16,5,197,M,23,6,4,76,-121,Severe
15,4,184,F,76,10,10,130,-54,Severe
15,2,182,F,55,8,8,104,-78,Severe
7,4,88,M,55,8,8,104,16,Well
10,10,130,M,10,5,7,67,-63,Severe
18,5,221,F,109,14,1,169,-52,Severe
5,4,64,M,81,11,4,136,72,Well
7,0,84,F,20,6,2,74,-10,Severe
9,6,114,F,32,6,10,82,-32,Severe
16,4,196,M,69,10,1,121,-75,Severe
16,3,195,M,74,10,7,127,-68,Severe
6,3,75,M,2,5,3,63,-12,Severe
8,11,107,F,73,10,6,126,19,Well
8,1,97,M,64,9,7,115,18,Well
6,10,82,M,91,12,4,148,66,Well
11,10,142,F,90,12,3,147,5,Good
14,3,171,F,5,5,5,65,-106,Severe
18,0,216,F,84,11,7,139,-77,Severe
5,8,68,M,26,6,6,78,10,Well
5,3,63,M,19,6,1,73,10,Well
6,0,72,M,58,9,0,108,36,Well
10,1,121,F,40,7,5,89,-32,Severe
8,9,105,M,81,11,4,136,31,Well
12,3,147,F,66,9,9,117,-30,Severe
10,9,129,M,37,7,3,87,-42,Severe
5,3,63,F,18,6,1,73,10,Well
8,3,99,M,2,5,3,63,-36,Severe
11,1,133,F,36,7,2,86,-47,Severe
9,0,108,M,89,12,1,145,37,Well
18,1,217,M,57,8,10,106,-111,Severe
13,10,166,M,108,14,0,168,2,Good
15,10,190,F,82,11,5,137,-53,Severe
15,6,186,M,87,11,11,143,-43,Severe
8,3,99,M,66,9,9,117,18,Well
9,2,110,M,19,6,1,73,-37,Severe
18,5,221,F,93,12,6,150,-71,Severe
17,9,213,M,77,10,11,131,-82,Severe
12,11,155,M,81,11,4,136,-19,Severe
8,7,103,F,59,9,1,109,6,Well
18,3,219,M,50,8,3,99,-120,Severe
11,5,137,M,36,7,2,86,-51,Severe
14,1,169,M,34,7,0,84,-85,Severe
11,10,142,M,57,8,10,106,-36,Severe
18,6,222,M,38,7,4,88,-134,Severe
6,3,75,M,56,8,9,105,30,Well
11,9,141,M,15,5,11,71,-70,Severe
8,1,97,F,42,7,7,91,-6,Severe
12,9,153,F,3,5,3,63,-90,Severe
7,4,88,F,55,8,8,104,16,Well
11,3,135,F,3,5,3,63,-72,Severe
11,7,139,F,67,9,10,118,-21,Severe
9,0,108,F,60,9,2,110,2,Good
8,7,103,F,22,6,3,75,-28,Severe
10,0,120,F,108,14,0,168,48,Well
6,9,81,F,78,11,0,132,51,Well
5,10,70,F,97,12,11,155,85,Well
11,8,140,M,80,11,3,135,-5,Mild
18,0,216,M,51,8,4,100,-116,Severe
13,3,159,F,72,10,4,124,-35,Severe
15,8,188,M,94,12,7,151,-37,Severe
14,6,174,M,79,11,1,133,-41,Severe
8,4,100,F,88,12,0,144,44,Well
5,4,64,M,2,5,3,63,-1,Mild
9,10,118,F,22,6,3,75,-43,Severe
11,3,135,M,106,13,10,166,31,Well
10,5,125,M,79,11,1,133,8,Well
12,7,151,F,91,12,4,148,-3,Mild
11,6,138,F,99,13,1,157,19,Well
12,1,145,M,53,8,6,102,-43,Severe
13,3,159,M,70,10,2,122,-37,Severe
12,3,147,F,26,6,6,78,-69,Severe
13,3,159,M,56,8,9,105,-54,Severe
12,3,147,F,67,9,10,118,-29,Severe
11,10,142,F,4,5,4,64,-78,Severe
16,4,196,F,106,13,10,166,-30,Severe
6,0,72,F,63,9,6,114,42,Well
5,10,70,F,65,9,8,116,46,Well
6,3,75,F,60,9,2,110,35,Well
14,9,177,F,44,7,9,93,-84,Severe
13,6,162,M,32,6,10,82,-80,Severe
7,1,85,F,110,14,3,171,86,Well
17,8,212,F,26,6,6,78,-134,Severe
13,2,158,F,28,6,8,80,-78,Severe
7,4,88,M,3,5,3,63,-25,Severe
14,3,171,M,26,6,6,78,-93,Severe
5,9,69,F,94,12,7,151,82,Well
13,4,160,M,101,13,4,160,0,Neutral
9,6,114,M,102,13,6,162,48,Well
9,8,116,F,6,5,5,65,-51,Severe
7,2,86,F,26,6,6,78,-8,Severe
15,0,180,M,43,7,8,92,-88,Severe
12,4,148,M,30,6,9,81,-67,Severe
6,3,75,F,17,6,0,72,-3,Mild
6,7,79,M,68,10,0,120,41,Well
17,2,206,M,106,13,10,166,-40,Severe
15,7,187,F,96,12,10,154,-33,Severe
6,8,80,F,87,11,11,143,63,Well
13,0,156,M,89,12,1,145,-11,Severe
15,8,188,M,27,6,7,79,-109,Severe
15,3,183,F,45,7,10,94,-89,Severe
10,9,129,M,64,9,7,115,-14,Severe
15,10,190,M,7,5,6,66,-124,Severe
5,8,68,F,70,10,2,122,54,Well
7,3,87,F,7,5,6,66,-21,Severe
13,9,165,F,64,9,7,115,-50,Severe
11,0,132,F,22,6,3,75,-57,Severe
15,9,189,M,31,6,9,81,-108,Severe
9,8,116,F,91,12,4,148,32,Well
13,1,157,F,9,5,7,67,-90,Severe
15,11,191,M,10,5,7,67,-124,Severe
10,4,124,M,86,11,10,142,18,Well
6,1,73,F,107,13,11,167,94,Well
16,0,192,M,17,6,0,72,-120,Severe
17,8,212,M,82,11,5,137,-75,Severe
9,3,111,F,34,7,0,84,-27,Severe
15,5,185,F,35,7,1,85,-100,Severe
6,6,78,F,50,8,3,99,21,Well
5,10,70,F,63,9,6,114,44,Well
17,7,211,M,7,5,6,66,-145,Severe
6,3,75,F,33,6,11,83,8,Well
9,8,116,F,108,14,0,168,52,Well
14,3,171,M,28,6,8,80,-91,Severe
8,3,99,F,101,13,4,160,61,Well
18,9,225,F,57,8,10,106,-119,Severe
10,0,120,M,95,12,9,153,33,Well
8,3,99,M,50,8,3,99,0,Neutral
18,9,225,F,83,11,6,138,-87,Severe
11,3,135,F,108,14,0,168,33,Well
9,7,115,M,60,9,2,110,-5,Mild
13,1,157,M,72,10,4,124,-33,Severe
8,11,107,M,101,13,4,160,53,Well
13,0,156,F,90,12,3,147,-9,Severe
11,9,141,M,24,6,5,77,-64,Severe
11,6,138,M,52,8,5,101,-37,Severe
8,9,105,M,107,13,11,167,62,Well
10,1,121,M,21,6,2,74,-47,Severe
6,6,78,F,95,12,9,153,75,Well
14,8,176,M,107,13,11,167,-9,Severe
15,0,180,F,82,11,5,137,-43,Severe
15,4,184,F,48,8,1,97,-87,Severe
13,10,166,M,15,5,11,71,-95,Severe
7,3,87,M,107,13,11,167,80,Well
17,1,205,M,29,6,8,80,-125,Severe
7,8,92,M,35,7,1,85,-7,Severe
5,5,65,F,99,13,1,157,92,Well
7,0,84,F,49,8,2,98,14,Well
7,4,88,F,37,7,3,87,-1,Mild
6,2,74,F,40,7,5,89,15,Well
7,10,94,M,63,9,6,114,20,Well
17,3,207,F,5,5,5,65,-142,Severe
10,11,131,M,73,10,6,126,-5,Mild
6,4,76,M,34,7,0,84,8,Well
9,6,114,M,90,12,3,147,33,Well
17,9,213,M,108,14,0,168,-45,Severe
12,8,152,F,2,5,3,63,-89,Severe
10,1,121,M,76,10,10,130,9,Well
14,9,177,F,84,11,7,139,-38,Severe
12,11,155,M,66,9,9,117,-38,Severe
18,5,221,F,38,7,4,88,-133,Severe
6,6,78,M,3,5,3,63,-15,Severe
14,5,173,F,39,7,5,89,-84,Severe
6,10,82,F,92,12,5,149,67,Well
14,2,170,F,78,11,0,132,-38,Severe
15,2,182,F,51,8,4,100,-82,Severe
17,3,207,M,28,6,8,80,-127,Severe
5,11,71,F,8,5,6,66,-5,Mild
18,10,226,F,17,6,0,72,-154,Severe
9,9,117,M,97,12,11,155,38,Well
12,5,149,F,71,10,3,123,-26,Severe
17,6,210,M,8,5,6,66,-144,Severe
11,0,132,M,35,7,1,85,-47,Severe
5,0,60,M,48,8,1,97,37,Well
14,4,172,F,14,5,10,70,-102,Severe
5,5,65,F,17,6,0,72,7,Well
7,8,92,F,19,6,1,73,-19,Severe
9,6,114,M,37,7,3,87,-27,Severe
16,7,199,M,86,11,10,142,-57,Severe
11,7,139,F,62,9,4,112,-27,Severe
12,1,145,M,47,8,0,96,-49,Severe
13,2,158,F,8,5,6,66,-92,Severe
6,3,75,F,90,12,3,147,72,Well
5,7,67,M,90,12,3,147,80,Well
12,2,146,F,69,10,1,121,-25,Severe
16,10,202,F,5,5,5,65,-137,Severe
10,9,129,M,84,11,7,139,10,Well
13,6,162,F,15,5,11,71,-91,Severe
13,11,167,M,65,9,8,116,-51,Severe
18,6,222,F,38,7,4,88,-134,Severe
14,10,178,M,95,12,9,153,-25,Severe
6,7,79,M,71,10,3,123,44,Well
8,0,96,F,22,6,3,75,-21,Severe
14,8,176,M,28,6,8,80,-96,Severe
12,6,150,F,23,6,4,76,-74,Severe
8,3,99,M,22,6,3,75,-24,Severe
18,11,227,F,97,12,11,155,-72,Severe
16,2,194,M,88,12,0,144,-50,Severe
11,0,132,F,96,12,10,154,22,Well
17,4,208,F,96,12,10,154,-54,Severe
12,2,146,F,73,10,6,126,-20,Severe
8,10,106,F,96,12,10,154,48,Well
10,3,123,F,109,14,1,169,46,Well
12,0,144,M,22,6,3,75,-69,Severe
5,2,62,F,13,5,9,69,7,Well
15,2,182,F,58,9,0,108,-74,Severe
16,5,197,F,64,9,7,115,-82,Severe
8,3,99,F,37,7,3,87,-12,Severe
15,4,184,F,103,13,6,162,-22,Severe
17,3,207,F,91,12,4,148,-59,Severe
14,4,172,F,84,11,7,139,-33,Severe
14,1,169,M,41,7,6,90,-79,Severe
5,8,68,M,86,11,10,142,74,Well
18,4,220,F,82,11,5,137,-83,Severe
15,4,184,M,106,13,10,166,-18,Severe
15,8,188,F,79,11,1,133,-55,Severe
13,4,160,M,82,11,5,137,-23,Severe
9,2,110,M,40,7,5,89,-21,Severe
11,2,134,M,43,7,8,92,-42,Severe
5,8,68,M,6,5,5,65,-3,Mild
11,8,140,F,51,8,4,100,-40,Severe
14,9,177,F,36,7,2,86,-91,Severe
14,9,177,F,65,9,8,116,-61,Severe
7,3,87,F,51,8,4,100,13,Well
9,6,114,F,44,7,9,93,-21,Severe
5,5,65,M,97,12,11,155,90,Well
8,2,98,M,95,12,9,153,55,Well
12,3,147,M,72,10,4,124,-23,Severe
9,7,115,M,66,9,9,117,2,Good
11,9,141,M,60,9,2,110,-31,Severe
18,0,216,F,14,5,10,70,-146,Severe
10,10,130,M,25,6,5,77,-53,Severe
17,8,212,M,92,12,5,149,-63,Severe
12,1,145,M,75,10,9,129,-16,Severe
14,3,171,F,24,6,5,77,-94,Severe
13,0,156,F,29,6,8,80,-76,Severe
14,3,171,M,99,13,1,157,-14,Severe
16,9,201,F,52,8,5,101,-100,Severe
13,9,165,M,41,7,6,90,-75,Severe
16,1,193,M,68,10,0,120,-73,Severe
11,4,136,F,62,9,4,112,-24,Severe
12,5,149,M,101,13,4,160,11,Well
15,7,187,M,53,8,6,102,-85,Severe
6,3,75,M,78,11,0,132,57,Well
16,9,201,M,11,5,8,68,-133,Severe
13,9,165,F,106,13,10,166,1,Good
7,5,89,F,94,12,7,151,62,Well
18,8,224,F,6,5,5,65,-159,Severe
13,0,156,F,69,10,1,121,-35,Severe
9,10,118,F,109,14,1,169,51,Well
17,10,214,M,41,7,6,90,-124,Severe
14,8,176,F,87,11,11,143,-33,Severe
8,7,103,F,49,8,2,98,-5,Mild
11,11,143,M,108,14,0,168,25,Well
12,2,146,M,106,13,10,166,20,Well
5,1,61,F,59,9,1,109,48,Well
7,10,94,F,95,12,9,153,59,Well
7,3,87,M,34,7,0,84,-3,Mild
10,0,120,F,3,5,3,63,-57,Severe
16,9,201,M,97,12,11,155,-46,Severe
9,2,110,M,58,9,0,108,-2,Mild
10,10,130,M,59,9,1,109,-21,Severe
7,0,84,M,51,8,4,100,16,Well
7,3,87,M,23,6,4,76,-11,Severe
9,3,111,F,49,8,2,98,-13,Severe
7,1,85,F,90,12,3,147,62,Well
17,3,207,F,85,11,9,141,-66,Severe
7,8,92,F,13,5,9,69,-23,Severe
12,0,144,F,23,6,4,76,-68,Severe
17,8,212,F,102,13,6,162,-50,Severe
17,4,208,F,23,6,4,76,-132,Severe
11,1,133,M,49,8,2,98,-35,Severe
8,9,105,M,32,6,10,82,-23,Severe
14,9,177,F,51,8,4,100,-77,Severe
18,6,222,M,8,5,6,66,-156,Severe
18,4,220,F,70,10,2,122,-98,Severe
12,10,154,F,78,11,0,132,-22,Severe
17,7,211,M,70,10,2,122,-89,Severe
14,3,171,F,64,9,7,115,-56,Severe
7,10,94,M,11,5,8,68,-26,Severe
6,0,72,F,90,12,3,147,75,Well
10,4,124,M,100,13,3,159,35,Well
6,6,78,F,18,6,1,73,-5,Mild
18,2,218,F,103,13,6,162,-56,Severe
17,2,206,F,50,8,3,99,-107,Severe
17,4,208,F,3,5,3,63,-145,Severe
8,10,106,F,105,13,9,165,59,Well
12,6,150,F,39,7,5,89,-61,Severe
13,5,161,M,17,6,0,72,-89,Severe
6,3,75,F,33,6,11,83,8,Well
9,11,119,M,103,13,6,162,43,Well
5,11,71,F,107,13,11,167,96,Well
13,10,166,F,104,13,7,163,-3,Mild
14,11,179,F,78,11,0,132,-47,Severe
13,3,159,F,21,6,2,74,-85,Severe
16,3,195,F,60,9,2,110,-85,Severe
10,11,131,F,76,10,10,130,-1,Mild
11,5,137,F,96,12,10,154,17,Well
14,8,176,M,18,6,1,73,-103,Severe
11,2,134,M,17,6,0,72,-62,Severe
10,4,124,M,97,12,11,155,31,Well
16,11,203,F,38,7,4,88,-115,Severe
14,7,175,M,85,11,9,141,-34,Severe
15,6,186,M,95,12,9,153,-33,Severe
15,5,185,F,78,11,0,132,-53,Severe
14,3,171,M,74,10,7,127,-44,Severe
15,1,181,F,84,11,7,139,-42,Severe
15,0,180,M,14,5,10,70,-110,Severe
7,6,90,F,10,5,7,67,-23,Severe
11,6,138,F,51,8,4,100,-38,Severe
18,7,223,M,89,12,1,145,-78,Severe
10,0,120,M,11,5,8,68,-52,Severe
12,10,154,M,105,13,9,165,11,Well
18,1,217,M,75,10,9,129,-88,Severe
14,5,173,M,8,5,6,66,-107,Severe
5,4,64,F,58,9,0,108,44,Well
11,7,139,F,10,5,7,67,-72,Severe
6,2,74,M,51,8,4,100,26,Well
12,10,154,M,96,12,10,154,0,Neutral
10,9,129,F,52,8,5,101,-28,Severe
17,4,208,F,41,7,6,90,-118,Severe
5,5,65,M,35,7,1,85,20,Well
13,5,161,F,49,8,2,98,-63,Severe
8,1,97,F,47,8,0,96,-1,Mild
13,4,160,F,25,6,5,77,-83,Severe
11,3,135,F,53,8,6,102,-33,Severe
17,1,205,M,66,9,9,117,-88,Severe
11,2,134,F,103,13,6,162,28,Well
15,8,188,F,43,7,8,92,-96,Severe
9,4,112,F,6,5,5,65,-47,Severe
13,4,160,F,8,5,6,66,-94,Severe
6,8,80,M,73,10,6,126,46,Well
5,0,60,F,23,6,4,76,16,Well
6,6,78,M,56,8,9,105,27,Well
15,0,180,F,64,9,7,115,-65,Severe
9,11,119,F,33,6,11,83,-36,Severe
8,10,106,F,48,8,1,97,-9,Severe
17,8,212,M,95,12,9,153,-59,Severe
12,3,147,M,94,12,7,151,4,Good
11,11,143,F,105,13,9,165,22,Well
12,1,145,M,11,5,8,68,-77,Severe
17,5,209,F,70,10,2,122,-87,Severe
13,6,162,F,21,6,2,74,-88,Severe
16,5,197,M,85,11,9,141,-56,Severe
15,5,185,F,54,8,7,103,-82,Severe
12,3,147,M,23,6,4,76,-71,Severe
7,4,88,M,109,14,1,169,81,Well
18,7,223,F,99,13,1,157,-66,Severe
10,1,121,F,85,11,9,141,20,Well
16,3,195,F,92,12,5,149,-46,Severe
17,10,214,M,103,13,6,162,-52,Severe
12,5,149,M,50,8,3,99,-50,Severe
8,3,99,M,100,13,3,159,60,Well
15,7,187,M,41,7,6,90,-97,Severe
9,0,108,M,74,10,7,127,19,Well
10,0,120,M,61,9,3,111,-9,Severe
13,3,159,F,63,9,6,114,-45,Severe
14,0,168,M,73,10,6,126,-42,Severe
13,9,165,F,94,12,7,151,-14,Severe
16,1,193,M,23,6,4,76,-117,Severe
15,10,190,M,84,11,7,139,-51,Severe
13,6,162,F,85,11,9,141,-21,Severe
7,6,90,M,94,12,7,151,61,Well
6,9,81,F,41,7,6,90,9,Well
10,10,130,M,35,7,1,85,-45,Severe
12,6,150,M,37,7,3,87,-63,Severe
15,6,186,F,58,9,0,108,-78,Severe
16,0,192,F,2,5,3,63,-129,Severe
9,9,117,F,25,6,5,77,-40,Severe
13,1,157,M,46,7,11,95,-62,Severe
17,8,212,M,103,13,6,162,-50,Severe
5,9,69,M,58,9,0,108,39,Well
17,2,206,F,102,13,6,162,-44,Severe
10,11,131,M,96,12,10,154,23,Well
15,5,185,F,22,6,3,75,-110,Severe
12,3,147,F,45,7,10,94,-53,Severe
6,10,82,M,70,10,2,122,40,Well
9,10,118,M,97,12,11,155,37,Well
18,7,223,F,41,7,6,90,-133,Severe
6,3,75,M,33,6,11,83,8,Well
15,1,181,F,41,7,6,90,-91,Severe
5,8,68,F,25,6,5,77,9,Well
9,8,116,M,72,10,4,124,8,Well
11,6,138,M,39,7,5,89,-49,Severe
16,8,200,M,94,12,7,151,-49,Severe
8,5,101,M,46,7,11,95,-6,Severe
10,0,120,M,47,8,0,96,-24,Severe
18,6,222,M,92,12,5,149,-73,Severe
18,2,218,F,95,12,9,153,-65,Severe
15,8,188,M,79,11,1,133,-55,Severe
15,11,191,F,35,7,1,85,-106,Severe
5,7,67,M,14,5,10,70,3,Good
16,7,199,M,27,6,7,79,-120,Severe
18,2,218,F,11,5,8,68,-150,Severe
17,3,207,F,28,6,8,80,-127,Severe
5,3,63,F,7,5,6,66,3,Good
8,10,106,M,67,9,10,118,12,Well
18,11,227,M,79,11,1,133,-94,Severe
11,3,135,F,2,5,3,63,-72,Severe
11,7,139,F,6,5,5,65,-74,Severe
6,4,76,M,29,6,8,80,4,Good
11,4,136,F,16,5,11,71,-65,Severe
5,11,71,F,66,9,9,117,46,Well
13,1,157,F,99,13,1,157,0,Neutral
9,10,118,F,89,12,1,145,27,Well
14,4,172,M,84,11,7,139,-33,Severe
8,4,100,F,50,8,3,99,-1,Mild
16,4,196,F,95,12,9,153,-43,Severe
14,3,171,M,65,9,8,116,-55,Severe
18,11,227,F,21,6,2,74,-153,Severe
14,11,179,M,102,13,6,162,-17,Severe
18,6,222,F,45,7,10,94,-128,Severe
5,11,71,F,42,7,7,91,20,Well
15,1,181,F,3,5,3,63,-118,Severe
11,6,138,M,38,7,4,88,-50,Severe
17,10,214,M,32,6,10,82,-132,Severe
17,6,210,M,74,10,7,127,-83,Severe
17,9,213,F,45,7,10,94,-119,Severe
14,1,169,M,12,5,9,69,-100,Severe
11,3,135,F,46,7,11,95,-40,Severe
9,0,108,M,22,6,3,75,-33,Severe
16,7,199,F,9,5,7,67,-132,Severe
12,11,155,F,72,10,4,124,-31,Severe
9,8,116,M,77,10,11,131,15,Well
7,3,87,F,70,10,2,122,35,Well
18,8,224,F,34,7,0,84,-140,Severe
11,3,135,F,89,12,1,145,10,Well
14,10,178,M,92,12,5,149,-29,Severe
12,7,151,F,28,6,8,80,-71,Severe
15,3,183,F,83,11,6,138,-45,Severe
16,1,193,F,17,6,0,72,-121,Severe
12,10,154,F,47,8,0,96,-58,Severe
14,4,172,F,97,12,11,155,-17,Severe
14,0,168,M,57,8,10,106,-62,Severe
8,6,102,M,9,5,7,67,-35,Severe
18,2,218,M,77,10,11,131,-87,Severe
18,8,224,M,57,8,10,106,-118,Severe
17,1,205,F,13,5,9,69,-136,Severe
16,2,194,M,26,6,6,78,-116,Severe
7,3,87,F,101,13,4,160,73,Well
14,9,177,F,58,9,0,108,-69,Severe
16,7,199,M,89,12,1,145,-54,Severe
13,9,165,F,39,7,5,89,-76,Severe
9,0,108,M,94,12,7,151,43,Well
11,11,143,F,23,6,4,76,-67,Severe
12,9,153,F,19,6,1,73,-80,Severe
11,9,141,F,85,11,9,141,0,Neutral
5,11,71,M,25,6,5,77,6,Well
5,8,68,F,10,5,7,67,-1,Mild
13,4,160,F,81,11,4,136,-24,Severe
17,6,210,F,24,6,5,77,-133,Severe
14,8,176,F,50,8,3,99,-77,Severe
8,3,99,F,48,8,1,97,-2,Mild
17,9,213,M,61,9,3,111,-102,Severe
5,3,63,F,99,13,1,157,94,Well
8,2,98,F,72,10,4,124,26,Well
8,1,97,F,16,5,11,71,-26,Severe
17,5,209,F,77,10,11,131,-78,Severe
9,2,110,M,42,7,7,91,-19,Severe
18,3,219,F,23,6,4,76,-143,Severe
11,3,135,F,64,9,7,115,-20,Severe
13,3,159,F,41,7,6,90,-69,Severe
16,2,194,M,7,5,6,66,-128,Severe
8,11,107,F,25,6,5,77,-30,Severe
17,9,213,F,30,6,9,81,-132,Severe
8,2,98,M,28,6,8,80,-18,Severe
16,10,202,F,84,11,7,139,-63,Severe
6,11,83,M,68,10,0,120,37,Well
6,8,80,F,95,12,9,153,73,Well
16,7,199,M,49,8,2,98,-101,Severe
6,3,75,F,84,11,7,139,64,Well
13,3,159,M,21,6,2,74,-85,Severe
7,2,86,F,104,13,7,163,77,Well
13,5,161,M,95,12,9,153,-8,Severe
9,1,109,M,53,8,6,102,-7,Severe
18,8,224,M,84,11,7,139,-85,Severe
7,11,95,F,11,5,8,68,-27,Severe
11,8,140,M,97,12,11,155,15,Well
16,8,200,F,23,6,4,76,-124,Severe
13,5,161,M,51,8,4,100,-61,Severe
15,7,187,M,76,10,10,130,-57,Severe
7,0,84,M,2,5,3,63,-21,Severe
18,10,226,M,63,9,6,114,-112,Severe
9,9,117,M,105,13,9,165,48,Well
6,10,82,F,42,7,7,91,9,Well
15,9,189,M,55,8,8,104,-85,Severe
15,11,191,M,30,6,9,81,-110,Severe
17,10,214,F,92,12,5,149,-65,Severe
7,5,89,M,107,13,11,167,78,Well
9,3,111,M,10,5,7,67,-44,Severe
10,6,126,F,105,13,9,165,39,Well
12,5,149,M,17,6,0,72,-77,Severe
5,10,70,M,84,11,7,139,69,Well
8,1,97,M,81,11,4,136,39,Well
6,8,80,F,24,6,5,77,-3,Mild
12,2,146,M,27,6,7,79,-67,Severe
13,0,156,F,6,5,5,65,-91,Severe
10,7,127,M,110,14,3,171,44,Well
16,4,196,M,48,8,1,97,-99,Severe
15,9,189,F,12,5,9,69,-120,Severe
8,0,96,F,43,7,8,92,-4,Mild
9,0,108,F,38,7,4,88,-20,Severe
10,5,125,F,53,8,6,102,-23,Severe
18,6,222,M,36,7,2,86,-136,Severe
17,0,204,F,2,5,3,63,-141,Severe
6,10,82,F,98,13,0,156,74,Well
16,8,200,F,18,6,1,73,-127,Severe
13,10,166,M,97,12,11,155,-11,Severe
16,8,200,F,80,11,3,135,-65,Severe
17,6,210,M,40,7,5,89,-121,Severe
16,5,197,F,46,7,11,95,-102,Severe
5,0,60,F,99,13,1,157,97,Well
12,9,153,M,85,11,9,141,-12,Severe
17,11,215,M,66,9,9,117,-98,Severe
17,0,204,F,26,6,6,78,-126,Severe
12,3,147,M,45,7,10,94,-53,Severe
11,2,134,M,7,5,6,66,-68,Severe
14,9,177,M,87,11,11,143,-34,Severe
12,9,153,M,12,5,9,69,-84,Severe
6,2,74,F,92,12,5,149,75,Well
10,7,127,M,40,7,5,89,-38,Severe
10,1,121,F,70,10,2,122,1,Good
17,4,208,M,59,9,1,109,-99,Severe
16,11,203,F,109,14,1,169,-34,Severe
7,4,88,F,10,5,7,67,-21,Severe
14,10,178,M,41,7,6,90,-88,Severe
14,10,178,M,54,8,7,103,-75,Severe
14,11,179,F,105,13,9,165,-14,Severe
15,10,190,M,50,8,3,99,-91,Severe
16,11,203,F,43,7,8,92,-111,Severe
8,3,99,M,28,6,8,80,-19,Severe
18,8,224,F,32,6,10,82,-142,Severe
18,11,227,M,104,13,7,163,-64,Severe
6,5,77,F,107,13,11,167,90,Well
13,3,159,F,11,5,8,68,-91,Severe
18,10,226,M,55,8,8,104,-122,Severe
14,3,171,M,107,13,11,167,-4,Mild
10,4,124,F,65,9,8,116,-8,Severe
6,6,78,F,91,12,4,148,70,Well
9,4,112,M,66,9,9,117,5,Good
12,9,153,F,79,11,1,133,-20,Severe
9,8,116,M,94,12,7,151,35,Well
12,4,148,F,87,11,11,143,-5,Mild
11,1,133,F,6,5,5,65,-68,Severe
6,1,73,M,74,10,7,127,54,Well
10,8,128,M,29,6,8,80,-48,Severe
16,10,202,M,69,10,1,121,-81,Severe
18,1,217,F,62,9,4,112,-105,Severe
11,10,142,M,99,13,1,157,15,Well
11,3,135,F,26,6,6,78,-57,Severe
5,10,70,F,94,12,7,151,81,Well
18,4,220,F,38,7,4,88,-132,Severe
11,8,140,F,71,10,3,123,-17,Severe
6,3,75,M,48,8,1,97,22,Well
15,3,183,M,107,13,11,167,-16,Severe
9,3,111,F,59,9,1,109,-2,Mild
8,0,96,F,72,10,4,124,28,Well
7,8,92,F,83,11,6,138,46,Well
11,3,135,F,94,12,7,151,16,Well
15,5,185,M,82,11,5,137,-48,Severe
15,5,185,M,92,12,5,149,-36,Severe
10,0,120,F,107,13,11,167,47,Well
8,1,97,M,86,11,10,142,45,Well
13,5,161,F,72,10,4,124,-37,Severe
17,6,210,F,96,12,10,154,-56,Severe
12,11,155,F,51,8,4,100,-55,Severe
8,11,107,M,83,11,6,138,31,Well
10,2,122,M,50,8,3,99,-23,Severe
13,0,156,M,33,6,11,83,-73,Severe
9,6,114,F,22,6,3,75,-39,Severe
11,3,135,M,107,13,11,167,32,Well
7,10,94,F,103,13,6,162,68,Well
13,4,160,F,94,12,7,151,-9,Severe
8,0,96,M,68,10,0,120,24,Well
5,1,61,F,51,8,4,100,39,Well
11,3,135,F,73,10,6,126,-9,Severe
11,2,134,F,35,7,1,85,-49,Severe
10,11,131,F,50,8,3,99,-32,Severe
7,4,88,F,95,12,9,153,65,Well
13,3,159,M,53,8,6,102,-57,Severe
5,5,65,F,19,6,1,73,8,Well
12,0,144,F,109,14,1,169,25,Well
14,9,177,M,10,5,7,67,-110,Severe
9,3,111,M,101,13,4,160,49,Well
13,5,161,M,81,11,4,136,-25,Severe
7,2,86,F,32,6,10,82,-4,Mild
7,9,93,F,66,9,9,117,24,Well
16,9,201,F,11,5,8,68,-133,Severe
15,8,188,F,83,11,6,138,-50,Severe
5,10,70,F,38,7,4,88,18,Well
5,9,69,M,76,10,10,130,61,Well
6,3,75,F,102,13,6,162,87,Well
11,5,137,F,80,11,3,135,-2,Mild
10,10,130,M,18,6,1,73,-57,Severe
18,9,225,M,64,9,7,115,-110,Severe
12,5,149,M,72,10,4,124,-25,Severe
6,0,72,M,36,7,2,86,14,Well
9,11,119,M,69,10,1,121,2,Good
16,3,195,F,78,11,0,132,-63,Severe
7,11,95,M,17,6,0,72,-23,Severe
15,3,183,M,63,9,6,114,-69,Severe
17,10,214,F,33,6,11,83,-131,Severe
5,1,61,M,43,7,8,92,31,Well
17,9,213,F,97,12,11,155,-58,Severe
7,10,94,M,25,6,5,77,-17,Severe
9,4,112,F,22,6,3,75,-37,Severe
7,6,90,M,60,9,2,110,20,Well
15,9,189,F,25,6,5,77,-112,Severe
10,9,129,M,70,10,2,122,-7,Severe
6,3,75,M,29,6,8,80,5,Good
7,0,84,M,105,13,9,165,81,Well
10,6,126,F,31,6,9,81,-45,Severe
9,7,115,F,19,6,1,73,-42,Severe
14,10,178,F,72,10,4,124,-54,Severe
11,6,138,F,36,7,2,86,-52,Severe
5,8,68,M,98,13,0,156,88,Well
10,6,126,M,85,11,9,141,15,Well
8,3,99,F,81,11,4,136,37,Well
12,5,149,F,105,13,9,165,16,Well
11,8,140,M,68,10,0,120,-20,Severe
8,8,104,M,97,12,11,155,51,Well
7,5,89,M,71,10,3,123,34,Well
18,0,216,M,14,5,10,70,-146,Severe
18,11,227,M,28,6,8,80,-147,Severe
15,8,188,F,52,8,5,101,-87,Severe
8,9,105,M,47,8,0,96,-9,Severe
16,11,203,F,75,10,9,129,-74,Severe
15,2,182,M,81,11,4,136,-46,Severe
15,3,183,M,73,10,6,126,-57,Severe
12,8,152,F,75,10,9,129,-23,Severe
15,4,184,M,90,12,3,147,-37,Severe
9,9,117,M,60,9,2,110,-7,Severe
18,6,222,M,97,12,11,155,-67,Severe
15,0,180,M,55,8,8,104,-76,Severe
15,6,186,M,92,12,5,149,-37,Severe
6,5,77,F,52,8,5,101,24,Well
17,2,206,M,40,7,5,89,-117,Severe
5,1,61,F,73,10,6,126,65,Well
16,5,197,M,31,6,9,81,-116,Severe
6,3,75,F,19,6,1,73,-2,Mild
16,10,202,M,41,7,6,90,-112,Severe
18,0,216,F,98,13,0,156,-60,Severe
14,6,174,M,85,11,9,141,-33,Severe
17,3,207,F,12,5,9,69,-138,Severe
5,9,69,F,90,12,3,147,78,Well
11,8,140,M,110,14,3,171,31,Well
9,4,112,F,21,6,2,74,-38,Severe
13,1,157,M,97,12,11,155,-2,Mild
13,5,161,F,92,12,5,149,-12,Severe
15,2,182,M,91,12,4,148,-34,Severe
18,3,219,F,33,6,11,83,-136,Severe
8,8,104,M,86,11,10,142,38,Well
16,8,200,F,12,5,9,69,-131,Severe
18,9,225,F,49,8,2,98,-127,Severe
17,3,207,F,3,5,3,63,-144,Severe
16,11,203,F,104,13,7,163,-40,Severe
7,8,92,M,56,8,9,105,13,Well
7,3,87,M,74,10,7,127,40,Well
12,8,152,M,73,10,6,126,-26,Severe
15,9,189,F,8,5,6,66,-123,Severe
14,7,175,M,102,13,6,162,-13,Severe
8,8,104,F,41,7,6,90,-14,Severe
15,3,183,M,64,9,7,115,-68,Severe
9,1,109,M,106,13,10,166,57,Well
8,10,106,M,8,5,6,66,-40,Severe
13,4,160,M,79,11,1,133,-27,Severe
8,3,99,F,87,11,11,143,44,Well
11,1,133,F,25,6,5,77,-56,Severe
12,8,152,F,19,6,1,73,-79,Severe
12,0,144,F,49,8,2,98,-46,Severe
18,5,221,M,21,6,2,74,-147,Severe
6,4,76,F,17,6,0,72,-4,Mild
10,4,124,F,70,10,2,122,-2,Mild
14,10,178,M,83,11,6,138,-40,Severe
12,10,154,F,7,5,6,66,-88,Severe
8,3,99,F,17,6,0,72,-27,Severe
15,1,181,F,10,5,7,67,-114,Severe
5,3,63,M,85,11,9,141,78,Well
10,0,120,F,32,6,10,82,-38,Severe
6,6,78,M,85,11,9,141,63,Well
5,3,63,F,86,11,10,142,79,Well
16,9,201,F,101,13,4,160,-41,Severe
13,11,167,F,107,13,11,167,0,Neutral
7,9,93,M,80,11,3,135,42,Well
9,10,118,F,57,8,10,106,-12,Severe
9,11,119,M,56,8,9,105,-14,Severe
13,11,167,F,86,11,10,142,-25,Severe
7,10,94,M,35,7,1,85,-9,Severe
5,9,69,F,109,14,1,169,100,Well
11,3,135,F,98,13,0,156,21,Well
5,7,67,F,30,6,9,81,14,Well
11,11,143,F,75,10,9,129,-14,Severe
17,0,204,F,58,9,0,108,-96,Severe
18,11,227,M,2,5,3,63,-164,Severe
18,4,220,M,21,6,2,74,-146,Severe
9,2,110,M,68,10,0,120,10,Well
7,8,92,F,15,5,11,71,-21,Severe
11,7,139,M,11,5,8,68,-71,Severe
8,1,97,M,103,13,6,162,65,Well
17,3,207,F,8,5,6,66,-141,Severe
11,0,132,F,58,9,0,108,-24,Severe
18,11,227,F,41,7,6,90,-137,Severe
16,6,198,F,106,13,10,166,-32,Severe
13,3,159,F,61,9,3,111,-48,Severe
18,11,227,M,72,10,4,124,-103,Severe
10,4,124,F,76,10,10,130,6,Well
11,0,132,F,14,5,10,70,-62,Severe
12,1,145,F,108,14,0,168,23,Well
5,3,63,M,39,7,5,89,26,Well
6,1,73,M,47,8,0,96,23,Well
13,3,159,F,12,5,9,69,-90,Severe
18,1,217,F,94,12,7,151,-66,Severe
14,11,179,M,68,10,0,120,-59,Severe
7,3,87,M,75,10,9,129,42,Well
7,10,94,F,39,7,5,89,-5,Mild
18,3,219,M,98,13,0,156,-63,Severe
11,11,143,M,52,8,5,101,-42,Severe
7,10,94,M,7,5,6,66,-28,Severe
13,3,159,M,58,9,0,108,-51,Severe
15,6,186,F,101,13,4,160,-26,Severe
17,1,205,F,78,11,0,132,-73,Severe
17,0,204,M,24,6,5,77,-127,Severe
17,0,204,F,104,13,7,163,-41,Severe
8,7,103,F,77,10,11,131,28,Well
12,2,146,F,6,5,5,65,-81,Severe
13,4,160,F,75,10,9,129,-31,Severe
11,7,139,F,49,8,2,98,-41,Severe
10,5,125,F,104,13,7,163,38,Well
17,3,207,M,46,7,11,95,-112,Severe
6,5,77,F,25,6,5,77,0,Neutral
15,5,185,M,43,7,8,92,-93,Severe
5,1,61,F,11,5,8,68,7,Well
10,3,123,F,20,6,2,74,-49,Severe
6,4,76,M,62,9,4,112,36,Well
17,7,211,F,40,7,5,89,-122,Severe
14,10,178,M,53,8,6,102,-76,Severe
18,3,219,M,81,11,4,136,-83,Severe
13,8,164,F,65,9,8,116,-48,Severe
8,4,100,M,16,5,11,71,-29,Severe
13,7,163,F,21,6,2,74,-89,Severe
14,4,172,M,39,7,5,89,-83,Severe
16,0,192,F,53,8,6,102,-90,Severe
10,6,126,F,107,13,11,167,41,Well
10,10,130,F,89,12,1,145,15,Well
13,7,163,F,109,14,1,169,6,Well
13,3,159,M,63,9,6,114,-45,Severe
16,5,197,M,74,10,7,127,-70,Severe
18,9,225,F,6,5,5,65,-160,Severe
16,8,200,M,86,11,10,142,-58,Severe
10,8,128,M,6,5,5,65,-63,Severe
13,9,165,F,17,6,0,72,-93,Severe
10,0,120,M,106,13,10,166,46,Well
11,0,132,F,88,12,0,144,12,Well
18,10,226,F,59,9,1,109,-117,Severe
11,9,141,F,108,14,0,168,27,Well
9,6,114,M,88,12,0,144,30,Well
9,9,117,F,75,10,9,129,12,Well
5,5,65,F,103,13,6,162,97,Well
18,4,220,M,49,8,2,98,-122,Severe
7,3,87,F,84,11,7,139,52,Well
12,0,144,F,60,9,2,110,-34,Severe
18,2,218,M,84,11,7,139,-79,Severe
13,7,163,F,41,7,6,90,-73,Severe
14,7,175,M,29,6,8,80,-95,Severe
10,0,120,F,42,7,7,91,-29,Severe
6,7,79,M,88,12,0,144,65,Well
5,10,70,F,32,6,10,82,12,Well
6,0,72,M,52,8,5,101,29,Well
6,0,72,M,91,12,4,148,76,Well
17,5,209,M,34,7,0,84,-125,Severe
10,2,122,M,71,10,3,123,1,Good
9,1,109,M,31,6,9,81,-28,Severe
9,9,117,F,19,6,1,73,-44,Severe
15,3,183,M,35,7,1,85,-98,Severe
6,2,74,F,101,13,4,160,86,Well
13,1,157,M,75,10,9,129,-28,Severe
8,0,96,F,10,5,7,67,-29,Severe
8,10,106,M,16,5,11,71,-35,Severe
5,7,67,F,79,11,1,133,66,Well
6,3,75,F,41,7,6,90,15,Well
17,10,214,F,109,14,1,169,-45,Severe
14,7,175,M,51,8,4,100,-75,Severe
5,3,63,M,109,14,1,169,106,Well
18,5,221,F,16,5,11,71,-150,Severe
9,8,116,M,18,6,1,73,-43,Severe
17,8,212,M,58,9,0,108,-104,Severe
7,10,94,F,81,11,4,136,42,Well
5,0,60,M,32,6,10,82,22,Well
7,3,87,M,24,6,5,77,-10,Severe
13,2,158,M,40,7,5,89,-69,Severe
7,11,95,F,64,9,7,115,20,Well
15,3,183,F,92,12,5,149,-34,Severe
15,3,183,M,10,5,7,67,-116,Severe
9,7,115,M,43,7,8,92,-23,Severe
7,0,84,F,54,8,7,103,19,Well
16,3,195,M,73,10,6,126,-69,Severe
11,3,135,M,82,11,5,137,2,Good
8,1,97,F,92,12,5,149,52,Well
18,6,222,F,39,7,5,89,-133,Severe
5,1,61,M,91,12,4,148,87,Well
16,3,195,M,103,13,6,162,-33,Severe
15,3,183,M,12,5,9,69,-114,Severe
12,7,151,M,82,11,5,137,-14,Severe
10,0,120,M,36,7,2,86,-34,Severe
5,2,62,M,14,5,10,70,8,Well
6,6,78,F,94,12,7,151,73,Well
15,7,187,F,72,10,4,124,-63,Severe
18,3,219,F,19,6,1,73,-146,Severe
8,5,101,F,97,12,11,155,54,Well
17,11,215,M,32,6,10,82,-133,Severe
6,5,77,M,3,5,3,63,-14,Severe
17,5,209,F,68,10,0,120,-89,Severe
6,6,78,M,33,6,11,83,5,Good
18,6,222,F,94,12,7,151,-71,Severe
15,2,182,F,43,7,8,92,-90,Severe
8,10,106,M,105,13,9,165,59,Well
6,5,77,F,110,14,3,171,94,Well
7,9,93,F,11,5,8,68,-25,Severe
7,2,86,F,90,12,3,147,61,Well
16,0,192,F,102,13,6,162,-30,Severe
16,5,197,M,97,12,11,155,-42,Severe
12,7,151,M,49,8,2,98,-53,Severe
10,11,131,F,69,10,1,121,-10,Severe
17,3,207,M,56,8,9,105,-102,Severe
18,0,216,M,65,9,8,116,-100,Severe
17,7,211,M,55,8,8,104,-107,Severe
10,2,122,F,73,10,6,126,4,Good
18,3,219,M,25,6,5,77,-142,Severe
5,10,70,M,54,8,7,103,33,Well
7,11,95,F,53,8,6,102,7,Well
16,0,192,F,108,14,0,168,-24,Severe
17,8,212,M,52,8,5,101,-111,Severe
12,10,154,F,2,5,3,63,-91,Severe
10,11,131,F,13,5,9,69,-62,Severe
8,3,99,F,44,7,9,93,-6,Severe
10,4,124,F,5,5,5,65,-59,Severe
11,5,137,F,32,6,10,82,-55,Severe
8,2,98,M,76,10,10,130,32,Well
18,5,221,M,73,10,6,126,-95,Severe
13,10,166,F,107,13,11,167,1,Good
9,1,109,F,84,11,7,139,30,Well
6,8,80,M,24,6,5,77,-3,Mild
13,5,161,M,2,5,3,63,-98,Severe
14,4,172,F,91,12,4,148,-24,Severe
11,4,136,F,40,7,5,89,-47,Severe
9,1,109,F,5,5,5,65,-44,Severe
16,3,195,F,37,7,3,87,-108,Severe
12,3,147,M,79,11,1,133,-14,Severe
7,3,87,M,28,6,8,80,-7,Severe
9,6,114,F,94,12,7,151,37,Well
18,7,223,F,65,9,8,116,-107,Severe
14,3,171,F,61,9,3,111,-60,Severe
8,8,104,F,109,14,1,169,65,Well
16,9,201,M,12,5,9,69,-132,Severe
7,5,89,F,49,8,2,98,9,Well
9,3,111,F,60,9,2,110,-1,Mild
17,0,204,M,30,6,9,81,-123,Severe
5,9,69,M,23,6,4,76,7,Well
17,3,207,F,10,5,7,67,-140,Severe
13,1,157,M,4,5,4,64,-93,Severe
17,6,210,F,90,12,3,147,-63,Severe
12,4,148,M,40,7,5,89,-59,Severe
10,11,131,M,94,12,7,151,20,Well
13,6,162,M,33,6,11,83,-79,Severe
10,7,127,F,35,7,1,85,-42,Severe
13,11,167,M,75,10,9,129,-38,Severe
8,9,105,M,17,6,0,72,-33,Severe
11,10,142,F,43,7,8,92,-50,Severe
7,2,86,F,109,14,1,169,83,Well
11,9,141,M,12,5,9,69,-72,Severe
12,5,149,F,23,6,4,76,-73,Severe
18,10,226,M,26,6,6,78,-148,Severe
9,9,117,F,78,11,0,132,15,Well
9,8,116,F,93,12,6,150,34,Well
9,10,118,F,83,11,6,138,20,Well
15,11,191,F,14,5,10,70,-121,Severe
17,2,206,F,63,9,6,114,-92,Severe
14,11,179,F,66,9,9,117,-62,Severe
18,6,222,M,48,8,1,97,-125,Severe
12,10,154,F,48,8,1,97,-57,Severe
15,1,181,M,45,7,10,94,-87,Severe
8,11,107,M,97,12,11,155,48,Well
13,7,163,F,58,9,0,108,-55,Severe
9,1,109,M,35,7,1,85,-24,Severe
5,2,62,M,7,5,6,66,4,Good
13,9,165,M,44,7,9,93,-72,Severe
12,7,151,F,78,11,0,132,-19,Severe
9,2,110,M,74,10,7,127,17,Well
11,0,132,F,70,10,2,122,-10,Severe
16,1,193,M,88,12,0,144,-49,Severe
12,1,145,F,93,12,6,150,5,Good
8,2,98,M,54,8,7,103,5,Good
13,9,165,F,105,13,9,165,0,Neutral
11,11,143,F,99,13,1,157,14,Well
12,6,150,F,15,5,11,71,-79,Severe
13,3,159,M,51,8,4,100,-59,Severe
9,2,110,M,52,8,5,101,-9,Severe
8,4,100,M,52,8,5,101,1,Good
6,6,78,F,14,5,10,70,-8,Severe
18,0,216,F,38,7,4,88,-128,Severe
6,11,83,M,34,7,0,84,1,Good
5,3,63,F,97,12,11,155,92,Well
11,9,141,F,69,10,1,121,-20,Severe
12,1,145,F,97,12,11,155,10,Well
15,11,191,M,41,7,6,90,-101,Severe
13,3,159,M,93,12,6,150,-9,Severe
7,4,88,M,96,12,10,154,66,Well
15,6,186,F,69,10,1,121,-65,Severe
9,0,108,F,5,5,5,65,-43,Severe
14,1,169,M,81,11,4,136,-33,Severe
5,0,60,F,15,5,11,71,11,Well
7,1,85,F,34,7,0,84,-1,Mild
8,11,107,F,19,6,1,73,-34,Severe
10,0,120,F,25,6,5,77,-43,Severe
10,9,129,M,103,13,6,162,33,Well
16,6,198,F,100,13,3,159,-39,Severe
14,9,177,M,61,9,3,111,-66,Severe
5,0,60,F,53,8,6,102,42,Well
7,7,91,M,69,10,1,121,30,Well
10,0,120,M,87,11,11,143,23,Well
9,4,112,M,89,12,1,145,33,Well
5,9,69,M,73,10,6,126,57,Well
5,5,65,F,92,12,5,149,84,Well
12,3,147,F,52,8,5,101,-46,Severe
5,11,71,F,81,11,4,136,65,Well
10,8,128,F,59,9,1,109,-19,Severe
16,10,202,F,19,6,1,73,-129,Severe
6,8,80,M,6,5,5,65,-15,Severe
14,9,177,F,4,5,4,64,-113,Severe
14,8,176,M,37,7,3,87,-89,Severe
10,3,123,F,72,10,4,124,1,Good
10,0,120,M,24,6,5,77,-43,Severe
8,3,99,M,84,11,7,139,40,Well
15,6,186,M,107,13,11,167,-19,Severe
11,2,134,M,36,7,2,86,-48,Severe
15,1,181,M,85,11,9,141,-40,Severe
14,0,168,F,54,8,7,103,-65,Severe
16,3,195,F,52,8,5,101,-94,Severe
15,3,183,F,50,8,3,99,-84,Severe
15,3,183,F,13,5,9,69,-114,Severe
16,4,196,F,20,6,2,74,-122,Severe
9,5,113,M,48,8,1,97,-16,Severe
14,8,176,M,12,5,9,69,-107,Severe
15,5,185,M,107,13,11,167,-18,Severe
14,11,179,F,7,5,6,66,-113,Severe
8,4,100,F,76,10,10,130,30,Well
16,0,192,M,54,8,7,103,-89,Severe
7,1,85,M,27,6,7,79,-6,Severe
9,7,115,F,86,11,10,142,27,Well
18,8,224,M,9,5,7,67,-157,Severe
7,10,94,M,76,10,10,130,36,Well
15,6,186,M,80,11,3,135,-51,Severe
16,2,194,F,57,8,10,106,-88,Severe
14,10,178,F,53,8,6,102,-76,Severe
16,5,197,F,22,6,3,75,-122,Severe
16,4,196,F,110,14,3,171,-25,Severe
13,3,159,F,109,14,1,169,10,Well
9,2,110,F,101,13,4,160,50,Well
11,3,135,M,76,10,10,130,-5,Mild
10,10,130,F,69,10,1,121,-9,Severe
12,9,153,F,65,9,8,116,-37,Severe
13,3,159,M,47,8,0,96,-63,Severe
13,6,162,F,55,8,8,104,-58,Severe
8,3,99,M,54,8,7,103,4,Good
5,8,68,F,44,7,9,93,25,Well
7,2,86,F,73,10,6,126,40,Well
5,8,68,F,37,7,3,87,19,Well
8,5,101,F,60,9,2,110,9,Well
13,9,165,F,20,6,2,74,-91,Severe
6,3,75,F,97,12,11,155,80,Well
10,1,121,F,59,9,1,109,-12,Severe
13,3,159,M,17,6,0,72,-87,Severe
14,11,179,F,88,12,0,144,-35,Severe
15,4,184,F,91,12,4,148,-36,Severe
12,8,152,M,20,6,2,74,-78,Severe
18,4,220,M,97,12,11,155,-65,Severe
16,2,194,F,12,5,9,69,-125,Severe
5,7,67,F,95,12,9,153,86,Well
9,3,111,M,54,8,7,103,-8,Severe
14,0,168,M,108,14,0,168,0,Neutral
15,2,182,F,38,7,4,88,-94,Severe
13,8,164,M,40,7,5,89,-75,Severe
11,10,142,M,68,10,0,120,-22,Severe
12,1,145,F,76,10,10,130,-15,Severe
16,5,197,M,51,8,4,100,-97,Severe
16,4,196,F,76,10,10,130,-66,Severe
6,6,78,F,24,6,5,77,-1,Mild
7,10,94,M,41,7,6,90,-4,Mild
13,4,160,M,10,5,7,67,-93,Severe
14,4,172,M,20,6,2,74,-98,Severe
15,2,182,F,108,14,0,168,-14,Severe
10,8,128,F,5,5,5,65,-63,Severe
10,3,123,F,66,9,9,117,-6,Severe
13,0,156,M,19,6,1,73,-83,Severe
13,4,160,F,35,7,1,85,-75,Severe
12,3,147,F,48,8,1,97,-50,Severe
10,1,121,F,5,5,5,65,-56,Severe
11,0,132,M,56,8,9,105,-27,Severe
10,5,125,M,22,6,3,75,-50,Severe
7,3,87,F,78,11,0,132,45,Well
7,7,91,F,99,13,1,157,66,Well
16,2,194,M,5,5,5,65,-129,Severe
14,4,172,M,41,7,6,90,-82,Severe
16,3,195,M,45,7,10,94,-101,Severe
17,5,209,F,93,12,6,150,-59,Severe
13,7,163,M,92,12,5,149,-14,Severe
13,4,160,F,107,13,11,167,7,Well
16,3,195,M,90,12,3,147,-48,Severe
13,3,159,F,93,12,6,150,-9,Severe
5,3,63,M,33,6,11,83,20,Well
11,3,135,F,42,7,7,91,-44,Severe
6,9,81,M,95,12,9,153,72,Well
14,0,168,M,89,12,1,145,-23,Severe
14,9,177,M,50,8,3,99,-78,Severe
8,2,98,F,14,5,10,70,-28,Severe
7,4,88,M,75,10,9,129,41,Well
11,7,139,M,22,6,3,75,-64,Severe
9,3,111,F,44,7,9,93,-18,Severe
17,11,215,M,20,6,2,74,-141,Severe
9,6,114,M,107,13,11,167,53,Well
17,7,211,F,15,5,11,71,-140,Severe
13,9,165,M,10,5,7,67,-98,Severe
6,2,74,F,94,12,7,151,77,Well
14,3,171,F,10,5,7,67,-104,Severe
15,3,183,M,89,12,1,145,-38,Severe
14,1,169,M,52,8,5,101,-68,Severe
16,7,199,M,31,6,9,81,-118,Severe
18,3,219,M,46,7,11,95,-124,Severe
14,1,169,M,2,5,3,63,-106,Severe
17,5,209,F,46,7,11,95,-114,Severe
18,6,222,M,90,12,3,147,-75,Severe
15,4,184,F,56,8,9,105,-79,Severe
8,0,96,M,54,8,7,103,7,Well
7,8,92,M,107,13,11,167,75,Well
14,3,171,F,21,6,2,74,-97,Severe
14,3,171,F,74,10,7,127,-44,Severe
13,10,166,M,73,10,6,126,-40,Severe
13,11,167,F,102,13,6,162,-5,Mild
5,2,62,F,63,9,6,114,52,Well
17,9,213,M,26,6,6,78,-135,Severe
17,7,211,M,86,11,10,142,-69,Severe
15,0,180,M,12,5,9,69,-111,Severe
9,1,109,M,49,8,2,98,-11,Severe
14,1,169,F,15,5,11,71,-98,Severe
6,2,74,M,103,13,6,162,88,Well
16,0,192,M,26,6,6,78,-114,Severe
5,7,67,M,51,8,4,100,33,Well
12,4,148,M,6,5,5,65,-83,Severe
8,8,104,F,66,9,9,117,13,Well
16,3,195,M,84,11,7,139,-56,Severe
15,4,184,M,96,12,10,154,-30,Severe
11,8,140,F,79,11,1,133,-7,Severe
11,2,134,M,61,9,3,111,-23,Severe
11,7,139,M,65,9,8,116,-23,Severe
7,3,87,M,104,13,7,163,76,Well
13,3,159,F,7,5,6,66,-93,Severe
10,3,123,F,45,7,10,94,-29,Severe
9,2,110,F,20,6,2,74,-36,Severe
6,4,76,M,38,7,4,88,12,Well
5,11,71,F,90,12,3,147,76,Well
10,2,122,M,93,12,6,150,28,Well
12,10,154,M,64,9,7,115,-39,Severe
8,5,101,F,40,7,5,89,-12,Severe
11,8,140,M,34,7,0,84,-56,Severe
18,0,216,M,66,9,9,117,-99,Severe
8,6,102,M,99,13,1,157,55,Well
12,0,144,F,28,6,8,80,-64,Severe
18,10,226,M,78,11,0,132,-94,Severe
5,1,61,F,93,12,6,150,89,Well
15,0,180,F,3,5,3,63,-117,Severe
10,9,129,M,10,5,7,67,-62,Severe
12,5,149,F,94,12,7,151,2,Good
6,4,76,M,4,5,4,64,-12,Severe
12,8,152,F,68,10,0,120,-32,Severe
5,11,71,F,4,5,4,64,-7,Severe
5,3,63,F,98,13,0,156,93,Well
17,3,207,F,21,6,2,74,-133,Severe
5,6,66,M,20,6,2,74,8,Well
15,3,183,F,48,8,1,97,-86,Severe
17,11,215,M,8,5,6,66,-149,Severe
7,9,93,M,66,9,9,117,24,Well
17,9,213,F,81,11,4,136,-77,Severe
12,7,151,M,99,13,1,157,6,Well
17,7,211,F,13,5,9,69,-142,Severe
8,9,105,M,4,5,4,64,-41,Severe
5,3,63,F,72,10,4,124,61,Well
12,4,148,F,75,10,9,129,-19,Severe
6,7,79,M,2,5,3,63,-16,Severe
15,3,183,F,101,13,4,160,-23,Severe
13,3,159,F,45,7,10,94,-65,Severe
8,11,107,M,90,12,3,147,40,Well
13,6,162,M,60,9,2,110,-52,Severe
5,7,67,M,70,10,2,122,55,Well
12,9,153,F,48,8,1,97,-56,Severe
8,6,102,F,5,5,5,65,-37,Severe
12,9,153,F,105,13,9,165,12,Well
16,0,192,F,6,5,5,65,-127,Severe
8,9,105,M,19,6,1,73,-32,Severe
16,5,197,M,58,9,0,108,-89,Severe
18,10,226,F,6,5,5,65,-161,Severe
9,11,119,F,58,9,0,108,-11,Severe
11,11,143,F,24,6,5,77,-66,Severe
6,5,77,F,29,6,8,80,3,Good
14,2,170,F,94,12,7,151,-19,Severe
5,1,61,F,27,6,7,79,18,Well
7,3,87,F,69,10,1,121,34,Well
11,7,139,F,26,6,6,78,-61,Severe
10,11,131,M,92,12,5,149,18,Well
13,5,161,F,71,10,3,123,-38,Severe
12,7,151,M,5,5,5,65,-86,Severe
17,11,215,M,76,10,10,130,-85,Severe
12,3,147,M,61,9,3,111,-36,Severe
16,8,200,F,44,7,9,93,-107,Severe
9,0,108,M,37,7,3,87,-21,Severe
13,0,156,M,81,11,4,136,-20,Severe
10,5,125,F,79,11,1,133,8,Well
18,6,222,F,62,9,4,112,-110,Severe
16,11,203,F,74,10,7,127,-76,Severe
16,3,195,F,27,6,7,79,-116,Severe
15,6,186,M,43,7,8,92,-94,Severe
9,6,114,M,45,7,10,94,-20,Severe
13,1,157,M,19,6,1,73,-84,Severe
15,8,188,F,91,12,4,148,-40,Severe
18,6,222,F,60,9,2,110,-112,Severe
6,2,74,F,80,11,3,135,61,Well
5,5,65,M,100,13,3,159,94,Well
11,2,134,F,20,6,2,74,-60,Severe
15,5,185,F,12,5,9,69,-116,Severe
5,1,61,M,2,5,3,63,2,Good
5,9,69,M,11,5,8,68,-1,Mild
18,1,217,F,11,5,8,68,-149,Severe
11,3,135,F,90,12,3,147,12,Well
7,11,95,F,110,14,3,171,76,Well
12,11,155,M,79,11,1,133,-22,Severe
7,11,95,M,16,5,11,71,-24,Severe
11,1,133,F,95,12,9,153,20,Well
17,5,209,F,54,8,7,103,-106,Severe
9,0,108,M,36,7,2,86,-22,Severe
16,10,202,F,75,10,9,129,-73,Severe
5,4,64,M,22,6,3,75,11,Well
6,1,73,F,41,7,6,90,17,Well
15,3,183,M,109,14,1,169,-14,Severe
10,6,126,M,23,6,4,76,-50,Severe
13,4,160,M,65,9,8,116,-44,Severe
14,7,175,F,30,6,9,81,-94,Severe
11,8,140,F,62,9,4,112,-28,Severe
14,0,168,F,11,5,8,68,-100,Severe
13,5,161,M,107,13,11,167,6,Well
12,4,148,F,88,12,0,144,-4,Mild
15,3,183,F,15,5,11,71,-112,Severe
17,6,210,F,61,9,3,111,-99,Severe
5,7,67,F,61,9,3,111,44,Well
8,6,102,F,44,7,9,93,-9,Severe
13,7,163,M,48,8,1,97,-66,Severe
9,9,117,M,45,7,10,94,-23,Severe
18,3,219,F,91,12,4,148,-71,Severe
6,0,72,F,108,14,0,168,96,Well
11,3,135,F,67,9,10,118,-17,Severe
10,8,128,F,4,5,4,64,-64,Severe
15,9,189,F,14,5,10,70,-119,Severe
5,5,65,F,109,14,1,169,104,Well
6,5,77,M,9,5,7,67,-10,Severe
12,0,144,M,10,5,7,67,-77,Severe
8,5,101,M,28,6,8,80,-21,Severe
10,8,128,M,97,12,11,155,27,Well
8,10,106,F,89,12,1,145,39,Well
12,2,146,M,84,11,7,139,-7,Severe
16,0,192,F,8,5,6,66,-126,Severe
8,2,98,M,59,9,1,109,11,Well
7,9,93,F,81,11,4,136,43,Well
15,1,181,M,15,5,11,71,-110,Severe
8,5,101,M,70,10,2,122,21,Well
11,2,134,F,48,8,1,97,-37,Severe
15,8,188,F,55,8,8,104,-84,Severe
14,11,179,F,37,7,3,87,-92,Severe
16,6,198,M,66,9,9,117,-81,Severe
16,2,194,M,10,5,7,67,-127,Severe
11,3,135,M,74,10,7,127,-8,Severe
17,5,209,M,18,6,1,73,-136,Severe
17,9,213,F,90,12,3,147,-66,Severe
15,7,187,F,12,5,9,69,-118,Severe
12,2,146,F,62,9,4,112,-34,Severe
8,6,102,M,20,6,2,74,-28,Severe
9,1,109,F,68,10,0,120,11,Well
13,5,161,M,48,8,1,97,-64,Severe
12,9,153,M,108,14,0,168,15,Well
8,3,99,F,47,8,0,96,-3,Mild
17,5,209,F,23,6,4,76,-133,Severe
9,3,111,M,27,6,7,79,-32,Severe
15,9,189,F,46,7,11,95,-94,Severe
11,6,138,F,98,13,0,156,18,Well
12,0,144,F,46,7,11,95,-49,Severe
13,7,163,M,14,5,10,70,-93,Severe
13,11,167,M,96,12,10,154,-13,Severe
18,8,224,M,64,9,7,115,-109,Severe
10,3,123,M,96,12,10,154,31,Well
5,0,60,F,46,7,11,95,35,Well
12,3,147,F,102,13,6,162,15,Well
16,6,198,M,41,7,6,90,-108,Severe
16,7,199,F,58,9,0,108,-91,Severe
10,4,124,M,10,5,7,67,-57,Severe
8,8,104,F,53,8,6,102,-2,Mild
17,5,209,M,94,12,7,151,-58,Severe
11,3,135,F,6,5,5,65,-70,Severe
12,8,152,M,9,5,7,67,-85,Severe
10,3,123,F,59,9,1,109,-14,Severe
14,0,168,F,86,11,10,142,-26,Severe
14,7,175,M,45,7,10,94,-81,Severe
11,10,142,M,86,11,10,142,0,Neutral
10,11,131,F,42,7,7,91,-40,Severe
15,4,184,F,39,7,5,89,-95,Severe
16,4,196,M,26,6,6,78,-118,Severe
18,1,217,F,72,10,4,124,-93,Severe
6,7,79,M,45,7,10,94,15,Well
18,3,219,M,74,10,7,127,-92,Severe
10,1,121,M,62,9,4,112,-9,Severe
17,10,214,F,102,13,6,162,-52,Severe
18,3,219,M,102,13,6,162,-57,Severe
11,1,133,M,44,7,9,93,-40,Severe
16,7,199,M,65,9,8,116,-83,Severe
17,7,211,F,47,8,0,96,-115,Severe
11,0,132,F,65,9,8,116,-16,Severe
5,9,69,M,62,9,4,112,43,Well
14,2,170,F,25,6,5,77,-93,Severe
12,3,147,M,109,14,1,169,22,Well
12,4,148,F,51,8,4,100,-48,Severe
15,0,180,F,77,10,11,131,-49,Severe
11,6,138,F,47,8,0,96,-42,Severe
17,3,207,M,52,8,5,101,-106,Severe
13,8,164,F,35,7,1,85,-79,Severe
6,0,72,M,2,5,3,63,-9,Severe
6,11,83,M,91,12,4,148,65,Well
7,10,94,F,92,12,5,149,55,Well
17,5,209,M,91,12,4,148,-61,Severe
15,11,191,F,87,11,11,143,-48,Severe
15,10,190,F,11,5,8,68,-122,Severe
14,2,170,M,75,10,9,129,-41,Severe
15,10,190,M,59,9,1,109,-81,Severe
11,11,143,F,13,5,9,69,-74,Severe
10,0,120,M,75,10,9,129,9,Well
8,4,100,M,49,8,2,98,-2,Mild
11,1,133,M,52,8,5,101,-32,Severe
15,8,188,F,63,9,6,114,-74,Severe
15,0,180,M,107,13,11,167,-13,Severe
9,6,114,F,30,6,9,81,-33,Severe
12,8,152,F,108,14,0,168,16,Well
16,3,195,M,101,13,4,160,-35,Severe
10,2,122,M,67,9,10,118,-4,Mild
7,10,94,F,49,8,2,98,4,Good
9,10,118,F,28,6,8,80,-38,Severe
6,8,80,F,21,6,2,74,-6,Severe
11,2,134,M,15,5,11,71,-63,Severe
12,8,152,M,52,8,5,101,-51,Severe
6,10,82,F,85,11,9,141,59,Well
6,0,72,F,3,5,3,63,-9,Severe
14,3,171,M,37,7,3,87,-84,Severe
5,0,60,M,94,12,7,151,91,Well
11,3,135,M,80,11,3,135,0,Neutral
15,0,180,F,89,12,1,145,-35,Severe
17,2,206,M,101,13,4,160,-46,Severe
7,4,88,F,56,8,9,105,17,Well
10,5,125,M,43,7,8,92,-33,Severe
9,6,114,M,60,9,2,110,-4,Mild
9,9,117,M,75,10,9,129,12,Well
15,6,186,M,56,8,9,105,-81,Severe
17,7,211,M,73,10,6,126,-85,Severe
14,5,173,F,4,5,4,64,-109,Severe
11,9,141,M,8,5,6,66,-75,Severe
11,6,138,F,108,14,0,168,30,Well
14,10,178,M,90,12,3,147,-31,Severe
14,2,170,F,98,13,0,156,-14,Severe
17,3,207,M,69,10,1,121,-86,Severe
17,8,212,F,49,8,2,98,-114,Severe
10,8,128,F,47,8,0,96,-32,Severe
12,6,150,M,40,7,5,89,-61,Severe
13,5,161,M,37,7,3,87,-74,Severe
11,5,137,F,31,6,9,81,-56,Severe
12,4,148,M,84,11,7,139,-9,Severe
11,5,137,F,79,11,1,133,-4,Mild
13,8,164,F,58,9,0,108,-56,Severe
7,4,88,M,56,8,9,105,17,Well
10,7,127,M,95,12,9,153,26,Well
12,11,155,F,33,6,11,83,-72,Severe
13,5,161,F,105,13,9,165,4,Good
5,4,64,F,89,12,1,145,81,Well
11,3,135,M,74,10,7,127,-8,Severe
15,5,185,F,32,6,10,82,-103,Severe
12,2,146,M,21,6,2,74,-72,Severe
17,3,207,M,55,8,8,104,-103,Severe
10,11,131,M,58,9,0,108,-23,Severe
16,3,195,M,100,13,3,159,-36,Severe
12,1,145,F,33,6,11,83,-62,Severe
13,7,163,M,9,5,7,67,-96,Severe
17,9,213,F,55,8,8,104,-109,Severe
5,0,60,M,89,12,1,145,85,Well
10,0,120,F,76,10,10,130,10,Well
16,6,198,M,49,8,2,98,-100,Severe
10,3,123,M,79,11,1,133,10,Well
10,2,122,F,108,14,0,168,46,Well
6,9,81,M,12,5,9,69,-12,Severe
6,5,77,M,61,9,3,111,34,Well
17,7,211,M,38,7,4,88,-123,Severe
16,2,194,F,65,9,8,116,-78,Severe
17,8,212,F,45,7,10,94,-118,Severe
17,0,204,M,13,5,9,69,-135,Severe
18,3,219,M,67,9,10,118,-101,Severe
13,8,164,M,2,5,3,63,-101,Severe
16,2,194,F,86,11,10,142,-52,Severe
5,8,68,M,16,5,11,71,3,Good
17,5,209,F,81,11,4,136,-73,Severe
7,10,94,F,61,9,3,111,17,Well
5,0,60,F,62,9,4,112,52,Well
6,3,75,M,17,6,0,72,-3,Mild
14,4,172,M,86,11,10,142,-30,Severe
11,10,142,F,98,13,0,156,14,Well
11,5,137,M,32,6,10,82,-55,Severe
14,9,177,F,71,10,3,123,-54,Severe
13,3,159,M,106,13,10,166,7,Well
18,7,223,M,64,9,7,115,-108,Severe
18,2,218,F,13,5,9,69,-149,Severe
18,7,223,M,61,9,3,111,-112,Severe
6,0,72,M,11,5,8,68,-4,Mild
10,4,124,F,36,7,2,86,-38,Severe
18,9,225,F,60,9,2,110,-115,Severe
18,1,217,M,27,6,7,79,-138,Severe
9,4,112,F,99,13,1,157,45,Well
8,4,100,M,108,14,0,168,68,Well
12,3,147,F,86,11,10,142,-5,Mild
16,10,202,F,73,10,6,126,-76,Severe
18,4,220,M,98,13,0,156,-64,Severe
12,5,149,F,90,12,3,147,-2,Mild
16,2,194,F,97,12,11,155,-39,Severe
8,3,99,F,82,11,5,137,38,Well
12,6,150,F,107,13,11,167,17,Well
18,0,216,F,105,13,9,165,-51,Severe
17,9,213,M,88,12,0,144,-69,Severe
6,11,83,M,49,8,2,98,15,Well
11,3,135,F,34,7,0,84,-51,Severe
16,11,203,M,21,6,2,74,-129,Severe
8,11,107,F,93,12,6,150,43,Well
5,11,71,F,2,5,3,63,-8,Severe
16,3,195,F,56,8,9,105,-90,Severe
17,5,209,M,9,5,7,67,-142,Severe
9,11,119,F,36,7,2,86,-33,Severe
14,3,171,M,92,12,5,149,-22,Severe
5,0,60,F,66,9,9,117,57,Well
7,9,93,F,56,8,9,105,12,Well
6,3,75,F,78,11,0,132,57,Well
10,3,123,F,60,9,2,110,-13,Severe
17,9,213,M,31,6,9,81,-132,Severe
8,3,99,F,84,11,7,139,40,Well
15,9,189,M,32,6,10,82,-107,Severe
7,11,95,M,80,11,3,135,40,Well
11,3,135,F,11,5,8,68,-67,Severe
6,6,78,M,34,7,0,84,6,Well
10,3,123,M,23,6,4,76,-47,Severe
12,1,145,M,17,6,0,72,-73,Severe
12,7,151,M,55,8,8,104,-47,Severe
6,8,80,F,48,8,1,97,17,Well
6,8,80,F,63,9,6,114,34,Well
7,3,87,F,45,7,10,94,7,Well
5,2,62,F,87,11,11,143,81,Well
18,8,224,M,20,6,2,74,-150,Severe
14,7,175,F,88,12,0,144,-31,Severe
14,3,171,M,41,7,6,90,-81,Severe
16,9,201,F,38,7,4,88,-113,Severe
15,10,190,F,93,12,6,150,-40,Severe
14,11,179,F,99,13,1,157,-22,Severe
13,5,161,F,44,7,9,93,-68,Severe
5,8,68,M,45,7,10,94,26,Well
8,11,107,F,22,6,3,75,-32,Severe
13,6,162,M,2,5,3,63,-99,Severe
12,8,152,F,45,7,10,94,-58,Severe
8,3,99,M,47,8,0,96,-3,Mild
13,8,164,F,31,6,9,81,-83,Severe
9,3,111,M,88,12,0,144,33,Well
16,5,197,F,92,12,5,149,-48,Severe
14,4,172,M,108,14,0,168,-4,Mild
6,8,80,M,93,12,6,150,70,Well
10,10,130,F,86,11,10,142,12,Well
16,3,195,M,106,13,10,166,-29,Severe
6,9,81,F,70,10,2,122,41,Well
15,9,189,F,101,13,4,160,-29,Severe
9,11,119,M,98,13,0,156,37,Well
6,3,75,M,13,5,9,69,-6,Severe
12,4,148,M,86,11,10,142,-6,Severe
16,3,195,F,69,10,1,121,-74,Severe
6,5,77,M,20,6,2,74,-3,Mild
13,11,167,M,87,11,11,143,-24,Severe
15,0,180,M,106,13,10,166,-14,Severe
8,0,96,M,16,5,11,71,-25,Severe
9,6,114,F,20,6,2,74,-40,Severe
11,8,140,F,86,11,10,142,2,Good
10,8,128,M,34,7,0,84,-44,Severe
8,9,105,F,96,12,10,154,49,Well
8,5,101,M,81,11,4,136,35,Well
16,7,199,F,13,5,9,69,-130,Severe
12,4,148,M,29,6,8,80,-68,Severe
17,3,207,M,32,6,10,82,-125,Severe
11,7,139,F,37,7,3,87,-52,Severe
10,2,122,M,21,6,2,74,-48,Severe
11,1,133,F,97,12,11,155,22,Well
9,6,114,M,8,5,6,66,-48,Severe
18,6,222,F,51,8,4,100,-122,Severe
13,3,159,M,11,5,8,68,-91,Severe
16,1,193,F,78,11,0,132,-61,Severe
5,3,63,F,108,14,0,168,105,Well
8,8,104,F,69,10,1,121,17,Well
6,3,75,F,30,6,9,81,6,Well
11,2,134,M,34,7,0,84,-50,Severe
6,4,76,F,71,10,3,123,47,Well
18,8,224,M,33,6,11,83,-141,Severe
17,7,211,M,98,13,0,156,-55,Severe
18,10,226,M,92,12,5,149,-77,Severe
18,5,221,M,22,6,3,75,-146,Severe
11,9,141,M,45,7,10,94,-47,Severe
17,2,206,M,110,14,3,171,-35,Severe
9,4,112,F,23,6,4,76,-36,Severe
17,5,209,M,85,11,9,141,-68,Severe
17,7,211,F,6,5,5,65,-146,Severe
15,11,191,F,41,7,6,90,-101,Severe
7,3,87,M,104,13,7,163,76,Well
15,7,187,F,104,13,7,163,-24,Severe
17,3,207,M,2,5,3,63,-144,Severe
5,11,71,M,14,5,10,70,-1,Mild
17,8,212,F,48,8,1,97,-115,Severe
5,9,69,M,80,11,3,135,66,Well
15,11,191,F,96,12,10,154,-37,Severe
9,5,113,M,105,13,9,165,52,Well
8,3,99,F,49,8,2,98,-1,Mild
15,4,184,F,36,7,2,86,-98,Severe
17,11,215,F,17,6,0,72,-143,Severe
17,7,211,M,31,6,9,81,-130,Severe
16,6,198,F,105,13,9,165,-33,Severe
14,9,177,M,45,7,10,94,-83,Severe
8,2,98,M,11,5,8,68,-30,Severe
14,5,173,F,30,6,9,81,-92,Severe
8,7,103,F,6,5,5,65,-38,Severe
10,6,126,F,80,11,3,135,9,Well
8,3,99,M,10,5,7,67,-32,Severe
14,8,176,F,81,11,4,136,-40,Severe
18,6,222,M,100,13,3,159,-63,Severe
12,4,148,M,8,5,6,66,-82,Severe
16,0,192,M,74,10,7,127,-65,Severe
12,3,147,M,72,10,4,124,-23,Severe
17,3,207,M,52,8,5,101,-106,Severe
7,8,92,F,104,13,7,163,71,Well
13,11,167,F,45,7,10,94,-73,Severe
16,3,195,F,86,11,10,142,-53,Severe
6,7,79,F,88,12,0,144,65,Well
18,11,227,M,59,9,1,109,-118,Severe
8,1,97,M,68,10,0,120,23,Well
5,2,62,F,99,13,1,157,95,Well
15,10,190,M,23,6,4,76,-114,Severe
9,4,112,M,25,6,5,77,-35,Severe
10,8,128,F,2,5,3,63,-65,Severe
14,7,175,M,24,6,5,77,-98,Severe
15,2,182,F,98,13,0,156,-26,Severe
11,10,142,F,29,6,8,80,-62,Severe
14,8,176,F,104,13,7,163,-13,Severe
9,3,111,M,82,11,5,137,26,Well
13,9,165,M,2,5,3,63,-102,Severe
5,3,63,F,46,7,11,95,32,Well
18,9,225,F,76,10,10,130,-95,Severe
17,1,205,M,6,5,5,65,-140,Severe
12,8,152,M,2,5,3,63,-89,Severe
14,6,174,M,19,6,1,73,-101,Severe
6,3,75,M,23,6,4,76,1,Good
5,4,64,M,6,5,5,65,1,Good
17,0,204,F,46,7,11,95,-109,Severe
15,7,187,M,105,13,9,165,-22,Severe
13,8,164,M,74,10,7,127,-37,Severe
15,8,188,F,76,10,10,130,-58,Severe
9,0,108,F,47,8,0,96,-12,Severe
9,9,117,M,42,7,7,91,-26,Severe
10,3,123,F,107,13,11,167,44,Well
17,8,212,F,8,5,6,66,-146,Severe
9,3,111,F,50,8,3,99,-12,Severe
12,6,150,M,73,10,6,126,-24,Severe
7,9,93,F,40,7,5,89,-4,Mild
18,2,218,F,104,13,7,163,-55,Severe
15,1,181,M,26,6,6,78,-103,Severe
11,3,135,M,42,7,7,91,-44,Severe
14,7,175,M,81,11,4,136,-39,Severe
11,0,132,M,12,5,9,69,-63,Severe
11,4,136,M,99,13,1,157,21,Well
16,2,194,F,44,7,9,93,-101,Severe
12,6,150,F,94,12,7,151,1,Good
15,3,183,F,96,12,10,154,-29,Severe
18,2,218,M,51,8,4,100,-118,Severe
7,4,88,M,83,11,6,138,50,Well
7,9,93,F,64,9,7,115,22,Well
10,7,127,F,106,13,10,166,39,Well
14,7,175,F,100,13,3,159,-16,Severe
10,11,131,M,95,12,9,153,22,Well
8,1,97,M,60,9,2,110,13,Well
15,1,181,F,22,6,3,75,-106,Severe
13,3,159,M,56,8,9,105,-54,Severe
10,3,123,F,35,7,1,85,-38,Severe
11,0,132,F,84,11,7,139,7,Well
13,6,162,F,92,12,5,149,-13,Severe
17,3,207,F,36,7,2,86,-121,Severe
8,0,96,F,98,13,0,156,60,Well
6,10,82,M,6,5,5,65,-17,Severe
10,4,124,M,37,7,3,87,-37,Severe
13,7,163,F,42,7,7,91,-72,Severe
7,8,92,M,50,8,3,99,7,Well
9,8,116,M,2,5,3,63,-53,Severe
9,5,113,F,11,5,8,68,-45,Severe
14,7,175,M,26,6,6,78,-97,Severe
17,2,206,M,25,6,5,77,-129,Severe
10,1,121,F,46,7,11,95,-26,Severe
10,11,131,M,106,13,10,166,35,Well
18,0,216,F,81,11,4,136,-80,Severe
7,0,84,M,8,5,6,66,-18,Severe
14,3,171,F,64,9,7,115,-56,Severe
16,4,196,M,77,10,11,131,-65,Severe
11,9,141,M,19,6,1,73,-68,Severe
10,5,125,M,5,5,5,65,-60,Severe
15,3,183,F,66,9,9,117,-66,Severe
17,0,204,M,109,14,1,169,-35,Severe
14,1,169,M,103,13,6,162,-7,Severe
15,3,183,F,27,6,7,79,-104,Severe
5,3,63,M,57,8,10,106,43,Well
13,11,167,M,26,6,6,78,-89,Severe
8,6,102,M,21,6,2,74,-28,Severe
6,3,75,M,37,7,3,87,12,Well
10,9,129,F,47,8,0,96,-33,Severe
9,2,110,F,29,6,8,80,-30,Severe
9,10,118,M,104,13,7,163,45,Well
12,1,145,M,98,13,0,156,11,Well
12,0,144,M,103,13,6,162,18,Well
14,9,177,M,97,12,11,155,-22,Severe
14,3,171,M,78,11,0,132,-39,Severe
12,8,152,F,37,7,3,87,-65,Severe
18,0,216,F,76,10,10,130,-86,Severe
13,1,157,M,104,13,7,163,6,Well
14,10,178,M,101,13,4,160,-18,Severe
16,1,193,F,20,6,2,74,-119,Severe
5,5,65,F,108,14,0,168,103,Well
17,5,209,M,36,7,2,86,-123,Severe
11,1,133,M,50,8,3,99,-34,Severe
5,5,65,M,36,7,2,86,21,Well
17,2,206,F,62,9,4,112,-94,Severe
15,4,184,F,43,7,8,92,-92,Severe
14,10,178,F,15,5,11,71,-107,Severe
13,5,161,M,35,7,1,85,-76,Severe
11,3,135,M,18,6,1,73,-62,Severe
6,9,81,F,80,11,3,135,54,Well
5,6,66,M,106,13,10,166,100,Well
11,1,133,F,38,7,4,88,-45,Severe
7,7,91,F,50,8,3,99,8,Well
18,11,227,F,12,5,9,69,-158,Severe
8,6,102,M,78,11,0,132,30,Well
12,11,155,F,106,13,10,166,11,Well
6,8,80,F,78,11,0,132,52,Well
6,10,82,M,88,12,0,144,62,Well
16,10,202,M,83,11,6,138,-64,Severe
10,3,123,M,97,12,11,155,32,Well
16,5,197,M,8,5,6,66,-131,Severe
13,8,164,M,77,10,11,131,-33,Severe
7,5,89,F,109,14,1,169,80,Well
17,5,209,M,86,11,10,142,-67,Severe
10,0,120,M,45,7,10,94,-26,Severe
16,1,193,M,16,5,11,71,-122,Severe
11,8,140,M,61,9,3,111,-29,Severe
7,4,88,M,45,7,10,94,6,Well
7,0,84,F,84,11,7,139,55,Well
12,8,152,M,66,9,9,117,-35,Severe
10,3,123,M,59,9,1,109,-14,Severe
6,10,82,M,58,9,0,108,26,Well
8,5,101,F,76,10,10,130,29,Well
14,5,173,M,28,6,8,80,-93,Severe
6,0,72,M,32,6,10,82,10,Well
12,2,146,F,7,5,6,66,-80,Severe
10,2,122,F,41,7,6,90,-32,Severe
15,0,180,M,24,6,5,77,-103,Severe
15,8,188,F,108,14,0,168,-20,Severe
5,10,70,F,106,13,10,166,96,Well
12,5,149,M,4,5,4,64,-85,Severe
15,2,182,M,51,8,4,100,-82,Severe
11,2,134,M,107,13,11,167,33,Well
7,2,86,F,99,13,1,157,71,Well
7,10,94,F,12,5,9,69,-25,Severe
15,11,191,M,68,10,0,120,-71,Severe
8,7,103,F,2,5,3,63,-40,Severe
5,0,60,F,34,7,0,84,24,Well
13,2,158,F,57,8,10,106,-52,Severe
5,1,61,F,110,14,3,171,110,Well
11,3,135,M,16,5,11,71,-64,Severe
18,3,219,M,8,5,6,66,-153,Severe
8,11,107,M,81,11,4,136,29,Well
14,3,171,F,27,6,7,79,-92,Severe
5,11,71,F,100,13,3,159,88,Well
14,0,168,F,24,6,5,77,-91,Severe
12,6,150,F,53,8,6,102,-48,Severe
17,10,214,F,82,11,5,137,-77,Severe
7,6,90,M,15,5,11,71,-19,Severe
18,2,218,F,57,8,10,106,-112,Severe
8,2,98,M,44,7,9,93,-5,Mild
15,3,183,F,103,13,6,162,-21,Severe
17,4,208,M,17,6,0,72,-136,Severe
17,5,209,F,48,8,1,97,-112,Severe
16,10,202,F,25,6,5,77,-125,Severe
6,4,76,F,10,5,7,67,-9,Severe
16,2,194,M,34,7,0,84,-110,Severe
15,3,183,M,65,9,8,116,-67,Severe
8,11,107,F,77,10,11,131,24,Well
6,6,78,M,109,14,1,169,91,Well
11,8,140,M,98,13,0,156,16,Well
14,10,178,F,85,11,9,141,-37,Severe
15,5,185,F,23,6,4,76,-109,Severe
5,1,61,F,96,12,10,154,93,Well
7,6,90,M,95,12,9,153,63,Well
17,1,205,M,19,6,1,73,-132,Severe
10,7,127,M,63,9,6,114,-13,Severe
5,1,61,M,75,10,9,129,68,Well
18,5,221,F,26,6,6,78,-143,Severe
6,2,74,F,24,6,5,77,3,Good
17,11,215,M,57,8,10,106,-109,Severe
16,3,195,F,104,13,7,163,-32,Severe
5,3,63,F,71,10,3,123,60,Well
10,8,128,F,17,6,0,72,-56,Severe
5,8,68,M,65,9,8,116,48,Well
17,7,211,M,77,10,11,131,-80,Severe
6,4,76,M,46,7,11,95,19,Well
11,2,134,M,108,14,0,168,34,Well
9,3,111,F,47,8,0,96,-15,Severe
14,5,173,M,98,13,0,156,-17,Severe
18,3,219,F,27,6,7,79,-140,Severe
12,8,152,F,49,8,2,98,-54,Severe
18,3,219,M,84,11,7,139,-80,Severe
10,2,122,F,61,9,3,111,-11,Severe
7,6,90,M,109,14,1,169,79,Well
14,8,176,F,37,7,3,87,-89,Severe
13,9,165,F,43,7,8,92,-73,Severe
12,11,155,F,30,6,9,81,-74,Severe
8,7,103,F,10,5,7,67,-36,Severe
10,8,128,M,82,11,5,137,9,Well
6,4,76,F,40,7,5,89,13,Well
5,1,61,M,52,8,5,101,40,Well
12,3,147,F,51,8,4,100,-47,Severe
6,2,74,F,83,11,6,138,64,Well
17,10,214,M,48,8,1,97,-117,Severe
5,1,61,F,106,13,10,166,105,Well
14,8,176,M,19,6,1,73,-103,Severe
14,7,175,M,8,5,6,66,-109,Severe
10,4,124,M,2,5,3,63,-61,Severe
14,3,171,M,23,6,4,76,-95,Severe
13,6,162,F,108,14,0,168,6,Well
5,4,64,M,35,7,1,85,21,Well
16,6,198,F,16,5,11,71,-127,Severe
14,5,173,F,55,8,8,104,-69,Severe
6,10,82,F,97,12,11,155,73,Well
9,5,113,F,18,6,1,73,-40,Severe
18,7,223,M,49,8,2,98,-125,Severe
18,2,218,M,66,9,9,117,-101,Severe
13,11,167,F,103,13,6,162,-5,Mild
15,2,182,M,62,9,4,112,-70,Severe
16,0,192,M,66,9,9,117,-75,Severe
12,2,146,F,63,9,6,114,-32,Severe
10,1,121,F,47,8,0,96,-25,Severe
12,9,153,F,81,11,4,136,-17,Severe
5,3,63,F,75,10,9,129,66,Well
9,1,109,M,30,6,9,81,-28,Severe
6,5,77,F,34,7,0,84,7,Well
6,7,79,F,60,9,2,110,31,Well
13,10,166,M,83,11,6,138,-28,Severe
9,1,109,M,39,7,5,89,-20,Severe
14,11,179,M,84,11,7,139,-40,Severe
6,8,80,M,34,7,0,84,4,Good
11,4,136,M,51,8,4,100,-36,Severe
12,8,152,M,5,5,5,65,-87,Severe
11,10,142,F,75,10,9,129,-13,Severe
18,5,221,F,102,13,6,162,-59,Severe
14,10,178,M,60,9,2,110,-68,Severe
5,0,60,F,33,6,11,83,23,Well
7,8,92,F,46,7,11,95,3,Good
9,5,113,F,80,11,3,135,22,Well
6,0,72,F,100,13,3,159,87,Well
10,2,122,M,59,9,1,109,-13,Severe
16,2,194,M,27,6,7,79,-115,Severe
14,9,177,F,53,8,6,102,-75,Severe
10,10,130,F,78,11,0,132,2,Good
8,1,97,M,40,7,5,89,-8,Severe
7,10,94,M,55,8,8,104,10,Well
14,6,174,M,87,11,11,143,-31,Severe
15,11,191,F,79,11,1,133,-58,Severe
5,3,63,M,100,13,3,159,96,Well
18,1,217,F,47,8,0,96,-121,Severe
14,4,172,F,73,10,6,126,-46,Severe
14,1,169,M,104,13,7,163,-6,Severe
6,10,82,F,31,6,9,81,-1,Mild
11,3,135,M,70,10,2,122,-13,Severe
7,9,93,M,58,9,0,108,15,Well
10,3,123,M,8,5,6,66,-57,Severe
17,9,213,F,103,13,6,162,-51,Severe
9,3,111,F,2,5,3,63,-48,Severe
6,5,77,M,55,8,8,104,27,Well
15,3,183,M,39,7,5,89,-94,Severe
5,9,69,M,94,12,7,151,82,Well
15,3,183,F,69,10,1,121,-62,Severe
7,7,91,F,90,12,3,147,56,Well
15,6,186,F,11,5,8,68,-118,Severe
10,4,124,F,106,13,10,166,42,Well
16,9,201,F,46,7,11,95,-106,Severe
13,3,159,F,99,13,1,157,-2,Mild
16,6,198,F,25,6,5,77,-121,Severe
13,0,156,M,55,8,8,104,-52,Severe
13,3,159,M,104,13,7,163,4,Good
12,0,144,M,62,9,4,112,-32,Severe
16,8,200,M,90,12,3,147,-53,Severe
5,10,70,M,97,12,11,155,85,Well
14,1,169,M,26,6,6,78,-91,Severe
18,10,226,F,53,8,6,102,-124,Severe
18,1,217,M,74,10,7,127,-90,Severe
11,10,142,F,65,9,8,116,-26,Severe
9,8,116,M,81,11,4,136,20,Well
6,9,81,M,47,8,0,96,15,Well
15,9,189,M,83,11,6,138,-51,Severe
8,5,101,F,110,14,3,171,70,Well
9,9,117,F,73,10,6,126,9,Well
5,0,60,M,9,5,7,67,7,Well
16,11,203,M,58,9,0,108,-95,Severe
6,7,79,F,32,6,10,82,3,Good
15,1,181,F,79,11,1,133,-48,Severe
8,8,104,F,5,5,5,65,-39,Severe
11,9,141,F,37,7,3,87,-54,Severe
5,6,66,F,50,8,3,99,33,Well
18,7,223,M,22,6,3,75,-148,Severe
10,11,131,F,10,5,7,67,-64,Severe
9,4,112,F,5,5,5,65,-47,Severe
11,4,136,M,54,8,7,103,-33,Severe
9,11,119,F,44,7,9,93,-26,Severe
5,11,71,F,37,7,3,87,16,Well
7,1,85,F,70,10,2,122,37,Well
9,9,117,F,7,5,6,66,-51,Severe
8,7,103,F,70,10,2,122,19,Well
7,9,93,F,3,5,3,63,-30,Severe
5,5,65,F,40,7,5,89,24,Well
15,8,188,M,13,5,9,69,-119,Severe
9,6,114,M,46,7,11,95,-19,Severe
10,6,126,M,71,10,3,123,-3,Mild
10,8,128,M,93,12,6,150,22,Well
17,0,204,F,48,8,1,97,-107,Severe
12,0,144,F,8,5,6,66,-78,Severe
13,1,157,F,52,8,5,101,-56,Severe
14,0,168,M,40,7,5,89,-79,Severe
18,3,219,M,69,10,1,121,-98,Severe
13,3,159,M,9,5,7,67,-92,Severe
16,11,203,M,74,10,7,127,-76,Severe
17,7,211,F,85,11,9,141,-70,Severe
5,5,65,M,50,8,3,99,34,Well
17,3,207,F,47,8,0,96,-111,Severe
18,10,226,F,78,11,0,132,-94,Severe
8,1,97,F,75,10,9,129,32,Well
18,7,223,F,48,8,1,97,-126,Severe
15,11,191,M,32,6,10,82,-109,Severe
13,9,165,M,75,10,9,129,-36,Severe
17,0,204,F,75,10,9,129,-75,Severe
14,7,175,F,51,8,4,100,-75,Severe
11,5,137,F,50,8,3,99,-38,Severe
10,7,127,M,57,8,10,106,-21,Severe
6,6,78,M,81,11,4,136,58,Well
17,3,207,M,67,9,10,118,-89,Severe
18,1,217,F,77,10,11,131,-86,Severe
15,8,188,M,9,5,7,67,-121,Severe
12,9,153,F,23,6,4,76,-77,Severe
11,1,133,F,65,9,8,116,-17,Severe
13,5,161,M,66,9,9,117,-44,Severe
11,7,139,M,15,5,11,71,-68,Severe
18,7,223,F,49,8,2,98,-125,Severe
12,0,144,F,21,6,2,74,-70,Severe
8,6,102,M,26,6,6,78,-24,Severe
18,3,219,F,34,7,0,84,-135,Severe
13,9,165,M,37,7,3,87,-78,Severe
10,4,124,M,65,9,8,116,-8,Severe
5,6,66,M,37,7,3,87,21,Well
13,10,166,F,68,10,0,120,-46,Severe
10,7,127,M,14,5,10,70,-57,Severe
17,6,210,F,71,10,3,123,-87,Severe
16,11,203,M,53,8,6,102,-101,Severe
6,10,82,F,10,5,7,67,-15,Severe
18,8,224,F,48,8,1,97,-127,Severe
6,3,75,F,34,7,0,84,9,Well
6,5,77,F,54,8,7,103,26,Well
6,3,75,M,103,13,6,162,87,Well
11,11,143,M,71,10,3,123,-20,Severe
10,11,131,F,98,13,0,156,25,Well
10,4,124,F,87,11,11,143,19,Well
16,1,193,F,86,11,10,142,-51,Severe
8,0,96,F,62,9,4,112,16,Well
9,4,112,F,7,5,6,66,-46,Severe
8,10,106,M,96,12,10,154,48,Well
14,0,168,F,91,12,4,148,-20,Severe
16,1,193,M,77,10,11,131,-62,Severe
7,4,88,F,66,9,9,117,29,Well
17,10,214,F,76,10,10,130,-84,Severe
8,9,105,F,98,13,0,156,51,Well
7,0,84,F,35,7,1,85,1,Good
15,10,190,F,16,5,11,71,-119,Severe
18,1,217,F,42,7,7,91,-126,Severe
7,5,89,M,88,12,0,144,55,Well
9,11,119,M,57,8,10,106,-13,Severe
10,7,127,F,110,14,3,171,44,Well
17,2,206,F,94,12,7,151,-55,Severe
16,10,202,F,71,10,3,123,-79,Severe
15,3,183,F,82,11,5,137,-46,Severe
5,6,66,F,24,6,5,77,11,Well
17,1,205,F,5,5,5,65,-140,Severe
8,0,96,M,40,7,5,89,-7,Severe
17,3,207,F,105,13,9,165,-42,Severe
11,1,133,F,2,5,3,63,-70,Severe
6,1,73,F,12,5,9,69,-4,Mild
14,9,177,F,82,11,5,137,-40,Severe
10,0,120,M,38,7,4,88,-32,Severe
17,1,205,M,90,12,3,147,-58,Severe
18,6,222,M,62,9,4,112,-110,Severe
11,9,141,F,38,7,4,88,-53,Severe
10,1,121,F,17,6,0,72,-49,Severe
12,5,149,F,69,10,1,121,-28,Severe
14,9,177,F,7,5,6,66,-111,Severe
18,5,221,F,37,7,3,87,-134,Severe
5,6,66,M,66,9,9,117,51,Well
6,8,80,M,72,10,4,124,44,Well
9,3,111,M,79,11,1,133,22,Well
10,3,123,F,24,6,5,77,-46,Severe
18,3,219,M,32,6,10,82,-137,Severe
16,3,195,M,76,10,10,130,-65,Severe
15,8,188,M,7,5,6,66,-122,Severe
13,5,161,M,103,13,6,162,1,Good
9,9,117,F,35,7,1,85,-32,Severe
9,4,112,F,10,5,7,67,-45,Severe
18,0,216,M,23,6,4,76,-140,Severe
11,0,132,F,30,6,9,81,-51,Severe
18,11,227,F,100,13,3,159,-68,Severe
18,3,219,F,10,5,7,67,-152,Severe
17,1,205,F,97,12,11,155,-50,Severe
5,0,60,M,92,12,5,149,89,Well
9,4,112,F,56,8,9,105,-7,Severe
18,9,225,M,73,10,6,126,-99,Severe
5,5,65,F,10,5,7,67,2,Good
10,5,125,M,109,14,1,169,44,Well
13,10,166,F,79,11,1,133,-33,Severe
14,6,174,F,22,6,3,75,-99,Severe
6,10,82,M,30,6,9,81,-1,Mild
6,7,79,F,76,10,10,130,51,Well
17,10,214,F,62,9,4,112,-102,Severe
13,4,160,F,34,7,0,84,-76,Severe
9,4,112,M,64,9,7,115,3,Good
6,11,83,F,41,7,6,90,7,Well
7,7,91,M,88,12,0,144,53,Well
14,9,177,F,37,7,3,87,-90,Severe
12,11,155,F,3,5,3,63,-92,Severe
13,0,156,F,23,6,4,76,-80,Severe
10,2,122,F,101,13,4,160,38,Well
5,3,63,F,100,13,3,159,96,Well
7,8,92,F,60,9,2,110,18,Well
10,9,129,M,56,8,9,105,-24,Severe
6,3,75,F,10,5,7,67,-8,Severe
8,0,96,F,14,5,10,70,-26,Severe
7,10,94,F,28,6,8,80,-14,Severe
13,5,161,F,10,5,7,67,-94,Severe
8,5,101,F,9,5,7,67,-34,Severe
11,9,141,M,25,6,5,77,-64,Severe
16,10,202,F,65,9,8,116,-86,Severe
13,1,157,M,20,6,2,74,-83,Severe
13,11,167,M,68,10,0,120,-47,Severe
6,5,77,F,44,7,9,93,16,Well
16,8,200,F,22,6,3,75,-125,Severe
5,7,67,M,97,12,11,155,88,Well
12,3,147,M,43,7,8,92,-55,Severe
5,11,71,F,15,5,11,71,0,Neutral
14,8,176,M,68,10,0,120,-56,Severe
13,6,162,F,82,11,5,137,-25,Severe
9,2,110,M,5,5,5,65,-45,Severe
8,6,102,F,33,6,11,83,-19,Severe
16,1,193,M,7,5,6,66,-127,Severe
17,11,215,M,102,13,6,162,-53,Severe
13,10,166,M,38,7,4,88,-78,Severe
10,8,128,M,64,9,7,115,-13,Severe
18,1,217,M,101,13,4,160,-57,Severe
8,3,99,M,4,5,4,64,-35,Severe
6,3,75,M,53,8,6,102,27,Well
12,3,147,F,11,5,8,68,-79,Severe
9,5,113,F,15,5,11,71,-42,Severe
10,0,120,F,54,8,7,103,-17,Severe
10,3,123,F,100,13,3,159,36,Well
5,2,62,M,77,10,11,131,69,Well
15,1,181,M,68,10,0,120,-61,Severe
9,8,116,M,106,13,10,166,50,Well
8,7,103,M,47,8,0,96,-7,Severe
16,3,195,M,104,13,7,163,-32,Severe
15,10,190,M,53,8,6,102,-88,Severe
15,11,191,F,51,8,4,100,-91,Severe
16,2,194,M,103,13,6,162,-32,Severe
5,11,71,M,30,6,9,81,10,Well
5,7,67,M,101,13,4,160,93,Well
10,10,130,F,46,7,11,95,-35,Severe
16,0,192,M,33,6,11,83,-109,Severe
5,5,65,F,78,11,0,132,67,Well
9,2,110,M,65,9,8,116,6,Well
11,4,136,M,85,11,9,141,5,Good
9,6,114,F,99,13,1,157,43,Well
5,6,66,M,16,5,11,71,5,Good
14,1,169,F,48,8,1,97,-72,Severe
13,1,157,M,50,8,3,99,-58,Severe
18,0,216,F,40,7,5,89,-127,Severe
5,6,66,M,28,6,8,80,14,Well
16,2,194,M,89,12,1,145,-49,Severe
16,3,195,M,83,11,6,138,-57,Severe
8,11,107,F,92,12,5,149,42,Well
14,1,169,F,58,9,0,108,-61,Severe
9,1,109,F,29,6,8,80,-29,Severe
16,2,194,F,79,11,1,133,-61,Severe
10,5,125,F,80,11,3,135,10,Well
6,9,81,M,99,13,1,157,76,Well
15,11,191,F,82,11,5,137,-54,Severe
7,2,86,F,63,9,6,114,28,Well
8,11,107,F,99,13,1,157,50,Well
10,6,126,F,91,12,4,148,22,Well
14,2,170,F,52,8,5,101,-69,Severe
16,4,196,F,6,5,5,65,-131,Severe
10,2,122,F,31,6,9,81,-41,Severe
18,6,222,F,26,6,6,78,-144,Severe
15,7,187,M,54,8,7,103,-84,Severe
11,9,141,M,29,6,8,80,-61,Severe
8,2,98,F,50,8,3,99,1,Good
18,4,220,F,55,8,8,104,-116,Severe
11,10,142,F,16,5,11,71,-71,Severe
6,10,82,F,30,6,9,81,-1,Mild
18,7,223,M,25,6,5,77,-146,Severe
12,8,152,F,56,8,9,105,-47,Severe
9,7,115,F,96,12,10,154,39,Well
8,7,103,F,80,11,3,135,32,Well
12,10,154,M,35,7,1,85,-69,Severe
9,2,110,F,39,7,5,89,-21,Severe
10,11,131,F,89,12,1,145,14,Well
9,5,113,M,8,5,6,66,-47,Severe
14,4,172,M,5,5,5,65,-107,Severe
12,9,153,F,69,10,1,121,-32,Severe
12,9,153,M,2,5,3,63,-90,Severe
12,2,146,M,87,11,11,143,-3,Mild
8,3,99,M,70,10,2,122,23,Well
15,8,188,M,39,7,5,89,-99,Severe
15,7,187,M,66,9,9,117,-70,Severe
10,7,127,M,64,9,7,115,-12,Severe
16,1,193,F,23,6,4,76,-117,Severe
16,6,198,F,108,14,0,168,-30,Severe
17,3,207,M,31,6,9,81,-126,Severe
10,7,127,M,65,9,8,116,-11,Severe
10,2,122,F,48,8,1,97,-25,Severe
6,9,81,M,24,6,5,77,-4,Mild
10,0,120,M,49,8,2,98,-22,Severe
14,11,179,M,7,5,6,66,-113,Severe
13,11,167,F,97,12,11,155,-12,Severe
5,7,67,M,12,5,9,69,2,Good
15,6,186,F,89,12,1,145,-41,Severe
11,6,138,M,103,13,6,162,24,Well
15,4,184,F,92,12,5,149,-35,Severe
10,1,121,F,14,5,10,70,-51,Severe
6,2,74,F,70,10,2,122,48,Well
6,11,83,M,42,7,7,91,8,Well
9,6,114,M,59,9,1,109,-5,Mild
5,9,69,F,59,9,1,109,40,Well
17,4,208,M,88,12,0,144,-64,Severe
10,7,127,M,93,12,6,150,23,Well
12,7,151,F,57,8,10,106,-45,Severe
18,1,217,M,65,9,8,116,-101,Severe
8,2,98,M,50,8,3,99,1,Good
15,4,184,M,82,11,5,137,-47,Severe
18,5,221,M,64,9,7,115,-106,Severe
11,5,137,M,77,10,11,131,-6,Severe
15,3,183,F,24,6,5,77,-106,Severe
17,6,210,M,96,12,10,154,-56,Severe
8,0,96,F,13,5,9,69,-27,Severe
15,7,187,M,18,6,1,73,-114,Severe
13,8,164,F,23,6,4,76,-88,Severe
8,3,99,F,75,10,9,129,30,Well
5,2,62,M,45,7,10,94,32,Well
15,8,188,M,91,12,4,148,-40,Severe
7,8,92,F,69,10,1,121,29,Well
5,3,63,M,102,13,6,162,99,Well
16,3,195,F,95,12,9,153,-42,Severe
18,0,216,F,27,6,7,79,-137,Severe
14,11,179,F,23,6,4,76,-103,Severe
6,1,73,M,11,5,8,68,-5,Mild
10,9,129,M,57,8,10,106,-23,Severe
13,10,166,F,41,7,6,90,-76,Severe
9,4,112,F,59,9,1,109,-3,Mild
9,9,117,F,65,9,8,116,-1,Mild
5,5,65,F,87,11,11,143,78,Well
13,4,160,F,33,6,11,83,-77,Severe
8,11,107,F,40,7,5,89,-18,Severe
12,11,155,F,13,5,9,69,-86,Severe
18,0,216,F,109,14,1,169,-47,Severe
14,9,177,M,7,5,6,66,-111,Severe
11,11,143,F,43,7,8,92,-51,Severe
14,9,177,F,89,12,1,145,-32,Severe
5,5,65,F,41,7,6,90,25,Well
12,9,153,M,15,5,11,71,-82,Severe
11,3,135,M,47,8,0,96,-39,Severe
9,11,119,M,90,12,3,147,28,Well
8,9,105,M,104,13,7,163,58,Well
10,5,125,M,98,13,0,156,31,Well
17,1,205,F,75,10,9,129,-76,Severe
15,8,188,M,29,6,8,80,-108,Severe
13,7,163,M,5,5,5,65,-98,Severe
13,9,165,F,40,7,5,89,-76,Severe
16,4,196,F,65,9,8,116,-80,Severe
13,8,164,F,95,12,9,153,-11,Severe
17,8,212,M,24,6,5,77,-135,Severe
18,6,222,F,75,10,9,129,-93,Severe
14,8,176,F,29,6,8,80,-96,Severe
5,0,60,M,33,6,11,83,23,Well
12,4,148,M,60,9,2,110,-38,Severe
16,11,203,M,70,10,2,122,-81,Severe
6,9,81,M,36,7,2,86,5,Good
13,0,156,F,103,13,6,162,6,Well
7,5,89,F,90,12,3,147,58,Well
12,4,148,M,99,13,1,157,9,Well
18,5,221,M,100,13,3,159,-62,Severe
14,5,173,F,10,5,7,67,-106,Severe
14,2,170,F,106,13,10,166,-4,Mild
16,1,193,F,85,11,9,141,-52,Severe
12,8,152,F,51,8,4,100,-52,Severe
10,6,126,M,45,7,10,94,-32,Severe
14,4,172,M,70,10,2,122,-50,Severe
6,8,80,M,49,8,2,98,18,Well
8,6,102,F,82,11,5,137,35,Well
11,2,134,F,62,9,4,112,-22,Severe
10,2,122,F,97,12,11,155,33,Well
12,8,152,F,106,13,10,166,14,Well
5,9,69,F,71,10,3,123,54,Well
17,2,206,M,88,12,0,144,-62,Severe
7,11,95,M,5,5,5,65,-30,Severe
13,6,162,F,51,8,4,100,-62,Severe
7,4,88,F,11,5,8,68,-20,Severe
9,6,114,M,36,7,2,86,-28,Severe
15,7,187,M,30,6,9,81,-106,Severe
17,8,212,M,55,8,8,104,-108,Severe
7,10,94,M,46,7,11,95,1,Good
16,8,200,F,102,13,6,162,-38,Severe
12,8,152,M,58,9,0,108,-44,Severe
11,11,143,M,88,12,0,144,1,Good
15,10,190,F,90,12,3,147,-43,Severe
17,4,208,F,87,11,11,143,-65,Severe
8,9,105,F,78,11,0,132,27,Well
10,8,128,M,23,6,4,76,-52,Severe
17,11,215,F,103,13,6,162,-53,Severe
8,0,96,F,81,11,4,136,40,Well
15,3,183,F,32,6,10,82,-101,Severe
5,5,65,F,59,9,1,109,44,Well
17,2,206,M,53,8,6,102,-104,Severe
18,7,223,F,71,10,3,123,-100,Severe
18,6,222,M,73,10,6,126,-96,Severe
16,0,192,F,62,9,4,112,-80,Severe
5,11,71,F,89,12,1,145,74,Well
14,3,171,M,10,5,7,67,-104,Severe
9,2,110,M,95,12,9,153,43,Well
14,1,169,M,68,10,0,120,-49,Severe
18,3,219,F,67,9,10,118,-101,Severe
16,3,195,M,34,7,0,84,-111,Severe
15,10,190,F,105,13,9,165,-25,Severe
15,11,191,F,62,9,4,112,-79,Severe
9,1,109,M,85,11,9,141,32,Well
7,4,88,F,65,9,8,116,28,Well
14,11,179,F,47,8,0,96,-83,Severe
6,9,81,F,51,8,4,100,19,Well
18,3,219,M,81,11,4,136,-83,Severe
16,3,195,F,81,11,4,136,-59,Severe
14,1,169,F,9,5,7,67,-102,Severe
11,1,133,M,18,6,1,73,-60,Severe
10,3,123,M,26,6,6,78,-45,Severe
10,9,129,M,58,9,0,108,-21,Severe
16,3,195,F,17,6,0,72,-123,Severe
16,3,195,F,74,10,7,127,-68,Severe
9,3,111,F,94,12,7,151,40,Well
15,11,191,F,19,6,1,73,-118,Severe
12,4,148,F,60,9,2,110,-38,Severe
11,3,135,F,12,5,9,69,-66,Severe
5,3,63,M,66,9,9,117,54,Well
18,1,217,M,48,8,1,97,-120,Severe
12,8,152,M,44,7,9,93,-59,Severe
8,5,101,F,46,7,11,95,-6,Severe
6,7,79,F,36,7,2,86,7,Well
7,3,87,M,53,8,6,102,15,Well
14,1,169,M,15,5,11,71,-98,Severe
10,6,126,F,43,7,8,92,-34,Severe
6,2,74,M,7,5,6,66,-8,Severe
9,7,115,M,94,12,7,151,36,Well
9,6,114,M,73,10,6,126,12,Well
5,6,66,M,81,11,4,136,70,Well
6,1,73,F,93,12,6,150,77,Well
15,1,181,M,9,5,7,67,-114,Severe
7,6,90,M,66,9,9,117,27,Well
13,4,160,F,72,10,4,124,-36,Severe
9,8,116,F,87,11,11,143,27,Well
15,9,189,F,13,5,9,69,-120,Severe
8,5,101,F,31,6,9,81,-20,Severe
13,4,160,F,29,6,8,80,-80,Severe
10,4,124,M,21,6,2,74,-50,Severe
9,10,118,F,51,8,4,100,-18,Severe
13,0,156,M,14,5,10,70,-86,Severe
12,11,155,F,40,7,5,89,-66,Severe
7,1,85,F,86,11,10,142,57,Well
13,8,164,F,6,5,5,65,-99,Severe
15,9,189,F,94,12,7,151,-38,Severe
10,1,121,F,78,11,0,132,11,Well
16,0,192,F,88,12,0,144,-48,Severe
14,9,177,M,37,7,3,87,-90,Severe
17,5,209,F,13,5,9,69,-140,Severe
14,8,176,M,71,10,3,123,-53,Severe
11,6,138,F,60,9,2,110,-28,Severe
15,2,182,M,20,6,2,74,-108,Severe
17,3,207,F,106,13,10,166,-41,Severe
12,9,153,M,68,10,0,120,-33,Severe
5,1,61,M,109,14,1,169,108,Well
18,9,225,M,107,13,11,167,-58,Severe
16,9,201,M,45,7,10,94,-107,Severe
5,2,62,F,66,9,9,117,55,Well
8,3,99,F,106,13,10,166,67,Well
18,10,226,F,25,6,5,77,-149,Severe
6,10,82,M,61,9,3,111,29,Well
5,1,61,F,45,7,10,94,33,Well
13,0,156,F,22,6,3,75,-81,Severe
12,3,147,M,44,7,9,93,-54,Severe
18,8,224,F,90,12,3,147,-77,Severe
7,6,90,F,63,9,6,114,24,Well
7,8,92,M,36,7,2,86,-6,Severe
5,0,60,F,20,6,2,74,14,Well
9,9,117,M,26,6,6,78,-39,Severe
7,3,87,F,35,7,1,85,-2,Mild
11,8,140,F,57,8,10,106,-34,Severe
7,9,93,F,13,5,9,69,-24,Severe
14,2,170,M,79,11,1,133,-37,Severe
10,10,130,F,101,13,4,160,30,Well
12,2,146,M,100,13,3,159,13,Well
10,0,120,F,5,5,5,65,-55,Severe
18,8,224,F,52,8,5,101,-123,Severe
15,3,183,M,57,8,10,106,-77,Severe
13,3,159,M,107,13,11,167,8,Well
13,6,162,M,58,9,0,108,-54,Severe
13,3,159,M,33,6,11,83,-76,Severe
8,9,105,M,15,5,11,71,-34,Severe
6,8,80,F,73,10,6,126,46,Well
17,4,208,M,103,13,6,162,-46,Severe
12,1,145,F,88,12,0,144,-1,Mild
12,10,154,F,101,13,4,160,6,Well
9,11,119,M,17,6,0,72,-47,Severe
15,6,186,F,35,7,1,85,-101,Severe
13,3,159,F,76,10,10,130,-29,Severe
11,10,142,F,12,5,9,69,-73,Severe
8,5,101,F,94,12,7,151,50,Well
18,0,216,M,45,7,10,94,-122,Severe
9,6,114,M,95,12,9,153,39,Well
18,2,218,F,81,11,4,136,-82,Severe
10,3,123,M,92,12,5,149,26,Well
10,9,129,F,44,7,9,93,-36,Severe
15,3,183,F,33,6,11,83,-100,Severe
6,1,73,F,57,8,10,106,33,Well
7,1,85,M,48,8,1,97,12,Well
14,6,174,F,32,6,10,82,-92,Severe
18,4,220,M,72,10,4,124,-96,Severe
10,4,124,M,87,11,11,143,19,Well
7,10,94,M,14,5,10,70,-24,Severe
12,9,153,M,75,10,9,129,-24,Severe
17,8,212,F,55,8,8,104,-108,Severe
17,0,204,M,86,11,10,142,-62,Severe
11,4,136,M,33,6,11,83,-53,Severe
11,8,140,F,10,5,7,67,-73,Severe
8,2,98,M,58,9,0,108,10,Well
15,3,183,F,48,8,1,97,-86,Severe
12,9,153,F,74,10,7,127,-26,Severe
17,3,207,F,70,10,2,122,-85,Severe
8,9,105,M,26,6,6,78,-27,Severe
13,6,162,F,101,13,4,160,-2,Mild
5,10,70,F,5,5,5,65,-5,Mild
9,11,119,M,39,7,5,89,-30,Severe
12,7,151,M,84,11,7,139,-12,Severe
10,4,124,M,67,9,10,118,-6,Severe
16,1,193,M,18,6,1,73,-120,Severe
16,3,195,M,9,5,7,67,-128,Severe
12,11,155,M,96,12,10,154,-1,Mild
8,3,99,M,84,11,7,139,40,Well
7,6,90,F,81,11,4,136,46,Well
10,1,121,F,86,11,10,142,21,Well
10,8,128,M,100,13,3,159,31,Well
10,2,122,F,83,11,6,138,16,Well
8,10,106,M,48,8,1,97,-9,Severe
16,10,202,F,62,9,4,112,-90,Severe
5,6,66,F,20,6,2,74,8,Well
15,3,183,M,110,14,3,171,-12,Severe
9,10,118,M,51,8,4,100,-18,Severe
9,1,109,M,37,7,3,87,-22,Severe
13,8,164,M,43,7,8,92,-72,Severe
16,0,192,M,105,13,9,165,-27,Severe
18,4,220,F,9,5,7,67,-153,Severe
5,11,71,M,7,5,6,66,-5,Mild
5,2,62,M,10,5,7,67,5,Good
13,3,159,M,97,12,11,155,-4,Mild
12,3,147,M,82,11,5,137,-10,Severe
9,7,115,M,64,9,7,115,0,Neutral
11,3,135,M,108,14,0,168,33,Well
17,9,213,M,66,9,9,117,-96,Severe
18,4,220,M,62,9,4,112,-108,Severe
6,5,77,F,64,9,7,115,38,Well
6,5,77,F,4,5,4,64,-13,Severe
9,8,116,M,6,5,5,65,-51,Severe
12,5,149,M,69,10,1,121,-28,Severe
13,8,164,F,28,6,8,80,-84,Severe
14,1,169,M,13,5,9,69,-100,Severe
17,1,205,F,28,6,8,80,-125,Severe
6,7,79,F,19,6,1,73,-6,Severe
11,3,135,F,50,8,3,99,-36,Severe
10,1,121,F,87,11,11,143,22,Well
16,4,196,M,73,10,6,126,-70,Severe
17,5,209,F,38,7,4,88,-121,Severe
15,6,186,M,76,10,10,130,-56,Severe
13,6,162,F,2,5,3,63,-99,Severe
13,1,157,M,18,6,1,73,-84,Severe
16,4,196,M,63,9,6,114,-82,Severe
11,6,138,M,73,10,6,126,-12,Severe
9,2,110,F,27,6,7,79,-31,Severe
9,11,119,F,91,12,4,148,29,Well
6,2,74,M,15,5,11,71,-3,Mild
10,11,131,F,107,13,11,167,36,Well
16,6,198,M,25,6,5,77,-121,Severe
8,6,102,M,48,8,1,97,-5,Mild
14,2,170,F,12,5,9,69,-101,Severe
7,2,86,M,26,6,6,78,-8,Severe
11,3,135,F,44,7,9,93,-42,Severe
8,3,99,M,31,6,9,81,-18,Severe
10,4,124,F,107,13,11,167,43,Well
7,4,88,F,53,8,6,102,14,Well
13,7,163,M,32,6,10,82,-81,Severe
16,1,193,M,67,9,10,118,-75,Severe
18,9,225,M,29,6,8,80,-145,Severe
15,3,183,M,73,10,6,126,-57,Severe
17,4,208,M,42,7,7,91,-117,Severe
14,1,169,F,69,10,1,121,-48,Severe
11,11,143,F,12,5,9,69,-74,Severe
10,7,127,F,108,14,0,168,41,Well
18,10,226,M,48,8,1,97,-129,Severe
5,5,65,F,11,5,8,68,3,Good
10,4,124,F,78,11,0,132,8,Well
5,9,69,M,55,8,8,104,35,Well
9,5,113,F,75,10,9,129,16,Well
5,1,61,F,10,5,7,67,6,Well
17,7,211,F,89,12,1,145,-66,Severe
7,11,95,F,90,12,3,147,52,Well
6,11,83,F,4,5,4,64,-19,Severe
16,3,195,M,52,8,5,101,-94,Severe
17,5,209,F,6,5,5,65,-144,Severe
7,0,84,M,56,8,9,105,21,Well
17,4,208,F,100,13,3,159,-49,Severe
9,10,118,F,10,5,7,67,-51,Severe
16,3,195,M,109,14,1,169,-26,Severe
13,10,166,F,17,6,0,72,-94,Severe
10,4,124,F,33,6,11,83,-41,Severe
7,1,85,M,51,8,4,100,15,Well
6,9,81,M,58,9,0,108,27,Well
16,11,203,F,59,9,1,109,-94,Severe
9,3,111,F,107,13,11,167,56,Well
5,4,64,M,68,10,0,120,56,Well
17,8,212,F,44,7,9,93,-119,Severe
17,2,206,F,5,5,5,65,-141,Severe
11,1,133,F,35,7,1,85,-48,Severe
17,6,210,F,37,7,3,87,-123,Severe
6,4,76,F,54,8,7,103,27,Well
8,2,98,F,98,13,0,156,58,Well
13,9,165,M,3,5,3,63,-102,Severe
11,9,141,F,60,9,2,110,-31,Severe
11,11,143,M,78,11,0,132,-11,Severe
7,8,92,M,20,6,2,74,-18,Severe
5,3,63,F,10,5,7,67,4,Good
11,1,133,F,70,10,2,122,-11,Severe
14,10,178,M,77,10,11,131,-47,Severe
7,4,88,M,70,10,2,122,34,Well
5,1,61,F,43,7,8,92,31,Well
5,9,69,M,26,6,6,78,9,Well
18,4,220,F,44,7,9,93,-127,Severe
10,7,127,M,8,5,6,66,-61,Severe
8,1,97,F,26,6,6,78,-19,Severe
10,6,126,F,34,7,0,84,-42,Severe
18,0,216,M,107,13,11,167,-49,Severe
17,7,211,F,101,13,4,160,-51,Severe
18,7,223,M,50,8,3,99,-124,Severe
18,1,217,F,27,6,7,79,-138,Severe
5,3,63,F,103,13,6,162,99,Well
14,5,173,F,94,12,7,151,-22,Severe
13,1,157,M,31,6,9,81,-76,Severe
12,7,151,F,6,5,5,65,-86,Severe
6,7,79,M,94,12,7,151,72,Well
14,3,171,F,60,9,2,110,-61,Severe
8,5,101,M,49,8,2,98,-3,Mild
13,2,158,M,26,6,6,78,-80,Severe
14,10,178,M,70,10,2,122,-56,Severe
12,6,150,F,56,8,9,105,-45,Severe
15,4,184,F,29,6,8,80,-104,Severe
9,2,110,F,59,9,1,109,-1,Mild
5,9,69,M,67,9,10,118,49,Well
8,5,101,M,79,11,1,133,32,Well
16,3,195,M,50,8,3,99,-96,Severe
15,10,190,M,22,6,3,75,-115,Severe
14,10,178,M,17,6,0,72,-106,Severe
14,6,174,M,30,6,9,81,-93,Severe
8,3,99,F,6,5,5,65,-34,Severe
17,2,206,F,32,6,10,82,-124,Severe
14,4,172,F,23,6,4,76,-96,Severe
18,6,222,F,35,7,1,85,-137,Severe
7,10,94,M,94,12,7,151,57,Well
16,3,195,F,2,5,3,63,-132,Severe
12,3,147,M,59,9,1,109,-38,Severe
10,5,125,F,36,7,2,86,-39,Severe
17,10,214,F,97,12,11,155,-59,Severe
8,4,100,F,55,8,8,104,4,Good
13,2,158,M,59,9,1,109,-49,Severe
12,4,148,F,100,13,3,159,11,Well
17,2,206,F,71,10,3,123,-83,Severe
9,3,111,M,22,6,3,75,-36,Severe
8,11,107,M,74,10,7,127,20,Well
7,5,89,M,23,6,4,76,-13,Severe
14,4,172,F,71,10,3,123,-49,Severe
16,7,199,F,28,6,8,80,-119,Severe
5,7,67,M,71,10,3,123,56,Well
11,2,134,F,97,12,11,155,21,Well
18,2,218,M,108,14,0,168,-50,Severe
10,1,121,M,87,11,11,143,22,Well
15,6,186,M,23,6,4,76,-110,Severe
11,8,140,M,53,8,6,102,-38,Severe
10,2,122,F,89,12,1,145,23,Well
13,2,158,F,60,9,2,110,-48,Severe
5,0,60,M,43,7,8,92,32,Well
16,6,198,F,65,9,8,116,-82,Severe
5,8,68,M,87,11,11,143,75,Well
15,0,180,F,28,6,8,80,-100,Severe
16,2,194,F,77,10,11,131,-63,Severe
15,11,191,F,43,7,8,92,-99,Severe
17,3,207,M,96,12,10,154,-53,Severe
14,6,174,F,70,10,2,122,-52,Severe
8,1,97,M,39,7,5,89,-8,Severe
12,0,144,F,33,6,11,83,-61,Severe
5,9,69,M,13,5,9,69,0,Neutral
16,4,196,M,32,6,10,82,-114,Severe
9,7,115,F,42,7,7,91,-24,Severe
12,3,147,M,56,8,9,105,-42,Severe
5,9,69,F,23,6,4,76,7,Well
7,2,86,F,61,9,3,111,25,Well
5,9,69,F,103,13,6,162,93,Well
7,9,93,F,24,6,5,77,-16,Severe
16,2,194,F,38,7,4,88,-106,Severe
15,0,180,F,21,6,2,74,-106,Severe
14,0,168,F,71,10,3,123,-45,Severe
18,1,217,M,10,5,7,67,-150,Severe
6,6,78,M,58,9,0,108,30,Well
9,0,108,F,19,6,1,73,-35,Severe
12,1,145,M,94,12,7,151,6,Well
7,0,84,F,83,11,6,138,54,Well
7,6,90,F,100,13,3,159,69,Well
18,2,218,M,50,8,3,99,-119,Severe
14,7,175,M,68,10,0,120,-55,Severe
7,4,88,M,87,11,11,143,55,Well
11,6,138,F,79,11,1,133,-5,Mild
13,7,163,M,6,5,5,65,-98,Severe
13,6,162,F,103,13,6,162,0,Neutral
18,6,222,F,88,12,0,144,-78,Severe
6,1,73,M,51,8,4,100,27,Well
12,10,154,F,65,9,8,116,-38,Severe
5,1,61,F,49,8,2,98,37,Well
7,11,95,M,75,10,9,129,34,Well
9,11,119,M,31,6,9,81,-38,Severe
11,5,137,M,104,13,7,163,26,Well
14,10,178,F,32,6,10,82,-96,Severe
18,2,218,M,98,13,0,156,-62,Severe
5,6,66,M,38,7,4,88,22,Well
14,3,171,M,70,10,2,122,-49,Severe
11,9,141,M,66,9,9,117,-24,Severe
14,2,170,M,94,12,7,151,-19,Severe
14,11,179,F,36,7,2,86,-93,Severe
15,11,191,M,36,7,2,86,-105,Severe
12,4,148,M,73,10,6,126,-22,Severe
10,11,131,F,66,9,9,117,-14,Severe
15,6,186,F,109,14,1,169,-17,Severe
9,1,109,M,4,5,4,64,-45,Severe
17,10,214,F,54,8,7,103,-111,Severe
16,8,200,F,53,8,6,102,-98,Severe
15,7,187,F,32,6,10,82,-105,Severe
11,1,133,M,14,5,10,70,-63,Severe
16,8,200,M,89,12,1,145,-55,Severe
17,1,205,M,46,7,11,95,-110,Severe
16,2,194,M,76,10,10,130,-64,Severe
13,3,159,M,105,13,9,165,6,Well
11,10,142,F,56,8,9,105,-37,Severe
10,10,130,F,36,7,2,86,-44,Severe
7,1,85,M,91,12,4,148,63,Well
15,6,186,F,75,10,9,129,-57,Severe
17,9,213,M,72,10,4,124,-89,Severe
12,7,151,F,8,5,6,66,-85,Severe
17,10,214,F,44,7,9,93,-121,Severe
7,6,90,F,26,6,6,78,-12,Severe
15,5,185,M,44,7,9,93,-92,Severe
15,9,189,F,59,9,1,109,-80,Severe
6,10,82,M,4,5,4,64,-18,Severe
18,3,219,M,39,7,5,89,-130,Severe
7,6,90,F,15,5,11,71,-19,Severe
11,8,140,F,85,11,9,141,1,Good
17,3,207,F,4,5,4,64,-143,Severe
15,6,186,M,103,13,6,162,-24,Severe
17,3,207,M,92,12,5,149,-58,Severe
13,3,159,M,83,11,6,138,-21,Severe
14,11,179,M,32,6,10,82,-97,Severe
16,10,202,F,48,8,1,97,-105,Severe
7,1,85,F,104,13,7,163,78,Well
7,11,95,F,109,14,1,169,74,Well
6,5,77,M,104,13,7,163,86,Well
9,9,117,M,5,5,5,65,-52,Severe
5,11,71,M,95,12,9,153,82,Well
6,2,74,F,89,12,1,145,71,Well
14,11,179,F,100,13,3,159,-20,Severe
16,2,194,F,64,9,7,115,-79,Severe
8,4,100,M,66,9,9,117,17,Well
18,6,222,F,21,6,2,74,-148,Severe
15,7,187,F,106,13,10,166,-21,Severe
18,3,219,M,99,13,1,157,-62,Severe
18,11,227,M,40,7,5,89,-138,Severe
5,7,67,M,105,13,9,165,98,Well
7,3,87,M,89,12,1,145,58,Well
17,1,205,M,56,8,9,105,-100,Severe
9,2,110,F,14,5,10,70,-40,Severe
17,8,212,M,93,12,6,150,-62,Severe
16,7,199,F,96,12,10,154,-45,Severe
13,9,165,M,87,11,11,143,-22,Severe
5,9,69,F,32,6,10,82,13,Well
13,0,156,M,48,8,1,97,-59,Severe
17,2,206,M,36,7,2,86,-120,Severe
15,1,181,M,37,7,3,87,-94,Severe
11,4,136,F,53,8,6,102,-34,Severe
10,5,125,F,23,6,4,76,-49,Severe
17,9,213,M,47,8,0,96,-117,Severe
16,2,194,F,51,8,4,100,-94,Severe
7,7,91,M,93,12,6,150,59,Well
5,1,61,F,15,5,11,71,10,Well
6,2,74,F,21,6,2,74,0,Neutral
17,1,205,M,2,5,3,63,-142,Severe
6,7,79,F,15,5,11,71,-8,Severe
16,8,200,F,87,11,11,143,-57,Severe
8,3,99,F,24,6,5,77,-22,Severe
9,4,112,M,12,5,9,69,-43,Severe
8,11,107,M,21,6,2,74,-33,Severe
14,2,170,M,109,14,1,169,-1,Mild
10,2,122,M,22,6,3,75,-47,Severe
7,3,87,M,57,8,10,106,19,Well
14,10,178,F,19,6,1,73,-105,Severe
9,3,111,M,36,7,2,86,-25,Severe
5,9,69,F,50,8,3,99,30,Well
18,10,226,F,94,12,7,151,-75,Severe
12,11,155,F,59,9,1,109,-46,Severe
16,4,196,M,90,12,3,147,-49,Severe
8,8,104,F,89,12,1,145,41,Well
7,3,87,F,41,7,6,90,3,Good
16,3,195,F,106,13,10,166,-29,Severe
10,3,123,F,106,13,10,166,43,Well
11,8,140,F,106,13,10,166,26,Well
14,3,171,F,57,8,10,106,-65,Severe
8,7,103,M,106,13,10,166,63,Well
17,0,204,M,8,5,6,66,-138,Severe
7,7,91,M,101,13,4,160,69,Well
5,9,69,F,107,13,11,167,98,Well
14,7,175,F,81,11,4,136,-39,Severe
12,7,151,F,97,12,11,155,4,Good
18,3,219,F,51,8,4,100,-119,Severe
8,7,103,M,96,12,10,154,51,Well
13,7,163,F,65,9,8,116,-47,Severe
5,8,68,M,88,12,0,144,76,Well
14,5,173,M,26,6,6,78,-95,Severe
8,10,106,F,10,5,7,67,-39,Severe
17,3,207,M,39,7,5,89,-118,Severe
12,10,154,M,104,13,7,163,9,Well
5,0,60,M,47,8,0,96,36,Well
12,6,150,F,30,6,9,81,-69,Severe
5,6,66,M,35,7,1,85,19,Well
14,11,179,M,36,7,2,86,-93,Severe
14,1,169,F,41,7,6,90,-79,Severe
6,8,80,F,2,5,3,63,-17,Severe
6,9,81,F,98,13,0,156,75,Well
6,2,74,M,54,8,7,103,29,Well
17,2,206,M,17,6,0,72,-134,Severe
13,1,157,F,45,7,10,94,-63,Severe
5,11,71,F,23,6,4,76,5,Good
10,7,127,M,48,8,1,97,-30,Severe
14,0,168,M,6,5,5,65,-103,Severe
18,3,219,M,18,6,1,73,-146,Severe
6,3,75,M,10,5,7,67,-8,Severe
14,6,174,F,35,7,1,85,-89,Severe
9,1,109,F,19,6,1,73,-36,Severe
8,7,103,M,22,6,3,75,-28,Severe
5,2,62,F,70,10,2,122,60,Well
13,1,157,M,43,7,8,92,-65,Severe
9,5,113,M,51,8,4,100,-13,Severe
10,11,131,M,78,11,0,132,1,Good
8,11,107,M,78,11,0,132,25,Well
15,5,185,M,26,6,6,78,-107,Severe
13,1,157,M,51,8,4,100,-57,Severe
13,5,161,M,8,5,6,66,-95,Severe
11,2,134,M,30,6,9,81,-53,Severe
6,6,78,M,61,9,3,111,33,Well
14,2,170,M,89,12,1,145,-25,Severe
8,4,100,M,80,11,3,135,35,Well
15,11,191,M,11,5,8,68,-123,Severe
11,4,136,M,94,12,7,151,15,Well
6,1,73,F,95,12,9,153,80,Well
6,10,82,F,21,6,2,74,-8,Severe
9,5,113,M,58,9,0,108,-5,Mild
11,4,136,M,91,12,4,148,12,Well
17,0,204,F,99,13,1,157,-47,Severe
15,0,180,M,46,7,11,95,-85,Severe
8,8,104,M,14,5,10,70,-34,Severe
6,1,73,F,83,11,6,138,65,Well
10,8,128,M,78,11,0,132,4,Good
8,10,106,F,12,5,9,69,-37,Severe
17,11,215,M,7,5,6,66,-149,Severe
18,3,219,F,65,9,8,116,-103,Severe
18,11,227,M,3,5,3,63,-164,Severe
16,11,203,M,23,6,4,76,-127,Severe
5,1,61,F,82,11,5,137,76,Well
7,2,86,M,48,8,1,97,11,Well
8,3,99,M,72,10,4,124,25,Well
14,4,172,M,8,5,6,66,-106,Severe
6,3,75,F,87,11,11,143,68,Well
7,3,87,M,108,14,0,168,81,Well
7,6,90,M,58,9,0,108,18,Well
8,7,103,F,79,11,1,133,30,Well
10,3,123,F,41,7,6,90,-33,Severe
7,2,86,F,101,13,4,160,74,Well
7,8,92,M,21,6,2,74,-18,Severe
18,10,226,F,12,5,9,69,-157,Severe
13,1,157,M,5,5,5,65,-92,Severe
12,9,153,F,73,10,6,126,-27,Severe
9,8,116,M,71,10,3,123,7,Well
16,3,195,F,7,5,6,66,-129,Severe
18,7,223,F,6,5,5,65,-158,Severe
8,1,97,F,85,11,9,141,44,Well
17,10,214,F,73,10,6,126,-88,Severe
8,5,101,M,107,13,11,167,66,Well
11,2,134,F,49,8,2,98,-36,Severe
13,7,163,F,81,11,4,136,-27,Severe
14,3,171,F,56,8,9,105,-66,Severe
7,7,91,F,49,8,2,98,7,Well
15,3,183,F,38,7,4,88,-95,Severe
14,4,172,F,96,12,10,154,-18,Severe
6,3,75,F,16,5,11,71,-4,Mild
7,7,91,M,84,11,7,139,48,Well
7,3,87,M,34,7,0,84,-3,Mild
15,7,187,M,68,10,0,120,-67,Severe
11,2,134,M,89,12,1,145,11,Well
11,4,136,M,11,5,8,68,-68,Severe
8,5,101,F,92,12,5,149,48,Well
16,6,198,M,99,13,1,157,-41,Severe
16,5,197,F,16,5,11,71,-126,Severe
9,3,111,M,68,10,0,120,9,Well
9,2,110,M,4,5,4,64,-46,Severe
17,1,205,M,42,7,7,91,-114,Severe
8,8,104,M,7,5,6,66,-38,Severe
6,7,79,F,63,9,6,114,35,Well
14,5,173,F,110,14,3,171,-2,Mild
5,5,65,F,16,5,11,71,6,Well
16,1,193,F,75,10,9,129,-64,Severe
18,3,219,F,26,6,6,78,-141,Severe
6,9,81,M,18,6,1,73,-8,Severe
13,4,160,F,24,6,5,77,-83,Severe
13,5,161,F,103,13,6,162,1,Good
9,8,116,F,33,6,11,83,-33,Severe
5,3,63,M,43,7,8,92,29,Well
16,3,195,F,46,7,11,95,-100,Severe
6,9,81,M,52,8,5,101,20,Well
10,10,130,M,48,8,1,97,-33,Severe
15,3,183,F,88,12,0,144,-39,Severe
9,3,111,M,10,5,7,67,-44,Severe
7,5,89,F,74,10,7,127,38,Well
9,9,117,F,41,7,6,90,-27,Severe
12,6,150,F,78,11,0,132,-18,Severe
9,9,117,M,87,11,11,143,26,Well
16,4,196,M,2,5,3,63,-133,Severe
7,10,94,M,47,8,0,96,2,Good
8,7,103,M,88,12,0,144,41,Well
7,3,87,M,10,5,7,67,-20,Severe
18,10,226,M,24,6,5,77,-149,Severe
9,9,117,M,40,7,5,89,-28,Severe
16,1,193,F,25,6,5,77,-116,Severe
6,2,74,F,105,13,9,165,91,Well
8,11,107,M,92,12,5,149,42,Well
9,5,113,M,43,7,8,92,-21,Severe
10,3,123,F,54,8,7,103,-20,Severe
12,1,145,F,60,9,2,110,-35,Severe
17,11,215,F,45,7,10,94,-121,Severe
8,4,100,M,61,9,3,111,11,Well
11,3,135,F,55,8,8,104,-31,Severe
16,7,199,F,75,10,9,129,-70,Severe
14,2,170,M,35,7,1,85,-85,Severe
17,3,207,F,68,10,0,120,-87,Severe
9,3,111,F,81,11,4,136,25,Well
15,9,189,F,82,11,5,137,-52,Severe
14,7,175,M,41,7,6,90,-85,Severe
5,3,63,M,28,6,8,80,17,Well
15,4,184,F,28,6,8,80,-104,Severe
5,11,71,M,86,11,10,142,71,Well
6,8,80,M,81,11,4,136,56,Well
18,0,216,M,87,11,11,143,-73,Severe
6,1,73,F,35,7,1,85,12,Well
13,4,160,F,84,11,7,139,-21,Severe
14,3,171,M,85,11,9,141,-30,Severe
8,9,105,M,68,10,0,120,15,Well
12,4,148,F,76,10,10,130,-18,Severe
8,11,107,F,42,7,7,91,-16,Severe
15,1,181,F,6,5,5,65,-116,Severe
18,1,217,F,29,6,8,80,-137,Severe
13,8,164,M,88,12,0,144,-20,Severe
18,2,218,M,41,7,6,90,-128,Severe
11,6,138,M,70,10,2,122,-16,Severe
6,11,83,M,77,10,11,131,48,Well
9,1,109,M,15,5,11,71,-38,Severe
8,4,100,M,33,6,11,83,-17,Severe
13,11,167,M,21,6,2,74,-93,Severe
18,0,216,F,30,6,9,81,-135,Severe
18,9,225,M,41,7,6,90,-135,Severe
10,10,130,F,77,10,11,131,1,Good
12,8,152,M,55,8,8,104,-48,Severe
15,1,181,F,109,14,1,169,-12,Severe
11,8,140,F,97,12,11,155,15,Well
13,4,160,M,94,12,7,151,-9,Severe
5,1,61,M,77,10,11,131,70,Well
8,9,105,F,89,12,1,145,40,Well
9,4,112,F,62,9,4,112,0,Neutral
5,1,61,M,84,11,7,139,78,Well
14,7,175,F,89,12,1,145,-30,Severe
12,11,155,M,13,5,9,69,-86,Severe
14,3,171,M,12,5,9,69,-102,Severe
9,5,113,F,63,9,6,114,1,Good
12,9,153,M,42,7,7,91,-62,Severe
6,9,81,F,68,10,0,120,39,Well
13,7,163,M,67,9,10,118,-45,Severe
7,4,88,M,28,6,8,80,-8,Severe
9,11,119,F,54,8,7,103,-16,Severe
10,7,127,M,22,6,3,75,-52,Severe
18,3,219,M,99,13,1,157,-62,Severe
13,9,165,F,4,5,4,64,-101,Severe
17,4,208,F,74,10,7,127,-81,Severe
6,1,73,M,44,7,9,93,20,Well
12,9,153,M,66,9,9,117,-36,Severe
17,10,214,F,13,5,9,69,-145,Severe
18,1,217,F,3,5,3,63,-154,Severe
12,0,144,F,71,10,3,123,-21,Severe
10,3,123,M,45,7,10,94,-29,Severe
13,3,159,F,77,10,11,131,-28,Severe
15,0,180,F,14,5,10,70,-110,Severe
18,8,224,F,62,9,4,112,-112,Severe
9,10,118,M,12,5,9,69,-49,Severe
9,5,113,M,102,13,6,162,49,Well
13,11,167,M,16,5,11,71,-96,Severe
7,8,92,F,110,14,3,171,79,Well
17,6,210,M,25,6,5,77,-133,Severe
13,10,166,F,4,5,4,64,-102,Severe
13,6,162,M,64,9,7,115,-47,Severe
13,11,167,M,49,8,2,98,-69,Severe
8,7,103,M,66,9,9,117,14,Well
16,2,194,F,61,9,3,111,-83,Severe
17,2,206,F,101,13,4,160,-46,Severe
9,4,112,F,44,7,9,93,-19,Severe
13,3,159,M,69,10,1,121,-38,Severe
16,0,192,M,39,7,5,89,-103,Severe
14,10,178,M,89,12,1,145,-33,Severe
17,11,215,M,75,10,9,129,-86,Severe
9,5,113,M,19,6,1,73,-40,Severe
17,11,215,F,98,13,0,156,-59,Severe
15,10,190,F,110,14,3,171,-19,Severe
9,1,109,M,24,6,5,77,-32,Severe
15,7,187,F,54,8,7,103,-84,Severe
10,6,126,F,27,6,7,79,-47,Severe
8,3,99,F,15,5,11,71,-28,Severe
18,2,218,F,12,5,9,69,-149,Severe
8,4,100,F,22,6,3,75,-25,Severe
18,6,222,M,13,5,9,69,-153,Severe
18,8,224,M,103,13,6,162,-62,Severe
18,3,219,F,55,8,8,104,-115,Severe
11,6,138,F,106,13,10,166,28,Well
9,10,118,M,64,9,7,115,-3,Mild
13,10,166,M,27,6,7,79,-87,Severe
8,9,105,F,13,5,9,69,-36,Severe
18,5,221,M,70,10,2,122,-99,Severe
15,7,187,M,12,5,9,69,-118,Severe
16,7,199,F,15,5,11,71,-128,Severe
12,9,153,F,37,7,3,87,-66,Severe
11,7,139,M,30,6,9,81,-58,Severe
7,1,85,M,63,9,6,114,29,Well
13,2,158,F,50,8,3,99,-59,Severe
8,5,101,M,11,5,8,68,-33,Severe
8,11,107,M,66,9,9,117,10,Well
13,3,159,M,71,10,3,123,-36,Severe
14,0,168,M,66,9,9,117,-51,Severe
18,10,226,M,41,7,6,90,-136,Severe
8,3,99,F,74,10,7,127,28,Well
18,9,225,M,100,13,3,159,-66,Severe
14,8,176,F,101,13,4,160,-16,Severe
7,2,86,F,85,11,9,141,55,Well
18,3,219,F,22,6,3,75,-144,Severe
5,9,69,M,31,6,9,81,12,Well
15,6,186,F,87,11,11,143,-43,Severe
8,7,103,F,14,5,10,70,-33,Severe
18,2,218,M,2,5,3,63,-155,Severe
12,5,149,F,32,6,10,82,-67,Severe
5,6,66,M,75,10,9,129,63,Well
7,9,93,F,57,8,10,106,13,Well
18,1,217,M,2,5,3,63,-154,Severe
5,10,70,M,73,10,6,126,56,Well
13,6,162,M,36,7,2,86,-76,Severe
13,8,164,F,49,8,2,98,-66,Severe
13,4,160,F,45,7,10,94,-66,Severe
16,8,200,M,87,11,11,143,-57,Severe
15,1,181,F,105,13,9,165,-16,Severe
7,3,87,F,47,8,0,96,9,Well
12,9,153,M,57,8,10,106,-47,Severe
12,9,153,F,33,6,11,83,-70,Severe
13,0,156,F,52,8,5,101,-55,Severe
11,4,136,M,6,5,5,65,-71,Severe
18,3,219,M,55,8,8,104,-115,Severe
6,0,72,F,84,11,7,139,67,Well
18,7,223,F,13,5,9,69,-154,Severe
7,3,87,M,81,11,4,136,49,Well
14,9,177,M,83,11,6,138,-39,Severe
11,3,135,M,22,6,3,75,-60,Severe
18,7,223,F,4,5,4,64,-159,Severe
12,6,150,F,6,5,5,65,-85,Severe
16,8,200,M,2,5,3,63,-137,Severe
16,11,203,M,2,5,3,63,-140,Severe
5,7,67,F,25,6,5,77,10,Well
11,11,143,F,7,5,6,66,-77,Severe
5,3,63,M,65,9,8,116,53,Well
16,6,198,M,107,13,11,167,-31,Severe
14,6,174,F,53,8,6,102,-72,Severe
6,2,74,M,67,9,10,118,44,Well
10,2,122,F,68,10,0,120,-2,Mild
12,3,147,F,93,12,6,150,3,Good
6,7,79,F,45,7,10,94,15,Well
11,1,133,M,70,10,2,122,-11,Severe
16,0,192,F,105,13,9,165,-27,Severe
16,11,203,F,19,6,1,73,-130,Severe
12,10,154,F,63,9,6,114,-40,Severe
10,3,123,M,100,13,3,159,36,Well
12,4,148,F,30,6,9,81,-67,Severe
10,4,124,M,76,10,10,130,6,Well
11,2,134,F,92,12,5,149,15,Well
14,2,170,M,8,5,6,66,-104,Severe
18,11,227,F,66,9,9,117,-110,Severe
5,1,61,M,76,10,10,130,69,Well
7,11,95,M,79,11,1,133,38,Well
14,8,176,M,94,12,7,151,-25,Severe
8,9,105,M,22,6,3,75,-30,Severe
11,5,137,M,89,12,1,145,8,Well
9,7,115,F,98,13,0,156,41,Well
6,3,75,M,88,12,0,144,69,Well
7,3,87,F,10,5,7,67,-20,Severe
15,10,190,M,95,12,9,153,-37,Severe
8,6,102,M,75,10,9,129,27,Well
11,8,140,F,84,11,7,139,-1,Mild
11,3,135,F,62,9,4,112,-23,Severe
13,6,162,F,23,6,4,76,-86,Severe
16,3,195,M,58,9,0,108,-87,Severe
8,9,105,M,40,7,5,89,-16,Severe
12,0,144,M,36,7,2,86,-58,Severe
16,3,195,M,17,6,0,72,-123,Severe
11,5,137,M,59,9,1,109,-28,Severe
9,10,118,F,71,10,3,123,5,Good
17,8,212,F,62,9,4,112,-100,Severe
5,2,62,F,56,8,9,105,43,Well
10,3,123,M,17,6,0,72,-51,Severe
17,9,213,F,5,5,5,65,-148,Severe
10,4,124,M,9,5,7,67,-57,Severe
7,11,95,M,83,11,6,138,43,Well
8,10,106,M,94,12,7,151,45,Well
8,2,98,F,107,13,11,167,69,Well
15,3,183,M,102,13,6,162,-21,Severe
13,3,159,F,50,8,3,99,-60,Severe
10,9,129,M,100,13,3,159,30,Well
7,6,90,M,108,14,0,168,78,Well
12,7,151,F,56,8,9,105,-46,Severe
8,4,100,F,106,13,10,166,66,Well
15,2,182,M,15,5,11,71,-111,Severe
10,10,130,F,87,11,11,143,13,Well
6,0,72,M,102,13,6,162,90,Well
12,11,155,M,10,5,7,67,-88,Severe
9,3,111,F,7,5,6,66,-45,Severe
9,10,118,M,74,10,7,127,9,Well
13,2,158,F,12,5,9,69,-89,Severe
5,7,67,M,9,5,7,67,0,Neutral
12,3,147,F,42,7,7,91,-56,Severe
12,8,152,F,44,7,9,93,-59,Severe
10,3,123,M,9,5,7,67,-56,Severe
9,9,117,M,106,13,10,166,49,Well
18,10,226,M,45,7,10,94,-132,Severe
8,1,97,F,22,6,3,75,-22,Severe
10,10,130,M,63,9,6,114,-16,Severe
11,6,138,M,24,6,5,77,-61,Severe
17,11,215,F,70,10,2,122,-93,Severe
10,3,123,F,49,8,2,98,-25,Severe
15,8,188,F,77,10,11,131,-57,Severe
5,2,62,F,20,6,2,74,12,Well
8,3,99,F,88,12,0,144,45,Well
9,2,110,F,19,6,1,73,-37,Severe
16,11,203,F,97,12,11,155,-48,Severe
14,8,176,M,73,10,6,126,-50,Severe
13,0,156,F,61,9,3,111,-45,Severe
10,3,123,M,93,12,6,150,27,Well
7,2,86,M,105,13,9,165,79,Well
12,4,148,F,99,13,1,157,9,Well
9,3,111,M,103,13,6,162,51,Well
15,1,181,F,57,8,10,106,-75,Severe
14,3,171,F,18,6,1,73,-98,Severe
8,8,104,F,8,5,6,66,-38,Severe
5,2,62,F,50,8,3,99,37,Well
13,1,157,F,6,5,5,65,-92,Severe
15,0,180,M,97,12,11,155,-25,Severe
10,6,126,F,86,11,10,142,16,Well
10,0,120,F,22,6,3,75,-45,Severe
8,3,99,M,19,6,1,73,-26,Severe
7,3,87,M,64,9,7,115,28,Well
5,8,68,M,97,12,11,155,87,Well
18,4,220,M,87,11,11,143,-77,Severe
12,11,155,M,110,14,3,171,16,Well
5,8,68,F,107,13,11,167,99,Well
11,1,133,F,59,9,1,109,-24,Severe
12,4,148,F,52,8,5,101,-47,Severe
8,3,99,F,70,10,2,122,23,Well
8,3,99,M,68,10,0,120,21,Well
16,11,203,M,20,6,2,74,-129,Severe
18,6,222,M,60,9,2,110,-112,Severe
10,3,123,M,27,6,7,79,-44,Severe
12,0,144,M,108,14,0,168,24,Well
8,6,102,F,27,6,7,79,-23,Severe
18,0,216,M,37,7,3,87,-129,Severe
5,2,62,F,44,7,9,93,31,Well
6,6,78,M,24,6,5,77,-1,Mild
13,0,156,F,42,7,7,91,-65,Severe
10,8,128,M,74,10,7,127,-1,Mild
6,8,80,F,50,8,3,99,19,Well
9,6,114,M,29,6,8,80,-34,Severe
14,3,171,F,99,13,1,157,-14,Severe
7,4,88,F,93,12,6,150,62,Well
11,2,134,M,54,8,7,103,-31,Severe
10,1,121,M,47,8,0,96,-25,Severe
7,9,93,F,14,5,10,70,-23,Severe
13,4,160,F,61,9,3,111,-49,Severe
7,8,92,M,97,12,11,155,63,Well
6,6,78,M,59,9,1,109,31,Well
15,5,185,F,38,7,4,88,-97,Severe
9,7,115,F,71,10,3,123,8,Well
6,2,74,M,20,6,2,74,0,Neutral
18,1,217,F,108,14,0,168,-49,Severe
7,0,84,F,22,6,3,75,-9,Severe
18,3,219,F,38,7,4,88,-131,Severe
9,2,110,F,75,10,9,129,19,Well
8,4,100,M,58,9,0,108,8,Well
11,1,133,M,80,11,3,135,2,Good
12,8,152,M,7,5,6,66,-86,Severe
9,1,109,M,105,13,9,165,56,Well
6,2,74,F,95,12,9,153,79,Well
12,8,152,F,63,9,6,114,-38,Severe
6,0,72,F,95,12,9,153,81,Well
6,5,77,M,95,12,9,153,76,Well
6,5,77,F,13,5,9,69,-8,Severe
14,3,171,F,4,5,4,64,-107,Severe
17,1,205,M,9,5,7,67,-138,Severe
12,1,145,M,19,6,1,73,-72,Severe
5,7,67,F,27,6,7,79,12,Well
8,3,99,F,30,6,9,81,-18,Severe
5,8,68,M,105,13,9,165,97,Well
18,2,218,F,66,9,9,117,-101,Severe
8,1,97,F,8,5,6,66,-31,Severe
14,10,178,F,59,9,1,109,-69,Severe
16,0,192,M,55,8,8,104,-88,Severe
9,3,111,F,41,7,6,90,-21,Severe
16,4,196,M,108,14,0,168,-28,Severe
7,9,93,F,89,12,1,145,52,Well
13,2,158,M,38,7,4,88,-70,Severe
15,1,181,F,100,13,3,159,-22,Severe
16,7,199,F,99,13,1,157,-42,Severe
6,3,75,F,58,9,0,108,33,Well
14,0,168,M,61,9,3,111,-57,Severe
15,9,189,M,26,6,6,78,-111,Severe
18,8,224,M,51,8,4,100,-124,Severe
8,0,96,F,48,8,1,97,1,Good
7,3,87,F,24,6,5,77,-10,Severe
10,5,125,F,90,12,3,147,22,Well
13,8,164,M,104,13,7,163,-1,Mild
10,6,126,M,21,6,2,74,-52,Severe
15,1,181,M,82,11,5,137,-44,Severe
11,11,143,M,53,8,6,102,-41,Severe
6,3,75,F,41,7,6,90,15,Well
14,6,174,M,46,7,11,95,-79,Severe
16,3,195,F,69,10,1,121,-74,Severe
6,9,81,M,28,6,8,80,-1,Mild
9,1,109,M,62,9,4,112,3,Good
18,2,218,F,72,10,4,124,-94,Severe
18,8,224,M,87,11,11,143,-81,Severe
8,9,105,F,105,13,9,165,60,Well
16,5,197,F,49,8,2,98,-99,Severe
15,6,186,M,73,10,6,126,-60,Severe
13,3,159,F,19,6,1,73,-86,Severe
7,3,87,M,38,7,4,88,1,Good
15,10,190,F,78,11,0,132,-58,Severe
6,11,83,F,44,7,9,93,10,Well
9,11,119,M,77,10,11,131,12,Well
17,9,213,F,36,7,2,86,-127,Severe
14,3,171,F,48,8,1,97,-74,Severe
10,11,131,M,45,7,10,94,-37,Severe
18,8,224,M,69,10,1,121,-103,Severe
15,1,181,F,93,12,6,150,-31,Severe
6,10,82,M,33,6,11,83,1,Good
5,5,65,M,51,8,4,100,35,Well
9,8,116,F,47,8,0,96,-20,Severe
13,4,160,M,25,6,5,77,-83,Severe
17,6,210,M,41,7,6,90,-120,Severe
11,10,142,M,63,9,6,114,-28,Severe
18,3,219,M,24,6,5,77,-142,Severe
14,9,177,F,64,9,7,115,-62,Severe
7,2,86,F,45,7,10,94,8,Well
13,3,159,M,24,6,5,77,-82,Severe
5,1,61,M,29,6,8,80,19,Well
16,3,195,M,7,5,6,66,-129,Severe
10,8,128,M,49,8,2,98,-30,Severe
12,8,152,M,67,9,10,118,-34,Severe
12,9,153,M,21,6,2,74,-79,Severe
9,3,111,M,109,14,1,169,58,Well
7,3,87,M,82,11,5,137,50,Well
9,8,116,M,31,6,9,81,-35,Severe
5,4,64,F,103,13,6,162,98,Well
7,10,94,M,30,6,9,81,-13,Severe
14,10,178,F,40,7,5,89,-89,Severe
10,3,123,M,101,13,4,160,37,Well
12,7,151,F,86,11,10,142,-9,Severe
16,4,196,F,64,9,7,115,-81,Severe
15,11,191,M,63,9,6,114,-77,Severe
17,0,204,F,101,13,4,160,-44,Severe
9,9,117,F,79,11,1,133,16,Well
7,5,89,F,38,7,4,88,-1,Mild
9,0,108,M,24,6,5,77,-31,Severe
13,11,167,F,90,12,3,147,-20,Severe
5,11,71,M,110,14,3,171,100,Well
10,9,129,M,11,5,8,68,-61,Severe
5,3,63,M,104,13,7,163,100,Well
13,4,160,F,95,12,9,153,-7,Severe
11,4,136,M,89,12,1,145,9,Well
14,7,175,M,23,6,4,76,-99,Severe
18,5,221,M,34,7,0,84,-137,Severe
5,6,66,M,7,5,6,66,0,Neutral
18,0,216,M,9,5,7,67,-149,Severe
17,10,214,F,25,6,5,77,-137,Severe
8,9,105,F,50,8,3,99,-6,Severe
5,4,64,M,41,7,6,90,26,Well
18,0,216,F,32,6,10,82,-134,Severe
7,1,85,F,75,10,9,129,44,Well
13,1,157,M,52,8,5,101,-56,Severe
16,5,197,F,9,5,7,67,-130,Severe
5,2,62,M,90,12,3,147,85,Well
11,4,136,F,64,9,7,115,-21,Severe
14,3,171,M,26,6,6,78,-93,Severe
12,11,155,F,17,6,0,72,-83,Severe
8,3,99,F,16,5,11,71,-28,Severe
7,4,88,F,61,9,3,111,23,Well
17,4,208,M,6,5,5,65,-143,Severe
18,2,218,M,103,13,6,162,-56,Severe
16,5,197,F,78,11,0,132,-65,Severe
17,11,215,F,60,9,2,110,-105,Severe
16,9,201,F,103,13,6,162,-39,Severe
18,1,217,M,41,7,6,90,-127,Severe
16,10,202,M,75,10,9,129,-73,Severe
18,10,226,F,67,9,10,118,-108,Severe
10,3,123,F,5,5,5,65,-58,Severe
11,9,141,F,80,11,3,135,-6,Severe
10,11,131,M,107,13,11,167,36,Well
5,11,71,F,62,9,4,112,41,Well
11,4,136,M,62,9,4,112,-24,Severe
9,9,117,F,44,7,9,93,-24,Severe
6,5,77,M,86,11,10,142,65,Well
12,10,154,M,66,9,9,117,-37,Severe
10,2,122,F,20,6,2,74,-48,Severe
7,0,84,M,80,11,3,135,51,Well
15,0,180,F,92,12,5,149,-31,Severe
7,7,91,M,7,5,6,66,-25,Severe
15,9,189,M,84,11,7,139,-50,Severe
6,11,83,M,67,9,10,118,35,Well
8,1,97,F,43,7,8,92,-5,Mild
16,1,193,F,6,5,5,65,-128,Severe
11,1,133,F,47,8,0,96,-37,Severe
17,1,205,F,22,6,3,75,-130,Severe
17,5,209,F,40,7,5,89,-120,Severe
7,3,87,M,31,6,9,81,-6,Severe
13,11,167,F,44,7,9,93,-74,Severe
12,11,155,M,85,11,9,141,-14,Severe
18,7,223,F,17,6,0,72,-151,Severe
11,0,132,M,54,8,7,103,-29,Severe
17,11,215,M,52,8,5,101,-114,Severe
14,3,171,M,9,5,7,67,-104,Severe
5,10,70,M,72,10,4,124,54,Well
5,3,63,F,43,7,8,92,29,Well
18,0,216,M,79,11,1,133,-83,Severe
9,6,114,F,12,5,9,69,-45,Severe
17,11,215,M,39,7,5,89,-126,Severe
7,0,84,F,44,7,9,93,9,Well
12,6,150,F,3,5,3,63,-87,Severe
16,3,195,M,44,7,9,93,-102,Severe
17,4,208,M,33,6,11,83,-125,Severe
15,6,186,M,35,7,1,85,-101,Severe
15,4,184,M,42,7,7,91,-93,Severe
13,0,156,M,9,5,7,67,-89,Severe
9,4,112,M,98,13,0,156,44,Well
10,1,121,M,11,5,8,68,-53,Severe
10,1,121,M,45,7,10,94,-27,Severe
7,7,91,M,42,7,7,91,0,Neutral
13,1,157,M,101,13,4,160,3,Good
17,8,212,M,9,5,7,67,-145,Severe
11,4,136,F,90,12,3,147,11,Well
6,1,73,F,55,8,8,104,31,Well
16,5,197,F,30,6,9,81,-116,Severe
7,5,89,F,95,12,9,153,64,Well
14,6,174,M,65,9,8,116,-58,Severe
12,3,147,F,13,5,9,69,-78,Severe
12,3,147,F,29,6,8,80,-67,Severe
14,10,178,M,35,7,1,85,-93,Severe
9,7,115,F,53,8,6,102,-13,Severe
11,1,133,F,92,12,5,149,16,Well
13,7,163,F,84,11,7,139,-24,Severe
8,11,107,F,3,5,3,63,-44,Severe
8,2,98,F,61,9,3,111,13,Well
14,4,172,F,49,8,2,98,-74,Severe
15,8,188,F,60,9,2,110,-78,Severe
5,2,62,F,12,5,9,69,7,Well
5,11,71,F,82,11,5,137,66,Well
12,7,151,F,51,8,4,100,-51,Severe
8,6,102,F,68,10,0,120,18,Well
8,11,107,M,61,9,3,111,4,Good
16,9,201,F,77,10,11,131,-70,Severe
13,2,158,M,81,11,4,136,-22,Severe
12,0,144,M,25,6,5,77,-67,Severe
11,6,138,M,4,5,4,64,-74,Severe
15,4,184,M,100,13,3,159,-25,Severe
5,11,71,M,52,8,5,101,30,Well
5,11,71,M,42,7,7,91,20,Well
13,1,157,F,14,5,10,70,-87,Severe
16,4,196,M,20,6,2,74,-122,Severe
12,5,149,M,105,13,9,165,16,Well
8,0,96,M,29,6,8,80,-16,Severe
17,1,205,F,23,6,4,76,-129,Severe
7,3,87,F,75,10,9,129,42,Well
11,1,133,M,28,6,8,80,-53,Severe
9,6,114,F,62,9,4,112,-2,Mild
14,2,170,F,2,5,3,63,-107,Severe
12,0,144,F,19,6,1,73,-71,Severe
9,5,113,F,98,13,0,156,43,Well
6,5,77,M,7,5,6,66,-11,Severe
13,3,159,F,84,11,7,139,-20,Severe
5,2,62,M,13,5,9,69,7,Well
7,5,89,M,17,6,0,72,-17,Severe
9,3,111,M,17,6,0,72,-39,Severe
6,11,83,F,99,13,1,157,74,Well
7,7,91,F,41,7,6,90,-1,Mild
7,5,89,F,85,11,9,141,52,Well
18,5,221,F,45,7,10,94,-127,Severe
12,3,147,M,77,10,11,131,-16,Severe
8,10,106,M,40,7,5,89,-17,Severe
17,6,210,F,14,5,10,70,-140,Severe
8,10,106,F,42,7,7,91,-15,Severe
16,10,202,M,79,11,1,133,-69,Severe
17,0,204,M,32,6,10,82,-122,Severe
11,6,138,F,2,5,3,63,-75,Severe
18,5,221,F,53,8,6,102,-119,Severe
9,3,111,M,95,12,9,153,42,Well
6,1,73,F,54,8,7,103,30,Well
11,5,137,M,49,8,2,98,-39,Severe
6,1,73,M,3,5,3,63,-10,Severe
18,10,226,F,49,8,2,98,-128,Severe
15,4,184,F,106,13,10,166,-18,Severe
13,0,156,F,62,9,4,112,-44,Severe
10,3,123,F,55,8,8,104,-19,Severe
7,0,84,F,66,9,9,117,33,Well
14,1,169,M,24,6,5,77,-92,Severe
18,10,226,M,9,5,7,67,-159,Severe
17,9,213,M,64,9,7,115,-98,Severe
7,4,88,M,108,14,0,168,80,Well
16,5,197,F,61,9,3,111,-86,Severe
18,6,222,M,104,13,7,163,-59,Severe
14,11,179,F,33,6,11,83,-96,Severe
6,2,74,M,90,12,3,147,73,Well
12,9,153,M,44,7,9,93,-60,Severe
13,0,156,M,57,8,10,106,-50,Severe
13,4,160,M,15,5,11,71,-89,Severe
8,8,104,M,3,5,3,63,-41,Severe
16,0,192,M,57,8,10,106,-86,Severe
17,5,209,F,39,7,5,89,-120,Severe
17,9,213,F,110,14,3,171,-42,Severe
8,0,96,M,70,10,2,122,26,Well
11,7,139,F,69,10,1,121,-18,Severe
6,7,79,M,36,7,2,86,7,Well
16,4,196,F,83,11,6,138,-58,Severe
14,3,171,M,95,12,9,153,-18,Severe
14,10,178,M,51,8,4,100,-78,Severe
7,10,94,M,77,10,11,131,37,Well
7,2,86,F,84,11,7,139,53,Well
5,10,70,M,76,10,10,130,60,Well
10,2,122,F,78,11,0,132,10,Well
13,0,156,M,46,7,11,95,-61,Severe
11,11,143,M,89,12,1,145,2,Good
13,9,165,F,30,6,9,81,-84,Severe
7,5,89,M,40,7,5,89,0,Neutral
16,3,195,M,62,9,4,112,-83,Severe
17,2,206,F,47,8,0,96,-110,Severe
18,5,221,M,35,7,1,85,-136,Severe
6,10,82,F,28,6,8,80,-2,Mild
17,11,215,M,61,9,3,111,-104,Severe
10,3,123,M,14,5,10,70,-53,Severe
10,7,127,M,72,10,4,124,-3,Mild
6,6,78,M,108,14,0,168,90,Well
14,11,179,F,41,7,6,90,-89,Severe
12,1,145,F,39,7,5,89,-56,Severe
14,7,175,M,43,7,8,92,-83,Severe
15,4,184,F,108,14,0,168,-16,Severe
18,11,227,F,28,6,8,80,-147,Severe
9,3,111,F,108,14,0,168,57,Well
11,6,138,F,69,10,1,121,-17,Severe
11,6,138,F,58,9,0,108,-30,Severe
16,1,193,F,33,6,11,83,-110,Severe
9,1,109,F,24,6,5,77,-32,Severe
16,6,198,F,83,11,6,138,-60,Severe
7,3,87,F,22,6,3,75,-12,Severe
15,3,183,F,14,5,10,70,-113,Severe
6,1,73,M,86,11,10,142,69,Well
10,10,130,F,29,6,8,80,-50,Severe
18,3,219,F,96,12,10,154,-65,Severe
15,10,190,M,105,13,9,165,-25,Severe
15,11,191,F,104,13,7,163,-28,Severe
13,3,159,F,108,14,0,168,9,Well
8,7,103,F,4,5,4,64,-39,Severe
11,11,143,F,14,5,10,70,-73,Severe
7,4,88,M,39,7,5,89,1,Good
8,10,106,M,100,13,3,159,53,Well
6,9,81,M,35,7,1,85,4,Good
7,9,93,F,106,13,10,166,73,Well
11,7,139,F,106,13,10,166,27,Well
6,3,75,F,70,10,2,122,47,Well
18,9,225,F,34,7,0,84,-141,Severe
7,11,95,M,18,6,1,73,-22,Severe
7,6,90,F,89,12,1,145,55,Well
5,1,61,M,35,7,1,85,24,Well
8,6,102,M,86,11,10,142,40,Well
7,6,90,F,82,11,5,137,47,Well
8,10,106,M,91,12,4,148,42,Well
6,1,73,F,23,6,4,76,3,Good
16,10,202,M,26,6,6,78,-124,Severe
6,2,74,M,94,12,7,151,77,Well
15,6,186,M,62,9,4,112,-74,Severe
15,10,190,M,15,5,11,71,-119,Severe
8,3,99,M,34,7,0,84,-15,Severe
14,10,178,M,5,5,5,65,-113,Severe
7,2,86,F,75,10,9,129,43,Well
10,6,126,M,67,9,10,118,-8,Severe
7,3,87,F,36,7,2,86,-1,Mild
18,6,222,F,53,8,6,102,-120,Severe
16,11,203,F,35,7,1,85,-118,Severe
11,1,133,M,89,12,1,145,12,Well
9,4,112,F,58,9,0,108,-4,Mild
12,0,144,F,55,8,8,104,-40,Severe
17,2,206,F,78,11,0,132,-74,Severe
11,0,132,M,37,7,3,87,-45,Severe
5,11,71,F,49,8,2,98,27,Well
17,3,207,M,7,5,6,66,-141,Severe
5,3,63,M,31,6,9,81,18,Well
11,8,140,M,12,5,9,69,-71,Severe
10,4,124,F,95,12,9,153,29,Well
6,0,72,M,3,5,3,63,-9,Severe
18,5,221,M,103,13,6,162,-59,Severe
7,8,92,F,18,6,1,73,-19,Severe
11,9,141,F,49,8,2,98,-43,Severe
13,0,156,F,30,6,9,81,-75,Severe
7,9,93,M,62,9,4,112,19,Well
17,11,215,F,8,5,6,66,-149,Severe
18,1,217,M,102,13,6,162,-55,Severe
18,1,217,F,81,11,4,136,-81,Severe
18,8,224,M,97,12,11,155,-69,Severe
18,2,218,F,19,6,1,73,-145,Severe
14,0,168,F,14,5,10,70,-98,Severe
17,0,204,M,4,5,4,64,-140,Severe
5,8,68,M,49,8,2,98,30,Well
15,1,181,F,48,8,1,97,-84,Severe
10,11,131,M,86,11,10,142,11,Well
13,7,163,M,71,10,3,123,-40,Severe
15,9,189,M,96,12,10,154,-35,Severe
13,0,156,M,93,12,6,150,-6,Severe
5,2,62,M,109,14,1,169,107,Well
8,5,101,M,2,5,3,63,-38,Severe
10,5,125,M,68,10,0,120,-5,Mild
7,2,86,F,2,5,3,63,-23,Severe
10,9,129,M,79,11,1,133,4,Good
7,1,85,M,100,13,3,159,74,Well
14,10,178,M,61,9,3,111,-67,Severe
6,11,83,M,83,11,6,138,55,Well
13,11,167,M,48,8,1,97,-70,Severe
18,4,220,F,89,12,1,145,-75,Severe
15,3,183,F,105,13,9,165,-18,Severe
17,0,204,F,4,5,4,64,-140,Severe
17,7,211,M,46,7,11,95,-116,Severe
18,0,216,F,18,6,1,73,-143,Severe
10,11,131,M,14,5,10,70,-61,Severe
11,3,135,M,86,11,10,142,7,Well
9,7,115,M,79,11,1,133,18,Well
6,2,74,M,17,6,0,72,-2,Mild
17,8,212,F,91,12,4,148,-64,Severe
14,4,172,F,102,13,6,162,-10,Severe
13,11,167,F,25,6,5,77,-90,Severe
11,0,132,F,83,11,6,138,6,Well
7,6,90,F,87,11,11,143,53,Well
7,8,92,F,80,11,3,135,43,Well
17,0,204,F,67,9,10,118,-86,Severe
13,3,159,M,7,5,6,66,-93,Severe
7,3,87,F,63,9,6,114,27,Well
17,9,213,F,99,13,1,157,-56,Severe
14,10,178,F,31,6,9,81,-97,Severe
17,0,204,F,94,12,7,151,-53,Severe
13,7,163,M,86,11,10,142,-21,Severe
5,3,63,F,18,6,1,73,10,Well
10,7,127,M,62,9,4,112,-15,Severe
11,11,143,M,24,6,5,77,-66,Severe
11,0,132,F,105,13,9,165,33,Well
15,5,185,M,12,5,9,69,-116,Severe
7,11,95,F,16,5,11,71,-24,Severe
14,2,170,F,60,9,2,110,-60,Severe
18,3,219,F,75,10,9,129,-90,Severe
12,5,149,F,107,13,11,167,18,Well
12,7,151,M,33,6,11,83,-68,Severe
17,11,215,M,110,14,3,171,-44,Severe
17,1,205,M,105,13,9,165,-40,Severe
11,6,138,F,22,6,3,75,-63,Severe
9,10,118,M,46,7,11,95,-23,Severe
7,1,85,F,25,6,5,77,-8,Severe
12,9,153,M,77,10,11,131,-22,Severe
16,1,193,M,78,11,0,132,-61,Severe
8,3,99,M,25,6,5,77,-22,Severe
14,8,176,M,91,12,4,148,-28,Severe
9,7,115,F,15,5,11,71,-44,Severe
12,6,150,M,54,8,7,103,-47,Severe
18,7,223,M,26,6,6,78,-145,Severe
7,3,87,F,104,13,7,163,76,Well
10,11,131,F,32,6,10,82,-49,Severe
12,7,151,M,23,6,4,76,-75,Severe
17,8,212,M,38,7,4,88,-124,Severe
6,0,72,M,15,5,11,71,-1,Mild
8,7,103,M,93,12,6,150,47,Well
11,3,135,F,10,5,7,67,-68,Severe
11,4,136,M,47,8,0,96,-40,Severe
9,2,110,M,26,6,6,78,-32,Severe
13,5,161,F,47,8,0,96,-65,Severe
5,2,62,F,67,9,10,118,56,Well
10,7,127,F,19,6,1,73,-54,Severe
13,10,166,F,24,6,5,77,-89,Severe
18,5,221,M,79,11,1,133,-88,Severe
9,9,117,M,20,6,2,74,-43,Severe
8,3,99,F,21,6,2,74,-25,Severe
18,4,220,M,46,7,11,95,-125,Severe
17,5,209,F,56,8,9,105,-104,Severe
15,8,188,F,32,6,10,82,-106,Severe
8,10,106,M,74,10,7,127,21,Well
7,8,92,M,33,6,11,83,-9,Severe
16,10,202,M,93,12,6,150,-52,Severe
16,8,200,M,57,8,10,106,-94,Severe
12,4,148,M,103,13,6,162,14,Well
15,6,186,M,57,8,10,106,-80,Severe
12,8,152,M,49,8,2,98,-54,Severe
10,11,131,M,25,6,5,77,-54,Severe
8,1,97,M,102,13,6,162,65,Well
8,7,103,M,27,6,7,79,-24,Severe
7,3,87,F,77,10,11,131,44,Well
8,3,99,F,6,5,5,65,-34,Severe
15,1,181,M,42,7,7,91,-90,Severe
12,8,152,M,87,11,11,143,-9,Severe
6,8,80,M,52,8,5,101,21,Well
18,4,220,M,108,14,0,168,-52,Severe
18,3,219,F,12,5,9,69,-150,Severe
15,11,191,M,26,6,6,78,-113,Severe
15,2,182,M,80,11,3,135,-47,Severe
12,9,153,M,33,6,11,83,-70,Severe
8,7,103,M,45,7,10,94,-9,Severe
12,8,152,M,94,12,7,151,-1,Mild
17,7,211,M,39,7,5,89,-122,Severe
18,5,221,M,81,11,4,136,-85,Severe
11,0,132,M,33,6,11,83,-49,Severe
7,6,90,F,108,14,0,168,78,Well
12,5,149,F,27,6,7,79,-70,Severe
8,4,100,F,54,8,7,103,3,Good
8,11,107,M,3,5,3,63,-44,Severe
6,8,80,M,80,11,3,135,55,Well
6,1,73,M,50,8,3,99,26,Well
7,0,84,M,47,8,0,96,12,Well
7,2,86,M,89,12,1,145,59,Well
17,3,207,M,25,6,5,77,-130,Severe
9,3,111,M,98,13,0,156,45,Well
6,3,75,M,69,10,1,121,46,Well
11,1,133,M,106,13,10,166,33,Well
13,10,166,M,107,13,11,167,1,Good
7,8,92,M,79,11,1,133,41,Well
13,8,164,F,16,5,11,71,-93,Severe
14,1,169,M,23,6,4,76,-93,Severe
10,0,120,F,110,14,3,171,51,Well
16,1,193,F,42,7,7,91,-102,Severe
5,6,66,F,105,13,9,165,99,Well
18,8,224,M,89,12,1,145,-79,Severe
11,10,142,F,13,5,9,69,-73,Severe
18,11,227,F,103,13,6,162,-65,Severe
9,10,118,F,33,6,11,83,-35,Severe
12,7,151,F,49,8,2,98,-53,Severe
15,7,187,F,75,10,9,129,-58,Severe
15,2,182,M,17,6,0,72,-110,Severe
5,11,71,M,56,8,9,105,34,Well
5,3,63,M,97,12,11,155,92,Well
9,6,114,F,34,7,0,84,-30,Severe
8,3,99,F,62,9,4,112,13,Well
10,3,123,M,24,6,5,77,-46,Severe
9,8,116,M,59,9,1,109,-7,Severe
5,11,71,F,6,5,5,65,-6,Severe
13,6,162,F,22,6,3,75,-87,Severe
7,7,91,M,100,13,3,159,68,Well
17,8,212,F,83,11,6,138,-74,Severe
6,0,72,F,31,6,9,81,9,Well
15,6,186,M,49,8,2,98,-88,Severe
15,10,190,M,87,11,11,143,-47,Severe
7,5,89,M,72,10,4,124,35,Well
18,2,218,M,104,13,7,163,-55,Severe
17,11,215,M,14,5,10,70,-145,Severe
10,6,126,F,26,6,6,78,-48,Severe
8,3,99,F,69,10,1,121,22,Well
16,3,195,F,89,12,1,145,-50,Severe
14,0,168,F,60,9,2,110,-58,Severe
16,8,200,M,52,8,5,101,-99,Severe
10,10,130,M,9,5,7,67,-63,Severe
6,4,76,M,76,10,10,130,54,Well
16,10,202,F,94,12,7,151,-51,Severe
15,0,180,F,49,8,2,98,-82,Severe
8,0,96,F,89,12,1,145,49,Well
7,0,84,F,53,8,6,102,18,Well
18,6,222,M,70,10,2,122,-100,Severe
16,10,202,M,106,13,10,166,-36,Severe
13,0,156,F,104,13,7,163,7,Well
17,6,210,M,21,6,2,74,-136,Severe
18,3,219,F,37,7,3,87,-132,Severe
9,5,113,M,56,8,9,105,-8,Severe
15,10,190,M,110,14,3,171,-19,Severe
7,11,95,F,63,9,6,114,19,Well
17,9,213,M,4,5,4,64,-149,Severe
7,7,91,F,48,8,1,97,6,Well
7,8,92,F,79,11,1,133,41,Well
17,5,209,M,101,13,4,160,-49,Severe
9,0,108,M,25,6,5,77,-31,Severe
15,3,183,M,98,13,0,156,-27,Severe
16,8,200,F,58,9,0,108,-92,Severe
7,7,91,F,20,6,2,74,-17,Severe
16,9,201,M,36,7,2,86,-115,Severe
7,7,91,M,21,6,2,74,-17,Severe
9,11,119,F,85,11,9,141,22,Well
5,4,64,M,49,8,2,98,34,Well
5,7,67,F,31,6,9,81,14,Well
12,5,149,F,99,13,1,157,8,Well
12,8,152,F,42,7,7,91,-61,Severe
6,10,82,F,5,5,5,65,-17,Severe
13,5,161,M,56,8,9,105,-56,Severe
8,5,101,F,12,5,9,69,-32,Severe
8,8,104,F,57,8,10,106,2,Good
15,10,190,M,24,6,5,77,-113,Severe
6,4,76,M,39,7,5,89,13,Well
7,6,90,M,93,12,6,150,60,Well
14,3,171,M,53,8,6,102,-69,Severe
12,10,154,F,42,7,7,91,-63,Severe
15,0,180,F,30,6,9,81,-99,Severe
9,7,115,M,108,14,0,168,53,Well
12,6,150,M,101,13,4,160,10,Well
6,11,83,M,106,13,10,166,83,Well
16,3,195,M,97,12,11,155,-40,Severe
14,0,168,M,49,8,2,98,-70,Severe
9,7,115,M,40,7,5,89,-26,Severe
11,7,139,F,36,7,2,86,-53,Severe
16,5,197,M,92,12,5,149,-48,Severe
10,9,129,M,94,12,7,151,22,Well
9,0,108,F,92,12,5,149,41,Well
15,3,183,F,43,7,8,92,-91,Severe
15,11,191,F,38,7,4,88,-103,Severe
16,9,201,F,12,5,9,69,-132,Severe
12,7,151,F,58,9,0,108,-43,Severe
9,10,118,F,16,5,11,71,-47,Severe
18,11,227,F,4,5,4,64,-163,Severe
18,9,225,F,51,8,4,100,-125,Severe
11,9,141,M,13,5,9,69,-72,Severe
8,3,99,M,38,7,4,88,-11,Severe
6,8,80,M,63,9,6,114,34,Well
13,7,163,F,6,5,5,65,-98,Severe
7,6,90,F,6,5,5,65,-25,Severe
11,11,143,F,50,8,3,99,-44,Severe
6,4,76,F,26,6,6,78,2,Good
10,6,126,F,44,7,9,93,-33,Severe
17,11,215,F,74,10,7,127,-88,Severe
10,11,131,M,108,14,0,168,37,Well
15,10,190,M,13,5,9,69,-121,Severe
16,10,202,F,49,8,2,98,-104,Severe
5,6,66,F,26,6,6,78,12,Well
8,1,97,F,95,12,9,153,56,Well
17,11,215,M,77,10,11,131,-84,Severe
18,11,227,F,45,7,10,94,-133,Severe
11,5,137,F,33,6,11,83,-54,Severe
10,3,123,M,85,11,9,141,18,Well
8,11,107,F,72,10,4,124,17,Well
13,1,157,F,18,6,1,73,-84,Severe
12,9,153,F,28,6,8,80,-73,Severe
16,1,193,M,57,8,10,106,-87,Severe
7,9,93,M,89,12,1,145,52,Well
6,4,76,F,49,8,2,98,22,Well
16,8,200,M,107,13,11,167,-33,Severe
17,6,210,M,60,9,2,110,-100,Severe
5,9,69,M,27,6,7,79,10,Well
9,11,119,F,34,7,0,84,-35,Severe
17,7,211,F,34,7,0,84,-127,Severe
7,4,88,M,2,5,3,63,-25,Severe
10,0,120,F,10,5,7,67,-53,Severe
6,3,75,F,108,14,0,168,93,Well
6,0,72,F,4,5,4,64,-8,Severe
12,3,147,M,35,7,1,85,-62,Severe
15,6,186,F,7,5,6,66,-120,Severe
14,8,176,F,2,5,3,63,-113,Severe
10,6,126,M,15,5,11,71,-55,Severe
17,11,215,F,87,11,11,143,-72,Severe
11,7,139,F,103,13,6,162,23,Well
16,3,195,F,6,5,5,65,-130,Severe
12,7,151,M,61,9,3,111,-40,Severe
11,3,135,M,101,13,4,160,25,Well
15,0,180,M,66,9,9,117,-63,Severe
11,8,140,M,25,6,5,77,-63,Severe
13,5,161,F,67,9,10,118,-43,Severe
14,11,179,F,93,12,6,150,-29,Severe
11,4,136,M,84,11,7,139,3,Good
8,0,96,M,85,11,9,141,45,Well
6,3,75,M,59,9,1,109,34,Well
6,4,76,F,78,11,0,132,56,Well
12,3,147,M,41,7,6,90,-57,Severe
8,3,99,M,61,9,3,111,12,Well
11,8,140,M,49,8,2,98,-42,Severe
17,7,211,M,33,6,11,83,-128,Severe
18,7,223,F,98,13,0,156,-67,Severe
12,10,154,F,108,14,0,168,14,Well
6,11,83,M,75,10,9,129,46,Well
10,10,130,F,90,12,3,147,17,Well
12,7,151,F,17,6,0,72,-79,Severe
11,3,135,M,73,10,6,126,-9,Severe
8,10,106,F,78,11,0,132,26,Well
9,3,111,M,26,6,6,78,-33,Severe
9,5,113,M,60,9,2,110,-3,Mild
17,5,209,F,18,6,1,73,-136,Severe
12,10,154,M,49,8,2,98,-56,Severe
8,11,107,F,38,7,4,88,-19,Severe
10,0,120,F,17,6,0,72,-48,Severe
17,0,204,M,51,8,4,100,-104,Severe
17,8,212,M,30,6,9,81,-131,Severe
9,3,111,M,21,6,2,74,-37,Severe
9,4,112,F,28,6,8,80,-32,Severe
7,11,95,F,94,12,7,151,56,Well
13,3,159,F,85,11,9,141,-18,Severe
9,7,115,M,74,10,7,127,12,Well
11,2,134,F,73,10,6,126,-8,Severe
10,10,130,F,21,6,2,74,-56,Severe
11,5,137,M,76,10,10,130,-7,Severe
16,0,192,F,12,5,9,69,-123,Severe
12,1,145,F,42,7,7,91,-54,Severe
9,9,117,F,6,5,5,65,-52,Severe
8,10,106,F,5,5,5,65,-41,Severe
11,0,132,M,38,7,4,88,-44,Severe
15,11,191,F,108,14,0,168,-23,Severe
10,8,128,F,83,11,6,138,10,Well
10,8,128,F,90,12,3,147,19,Well
5,11,71,F,5,5,5,65,-6,Severe
18,2,218,F,30,6,9,81,-137,Severe
10,11,131,F,65,9,8,116,-15,Severe
5,3,63,M,70,10,2,122,59,Well
9,0,108,M,54,8,7,103,-5,Mild
10,3,123,F,9,5,7,67,-56,Severe
9,5,113,M,28,6,8,80,-33,Severe
17,2,206,F,7,5,6,66,-140,Severe
10,6,126,F,5,5,5,65,-61,Severe
13,4,160,F,38,7,4,88,-72,Severe
16,9,201,M,5,5,5,65,-136,Severe
18,11,227,M,73,10,6,126,-101,Severe
15,10,190,F,53,8,6,102,-88,Severe
7,11,95,F,100,13,3,159,64,Well
7,8,92,M,45,7,10,94,2,Good
6,1,73,M,55,8,8,104,31,Well
16,9,201,M,53,8,6,102,-99,Severe
17,3,207,M,86,11,10,142,-65,Severe
9,3,111,M,63,9,6,114,3,Good
16,4,196,M,94,12,7,151,-45,Severe
5,5,65,M,57,8,10,106,41,Well
15,10,190,M,63,9,6,114,-76,Severe
13,9,165,M,25,6,5,77,-88,Severe
15,2,182,F,52,8,5,101,-81,Severe
12,9,153,M,54,8,7,103,-50,Severe
16,1,193,M,76,10,10,130,-63,Severe
12,10,154,M,84,11,7,139,-15,Severe
16,1,193,F,4,5,4,64,-129,Severe
15,11,191,F,69,10,1,121,-70,Severe
6,3,75,M,97,12,11,155,80,Well
14,2,170,M,61,9,3,111,-59,Severe
7,8,92,M,92,12,5,149,57,Well
13,11,167,M,95,12,9,153,-14,Severe
9,7,115,F,69,10,1,121,6,Well
13,1,157,F,59,9,1,109,-48,Severe
5,2,62,M,89,12,1,145,83,Well
18,8,224,F,33,6,11,83,-141,Severe
17,8,212,F,41,7,6,90,-122,Severe
6,4,76,F,59,9,1,109,33,Well
7,0,84,M,25,6,5,77,-7,Severe
15,2,182,M,86,11,10,142,-40,Severe
17,5,209,M,87,11,11,143,-66,Severe
6,1,73,F,89,12,1,145,72,Well
11,4,136,M,68,10,0,120,-16,Severe
13,0,156,F,60,9,2,110,-46,Severe
17,10,214,F,30,6,9,81,-133,Severe
17,0,204,F,106,13,10,166,-38,Severe
18,8,224,M,88,12,0,144,-80,Severe
14,4,172,F,33,6,11,83,-89,Severe
18,6,222,M,15,5,11,71,-151,Severe
6,7,79,F,73,10,6,126,47,Well
7,1,85,F,55,8,8,104,19,Well
10,0,120,M,84,11,7,139,19,Well
6,0,72,M,57,8,10,106,34,Well
13,9,165,M,6,5,5,65,-100,Severe
5,3,63,M,18,6,1,73,10,Well
7,2,86,M,61,9,3,111,25,Well
9,4,112,F,49,8,2,98,-14,Severe
10,10,130,M,36,7,2,86,-44,Severe
14,0,168,F,36,7,2,86,-82,Severe
12,6,150,F,58,9,0,108,-42,Severe
14,7,175,M,99,13,1,157,-18,Severe
12,3,147,F,7,5,6,66,-81,Severe
15,10,190,F,61,9,3,111,-79,Severe
12,11,155,M,88,12,0,144,-11,Severe
10,6,126,F,70,10,2,122,-4,Mild
5,5,65,M,47,8,0,96,31,Well
8,3,99,M,94,12,7,151,52,Well
10,0,120,M,9,5,7,67,-53,Severe
16,8,200,M,56,8,9,105,-95,Severe
8,5,101,F,19,6,1,73,-28,Severe
17,3,207,M,81,11,4,136,-71,Severe
14,3,171,M,69,10,1,121,-50,Severe
10,2,122,M,18,6,1,73,-49,Severe
13,2,158,M,16,5,11,71,-87,Severe
6,3,75,M,65,9,8,116,41,Well
14,7,175,F,85,11,9,141,-34,Severe
12,1,145,M,20,6,2,74,-71,Severe
18,7,223,M,102,13,6,162,-61,Severe
7,8,92,M,87,11,11,143,51,Well
9,8,116,M,56,8,9,105,-11,Severe
11,9,141,F,16,5,11,71,-70,Severe
6,5,77,M,94,12,7,151,74,Well
11,6,138,F,16,5,11,71,-67,Severe
14,7,175,M,31,6,9,81,-94,Severe
11,11,143,F,53,8,6,102,-41,Severe
8,2,98,F,97,12,11,155,57,Well
16,1,193,M,84,11,7,139,-54,Severe
10,3,123,M,57,8,10,106,-17,Severe
5,3,63,F,28,6,8,80,17,Well
9,5,113,M,53,8,6,102,-11,Severe
9,6,114,F,15,5,11,71,-43,Severe
14,11,179,F,11,5,8,68,-111,Severe
17,4,208,M,65,9,8,116,-92,Severe
17,11,215,F,28,6,8,80,-135,Severe
14,0,168,M,35,7,1,85,-83,Severe
18,5,221,F,44,7,9,93,-128,Severe
10,4,124,M,17,6,0,72,-52,Severe
12,3,147,M,82,11,5,137,-10,Severe
6,7,79,M,34,7,0,84,5,Good
11,3,135,F,15,5,11,71,-64,Severe
5,8,68,M,7,5,6,66,-2,Mild
10,2,122,F,64,9,7,115,-7,Severe
12,3,147,F,18,6,1,73,-74,Severe
8,10,106,F,39,7,5,89,-17,Severe
9,2,110,M,59,9,1,109,-1,Mild
6,7,79,M,46,7,11,95,16,Well
15,3,183,M,83,11,6,138,-45,Severe
13,5,161,M,15,5,11,71,-90,Severe
16,1,193,F,100,13,3,159,-34,Severe
17,4,208,F,58,9,0,108,-100,Severe
12,7,151,M,17,6,0,72,-79,Severe
16,10,202,M,84,11,7,139,-63,Severe
10,2,122,F,46,7,11,95,-27,Severe
7,2,86,M,5,5,5,65,-21,Severe
16,4,196,F,50,8,3,99,-97,Severe
17,11,215,M,19,6,1,73,-142,Severe
13,1,157,M,56,8,9,105,-52,Severe
6,10,82,M,48,8,1,97,15,Well
18,3,219,F,46,7,11,95,-124,Severe
8,2,98,M,48,8,1,97,-1,Mild
7,4,88,M,91,12,4,148,60,Well
5,10,70,F,57,8,10,106,36,Well
13,0,156,M,83,11,6,138,-18,Severe
14,3,171,M,60,9,2,110,-61,Severe
5,10,70,F,84,11,7,139,69,Well
12,9,153,F,56,8,9,105,-48,Severe
6,3,75,F,32,6,10,82,7,Well
14,6,174,F,110,14,3,171,-3,Mild
17,1,205,M,103,13,6,162,-43,Severe
5,10,70,F,78,11,0,132,62,Well
16,11,203,F,9,5,7,67,-136,Severe
8,5,101,F,37,7,3,87,-14,Severe
12,6,150,F,27,6,7,79,-71,Severe
14,3,171,M,49,8,2,98,-73,Severe
14,6,174,M,3,5,3,63,-111,Severe
14,3,171,M,34,7,0,84,-87,Severe
13,3,159,M,31,6,9,81,-78,Severe
10,5,125,M,7,5,6,66,-59,Severe
11,11,143,M,105,13,9,165,22,Well
9,6,114,F,78,11,0,132,18,Well
10,3,123,F,37,7,3,87,-36,Severe
10,10,130,F,61,9,3,111,-19,Severe
13,2,158,F,43,7,8,92,-66,Severe
5,6,66,M,82,11,5,137,71,Well
5,0,60,M,49,8,2,98,38,Well
15,3,183,M,67,9,10,118,-65,Severe
5,7,67,M,110,14,3,171,104,Well
11,1,133,M,71,10,3,123,-10,Severe
16,7,199,M,18,6,1,73,-126,Severe
6,8,80,F,90,12,3,147,67,Well
16,8,200,F,31,6,9,81,-119,Severe
5,3,63,F,102,13,6,162,99,Well
5,8,68,F,17,6,0,72,4,Good
8,2,98,M,30,6,9,81,-17,Severe
11,7,139,M,41,7,6,90,-49,Severe
5,10,70,F,7,5,6,66,-4,Mild
8,3,99,M,98,13,0,156,57,Well
11,7,139,M,50,8,3,99,-40,Severe
8,1,97,F,63,9,6,114,17,Well
6,3,75,F,34,7,0,84,9,Well
6,9,81,F,38,7,4,88,7,Well
8,3,99,F,20,6,2,74,-25,Severe
17,10,214,F,68,10,0,120,-94,Severe
9,2,110,M,110,14,3,171,61,Well
18,5,221,F,27,6,7,79,-142,Severe
18,7,223,F,72,10,4,124,-99,Severe
14,4,172,M,35,7,1,85,-87,Severe
9,9,117,M,25,6,5,77,-40,Severe
16,3,195,F,49,8,2,98,-97,Severe
12,3,147,M,12,5,9,69,-78,Severe
7,6,90,M,67,9,10,118,28,Well
9,5,113,M,12,5,9,69,-44,Severe
16,0,192,F,79,11,1,133,-59,Severe
18,1,217,F,53,8,6,102,-115,Severe
9,7,115,M,19,6,1,73,-42,Severe
11,10,142,M,9,5,7,67,-75,Severe
9,7,115,F,91,12,4,148,33,Well
5,10,70,F,31,6,9,81,11,Well
13,1,157,F,47,8,0,96,-61,Severe
18,4,220,M,34,7,0,84,-136,Severe
15,9,189,M,12,5,9,69,-120,Severe
15,3,183,M,52,8,5,101,-82,Severe
12,4,148,F,74,10,7,127,-21,Severe
15,6,186,F,97,12,11,155,-31,Severe
8,6,102,M,36,7,2,86,-16,Severe
10,1,121,M,61,9,3,111,-10,Severe
6,4,76,F,66,9,9,117,41,Well
5,6,66,M,77,10,11,131,65,Well
9,11,119,M,5,5,5,65,-54,Severe
5,5,65,M,77,10,11,131,66,Well
13,1,157,M,42,7,7,91,-66,Severe
5,6,66,M,61,9,3,111,45,Well
5,0,60,M,97,12,11,155,95,Well
6,7,79,M,64,9,7,115,36,Well
14,8,176,M,80,11,3,135,-41,Severe
11,1,133,M,97,12,11,155,22,Well
12,7,151,F,31,6,9,81,-70,Severe
15,0,180,F,59,9,1,109,-71,Severe
5,9,69,M,5,5,5,65,-4,Mild
5,3,63,F,86,11,10,142,79,Well
15,3,183,F,7,5,6,66,-117,Severe
8,10,106,F,44,7,9,93,-13,Severe
14,9,177,F,60,9,2,110,-67,Severe
10,9,129,M,38,7,4,88,-41,Severe
8,6,102,M,69,10,1,121,19,Well
5,9,69,F,33,6,11,83,14,Well
7,4,88,M,77,10,11,131,43,Well
8,1,97,M,53,8,6,102,5,Good
5,3,63,F,40,7,5,89,26,Well
6,7,79,F,51,8,4,100,21,Well
10,8,128,M,72,10,4,124,-4,Mild
15,3,183,F,5,5,5,65,-118,Severe
10,8,128,M,106,13,10,166,38,Well
11,6,138,M,95,12,9,153,15,Well
10,2,122,M,101,13,4,160,38,Well
12,3,147,F,20,6,2,74,-73,Severe
15,10,190,F,89,12,1,145,-45,Severe
9,3,111,M,81,11,4,136,25,Well
13,3,159,M,30,6,9,81,-78,Severe
10,9,129,M,35,7,1,85,-44,Severe
13,3,159,M,50,8,3,99,-60,Severe
12,4,148,F,93,12,6,150,2,Good
18,5,221,F,73,10,6,126,-95,Severe
18,3,219,M,46,7,11,95,-124,Severe
10,2,122,F,42,7,7,91,-31,Severe
15,5,185,M,77,10,11,131,-54,Severe
10,1,121,M,97,12,11,155,34,Well
9,3,111,M,76,10,10,130,19,Well
17,10,214,M,73,10,6,126,-88,Severe
7,10,94,F,96,12,10,154,60,Well
6,3,75,M,82,11,5,137,62,Well
6,7,79,F,28,6,8,80,1,Good
10,9,129,F,16,5,11,71,-58,Severe
16,5,197,F,79,11,1,133,-64,Severe
5,5,65,F,26,6,6,78,13,Well
6,10,82,F,79,11,1,133,51,Well
8,5,101,F,44,7,9,93,-8,Severe
9,4,112,M,90,12,3,147,35,Well
8,8,104,F,88,12,0,144,40,Well
14,5,173,F,76,10,10,130,-43,Severe
11,9,141,M,27,6,7,79,-62,Severe
13,2,158,M,15,5,11,71,-87,Severe
16,3,195,F,20,6,2,74,-121,Severe
12,10,154,M,89,12,1,145,-9,Severe
6,3,75,M,18,6,1,73,-2,Mild
10,2,122,M,57,8,10,106,-16,Severe
8,0,96,F,77,10,11,131,35,Well
12,10,154,F,79,11,1,133,-21,Severe
12,3,147,F,19,6,1,73,-74,Severe
9,2,110,F,57,8,10,106,-4,Mild
7,3,87,M,78,11,0,132,45,Well
6,8,80,M,50,8,3,99,19,Well
11,3,135,M,6,5,5,65,-70,Severe
16,3,195,F,97,12,11,155,-40,Severe
10,5,125,M,53,8,6,102,-23,Severe
14,9,177,F,39,7,5,89,-88,Severe
7,3,87,F,8,5,6,66,-21,Severe
17,2,206,F,25,6,5,77,-129,Severe
8,6,102,F,51,8,4,100,-2,Mild
17,0,204,M,97,12,11,155,-49,Severe
9,7,115,M,92,12,5,149,34,Well
13,0,156,F,13,5,9,69,-87,Severe
9,2,110,F,38,7,4,88,-22,Severe
18,7,223,M,90,12,3,147,-76,Severe
5,4,64,M,107,13,11,167,103,Well
17,7,211,F,57,8,10,106,-105,Severe
14,3,171,M,19,6,1,73,-98,Severe
7,1,85,F,96,12,10,154,69,Well
10,11,131,M,98,13,0,156,25,Well
17,2,206,F,42,7,7,91,-115,Severe
17,10,214,M,109,14,1,169,-45,Severe
11,8,140,F,96,12,10,154,14,Well
15,9,189,F,85,11,9,141,-48,Severe
12,11,155,F,29,6,8,80,-75,Severe
5,0,60,F,79,11,1,133,73,Well
11,10,142,F,89,12,1,145,3,Good
8,11,107,M,32,6,10,82,-25,Severe
13,3,159,F,51,8,4,100,-59,Severe
9,2,110,M,109,14,1,169,59,Well
6,6,78,F,4,5,4,64,-14,Severe
5,0,60,F,57,8,10,106,46,Well
5,3,63,F,35,7,1,85,22,Well
18,9,225,M,49,8,2,98,-127,Severe
18,8,224,M,90,12,3,147,-77,Severe
13,0,156,M,92,12,5,149,-7,Severe
16,8,200,M,110,14,3,171,-29,Severe
16,8,200,F,99,13,1,157,-43,Severe
9,10,118,M,109,14,1,169,51,Well
12,3,147,F,43,7,8,92,-55,Severe
8,0,96,M,100,13,3,159,63,Well
15,1,181,M,25,6,5,77,-104,Severe
6,11,83,F,54,8,7,103,20,Well
7,3,87,M,45,7,10,94,7,Well
8,3,99,M,104,13,7,163,64,Well
13,9,165,M,81,11,4,136,-29,Severe
11,6,138,F,70,10,2,122,-16,Severe
9,6,114,M,70,10,2,122,8,Well
18,7,223,M,95,12,9,153,-70,Severe
13,3,159,F,21,6,2,74,-85,Severe
14,2,170,F,54,8,7,103,-67,Severe
11,9,141,M,53,8,6,102,-39,Severe
17,0,204,F,29,6,8,80,-124,Severe
11,6,138,F,27,6,7,79,-59,Severe
6,11,83,M,108,14,0,168,85,Well
11,10,142,M,107,13,11,167,25,Well
11,4,136,F,41,7,6,90,-46,Severe
18,0,216,M,98,13,0,156,-60,Severe
17,0,204,F,30,6,9,81,-123,Severe
5,0,60,F,52,8,5,101,41,Well
14,5,173,M,38,7,4,88,-85,Severe
11,2,134,F,100,13,3,159,25,Well
6,1,73,F,78,11,0,132,59,Well
15,7,187,M,62,9,4,112,-75,Severe
16,7,199,M,80,11,3,135,-64,Severe
13,3,159,F,103,13,6,162,3,Good
13,10,166,F,12,5,9,69,-97,Severe
7,3,87,F,93,12,6,150,63,Well
13,3,159,F,3,5,3,63,-96,Severe
6,2,74,M,78,11,0,132,58,Well
7,2,86,M,4,5,4,64,-22,Severe
10,7,127,F,75,10,9,129,2,Good
14,5,173,M,33,6,11,83,-90,Severe
5,0,60,M,10,5,7,67,7,Well
10,1,121,M,107,13,11,167,46,Well
16,10,202,F,96,12,10,154,-48,Severe
8,0,96,M,46,7,11,95,-1,Mild
9,11,119,M,70,10,2,122,3,Good
7,1,85,M,108,14,0,168,83,Well
8,1,97,M,49,8,2,98,1,Good
6,10,82,M,38,7,4,88,6,Well
18,6,222,M,34,7,0,84,-138,Severe
12,3,147,F,79,11,1,133,-14,Severe
14,9,177,F,27,6,7,79,-98,Severe
8,5,101,M,61,9,3,111,10,Well
16,2,194,M,41,7,6,90,-104,Severe
10,7,127,M,12,5,9,69,-58,Severe
6,2,74,M,19,6,1,73,-1,Mild
5,2,62,M,3,5,3,63,1,Good
18,8,224,F,76,10,10,130,-94,Severe
5,10,70,M,102,13,6,162,92,Well
5,2,62,F,82,11,5,137,75,Well
8,2,98,M,66,9,9,117,19,Well
8,3,99,M,40,7,5,89,-10,Severe
7,2,86,M,9,5,7,67,-19,Severe
10,3,123,F,12,5,9,69,-54,Severe
14,6,174,F,96,12,10,154,-20,Severe
12,10,154,M,93,12,6,150,-4,Mild
16,6,198,F,69,10,1,121,-77,Severe
14,10,178,F,86,11,10,142,-36,Severe
5,2,62,F,58,9,0,108,46,Well
18,2,218,F,53,8,6,102,-116,Severe
7,3,87,M,91,12,4,148,61,Well
5,9,69,M,61,9,3,111,42,Well
10,6,126,F,52,8,5,101,-25,Severe
16,7,199,F,64,9,7,115,-84,Severe
5,0,60,F,104,13,7,163,103,Well
15,7,187,F,101,13,4,160,-27,Severe
17,8,212,F,105,13,9,165,-47,Severe
6,10,82,M,69,10,1,121,39,Well
14,5,173,M,94,12,7,151,-22,Severe
6,2,74,M,16,5,11,71,-3,Mild
5,4,64,F,37,7,3,87,23,Well
10,11,131,M,7,5,6,66,-65,Severe
9,1,109,F,72,10,4,124,15,Well
15,7,187,M,35,7,1,85,-102,Severe
18,0,216,M,26,6,6,78,-138,Severe
6,6,78,F,69,10,1,121,43,Well
16,3,195,M,10,5,7,67,-128,Severe
11,4,136,F,75,10,9,129,-7,Severe
17,3,207,F,26,6,6,78,-129,Severe
7,2,86,F,86,11,10,142,56,Well
12,1,145,F,36,7,2,86,-59,Severe
14,7,175,M,62,9,4,112,-63,Severe
13,5,161,F,100,13,3,159,-2,Mild
6,0,72,F,104,13,7,163,91,Well
14,5,173,M,106,13,10,166,-7,Severe
10,8,128,M,89,12,1,145,17,Well
18,9,225,F,78,11,0,132,-93,Severe
18,0,216,F,52,8,5,101,-115,Severe
11,2,134,F,81,11,4,136,2,Good
10,2,122,F,5,5,5,65,-57,Severe
14,1,169,M,106,13,10,166,-3,Mild
14,3,171,M,25,6,5,77,-94,Severe
17,7,211,M,45,7,10,94,-117,Severe
6,10,82,M,23,6,4,76,-6,Severe
8,4,100,M,42,7,7,91,-9,Severe
8,7,103,M,108,14,0,168,65,Well
16,0,192,M,87,11,11,143,-49,Severe
14,11,179,F,65,9,8,116,-63,Severe
12,6,150,M,53,8,6,102,-48,Severe
14,8,176,M,83,11,6,138,-38,Severe
13,1,157,F,5,5,5,65,-92,Severe
7,3,87,F,53,8,6,102,15,Well
11,9,141,M,52,8,5,101,-40,Severe
18,0,216,M,109,14,1,169,-47,Severe
6,2,74,F,81,11,4,136,62,Well
15,9,189,M,70,10,2,122,-67,Severe
10,6,126,F,103,13,6,162,36,Well
17,3,207,F,104,13,7,163,-44,Severe
16,2,194,M,104,13,7,163,-31,Severe
7,5,89,F,46,7,11,95,6,Well
14,5,173,M,56,8,9,105,-68,Severe
10,6,126,F,21,6,2,74,-52,Severe
13,2,158,M,29,6,8,80,-78,Severe
6,10,82,F,33,6,11,83,1,Good
8,2,98,M,84,11,7,139,41,Well
9,10,118,F,31,6,9,81,-37,Severe
16,7,199,M,99,13,1,157,-42,Severe
14,8,176,M,88,12,0,144,-32,Severe
10,3,123,M,61,9,3,111,-12,Severe
5,1,61,M,27,6,7,79,18,Well
17,10,214,F,23,6,4,76,-138,Severe
18,8,224,M,110,14,3,171,-53,Severe
17,7,211,M,92,12,5,149,-62,Severe
8,6,102,F,45,7,10,94,-8,Severe
9,1,109,F,31,6,9,81,-28,Severe
5,4,64,M,99,13,1,157,93,Well
18,2,218,M,76,10,10,130,-88,Severe
10,4,124,M,81,11,4,136,12,Well
5,0,60,M,37,7,3,87,27,Well
7,9,93,M,48,8,1,97,4,Good
10,5,125,M,89,12,1,145,20,Well
12,6,150,M,17,6,0,72,-78,Severe
9,4,112,M,67,9,10,118,6,Well
18,2,218,F,27,6,7,79,-139,Severe
6,11,83,M,22,6,3,75,-8,Severe
14,10,178,F,102,13,6,162,-16,Severe
12,10,154,M,92,12,5,149,-5,Mild
13,11,167,M,42,7,7,91,-76,Severe
18,3,219,M,54,8,7,103,-116,Severe
11,3,135,M,20,6,2,74,-61,Severe
17,5,209,F,79,11,1,133,-76,Severe
8,6,102,M,67,9,10,118,16,Well
9,0,108,M,77,10,11,131,23,Well
6,3,75,F,54,8,7,103,28,Well
8,0,96,M,101,13,4,160,64,Well
15,9,189,F,108,14,0,168,-21,Severe
17,3,207,F,78,11,0,132,-75,Severe
7,6,90,M,32,6,10,82,-8,Severe
13,10,166,F,46,7,11,95,-71,Severe
9,7,115,M,39,7,5,89,-26,Severe
9,5,113,M,46,7,11,95,-18,Severe
14,0,168,M,2,5,3,63,-105,Severe
6,6,78,F,102,13,6,162,84,Well
11,4,136,F,104,13,7,163,27,Well
14,1,169,F,80,11,3,135,-34,Severe
16,5,197,F,93,12,6,150,-47,Severe
14,3,171,M,97,12,11,155,-16,Severe
15,3,183,F,14,5,10,70,-113,Severe
11,8,140,M,83,11,6,138,-2,Mild
9,0,108,F,76,10,10,130,22,Well
6,3,75,M,21,6,2,74,-1,Mild
14,11,179,M,12,5,9,69,-110,Severe
13,7,163,M,47,8,0,96,-67,Severe
12,4,148,F,70,10,2,122,-26,Severe
16,9,201,F,36,7,2,86,-115,Severe
13,6,162,M,4,5,4,64,-98,Severe
8,9,105,M,77,10,11,131,26,Well
11,8,140,F,80,11,3,135,-5,Mild
18,4,220,M,9,5,7,67,-153,Severe
17,10,214,M,102,13,6,162,-52,Severe
18,1,217,M,96,12,10,154,-63,Severe
6,2,74,F,108,14,0,168,94,Well
5,7,67,M,52,8,5,101,34,Well
14,10,178,F,70,10,2,122,-56,Severe
15,6,186,F,20,6,2,74,-112,Severe
6,1,73,F,92,12,5,149,76,Well
7,4,88,M,61,9,3,111,23,Well
7,0,84,F,87,11,11,143,59,Well
12,6,150,M,13,5,9,69,-81,Severe
11,4,136,F,89,12,1,145,9,Well
18,2,218,F,3,5,3,63,-155,Severe
13,2,158,M,34,7,0,84,-74,Severe
14,7,175,M,70,10,2,122,-53,Severe
5,10,70,F,44,7,9,93,23,Well
5,0,60,M,46,7,11,95,35,Well
10,8,128,M,88,12,0,144,16,Well
6,1,73,F,5,5,5,65,-8,Severe
17,9,213,M,51,8,4,100,-113,Severe
9,9,117,F,61,9,3,111,-6,Severe
15,2,182,F,9,5,7,67,-115,Severe
11,9,141,M,47,8,0,96,-45,Severe
12,10,154,F,80,11,3,135,-19,Severe
12,1,145,F,22,6,3,75,-70,Severe
5,9,69,M,110,14,3,171,102,Well
11,1,133,F,68,10,0,120,-13,Severe
5,11,71,M,70,10,2,122,51,Well
6,3,75,F,12,5,9,69,-6,Severe
6,3,75,M,24,6,5,77,2,Good
14,6,174,M,61,9,3,111,-63,Severe
5,0,60,M,65,9,8,116,56,Well
8,9,105,F,83,11,6,138,33,Well
8,4,100,M,98,13,0,156,56,Well
7,6,90,M,78,11,0,132,42,Well
15,5,185,M,94,12,7,151,-34,Severe
7,1,85,F,61,9,3,111,26,Well
14,8,176,M,24,6,5,77,-99,Severe
17,0,204,M,15,5,11,71,-133,Severe
9,5,113,F,94,12,7,151,38,Well
17,10,214,F,103,13,6,162,-52,Severe
12,3,147,F,5,5,5,65,-82,Severe
18,10,226,M,23,6,4,76,-150,Severe
15,7,187,F,93,12,6,150,-37,Severe
10,1,121,F,22,6,3,75,-46,Severe
9,3,111,F,80,11,3,135,24,Well
5,4,64,F,96,12,10,154,90,Well
15,5,185,F,18,6,1,73,-112,Severe
10,3,123,M,52,8,5,101,-22,Severe
11,6,138,F,84,11,7,139,1,Good
12,3,147,M,84,11,7,139,-8,Severe
9,11,119,F,61,9,3,111,-8,Severe
17,10,214,M,68,10,0,120,-94,Severe
12,4,148,F,8,5,6,66,-82,Severe
14,6,174,F,11,5,8,68,-106,Severe
5,2,62,M,104,13,7,163,101,Well
15,0,180,F,67,9,10,118,-62,Severe
8,8,104,F,27,6,7,79,-25,Severe
9,11,119,M,59,9,1,109,-10,Severe
6,3,75,M,3,5,3,63,-12,Severe
17,3,207,M,89,12,1,145,-62,Severe
16,9,201,M,98,13,0,156,-45,Severe
11,2,134,M,26,6,6,78,-56,Severe
15,10,190,M,8,5,6,66,-124,Severe
8,1,97,F,103,13,6,162,65,Well
11,8,140,F,78,11,0,132,-8,Severe
14,6,174,M,82,11,5,137,-37,Severe
11,3,135,M,17,6,0,72,-63,Severe
9,9,117,M,72,10,4,124,7,Well
16,6,198,M,42,7,7,91,-107,Severe
8,11,107,F,31,6,9,81,-26,Severe
9,8,116,F,35,7,1,85,-31,Severe
10,3,123,M,41,7,6,90,-33,Severe
5,3,63,F,70,10,2,122,59,Well
5,6,66,F,71,10,3,123,57,Well
16,10,202,M,25,6,5,77,-125,Severe
7,2,86,M,98,13,0,156,70,Well
6,8,80,M,109,14,1,169,89,Well
15,0,180,F,97,12,11,155,-25,Severe
18,3,219,M,10,5,7,67,-152,Severe
13,2,158,M,30,6,9,81,-77,Severe
15,3,183,M,39,7,5,89,-94,Severe
7,3,87,M,85,11,9,141,54,Well
13,9,165,F,8,5,6,66,-99,Severe
10,0,120,M,37,7,3,87,-33,Severe
8,5,101,F,89,12,1,145,44,Well
18,4,220,M,110,14,3,171,-49,Severe
12,11,155,M,14,5,10,70,-85,Severe
16,7,199,M,59,9,1,109,-90,Severe
5,0,60,F,106,13,10,166,106,Well
9,9,117,M,19,6,1,73,-44,Severe
11,2,134,M,14,5,10,70,-64,Severe
6,2,74,M,85,11,9,141,67,Well
8,9,105,F,61,9,3,111,6,Well
12,2,146,F,110,14,3,171,25,Well
15,3,183,M,23,6,4,76,-107,Severe
17,10,214,F,27,6,7,79,-135,Severe
14,4,172,M,21,6,2,74,-98,Severe
9,11,119,M,101,13,4,160,41,Well
18,10,226,F,87,11,11,143,-83,Severe
18,7,223,F,100,13,3,159,-64,Severe
8,8,104,F,12,5,9,69,-35,Severe
6,3,75,M,77,10,11,131,56,Well
13,2,158,F,25,6,5,77,-81,Severe
17,10,214,F,56,8,9,105,-109,Severe
5,6,66,M,13,5,9,69,3,Good
11,7,139,F,98,13,0,156,17,Well
5,0,60,F,28,6,8,80,20,Well
10,4,124,M,12,5,9,69,-55,Severe
11,1,133,M,69,10,1,121,-12,Severe
12,3,147,M,60,9,2,110,-37,Severe
5,7,67,F,86,11,10,142,75,Well
13,8,164,M,97,12,11,155,-9,Severe
13,10,166,M,32,6,10,82,-84,Severe
17,3,207,M,68,10,0,120,-87,Severe
8,6,102,F,107,13,11,167,65,Well
5,6,66,F,96,12,10,154,88,Well
11,3,135,F,58,9,0,108,-27,Severe
8,10,106,M,36,7,2,86,-20,Severe
18,8,224,F,87,11,11,143,-81,Severe
10,9,129,M,96,12,10,154,25,Well
13,4,160,F,64,9,7,115,-45,Severe
11,1,133,M,43,7,8,92,-41,Severe
15,10,190,F,20,6,2,74,-116,Severe
17,2,206,F,21,6,2,74,-132,Severe
12,11,155,F,78,11,0,132,-23,Severe
7,2,86,M,46,7,11,95,9,Well
14,0,168,M,17,6,0,72,-96,Severe
13,1,157,M,108,14,0,168,11,Well
7,3,87,M,49,8,2,98,11,Well
8,3,99,F,2,5,3,63,-36,Severe
17,8,212,M,48,8,1,97,-115,Severe
16,4,196,F,78,11,0,132,-64,Severe
6,6,78,F,33,6,11,83,5,Good
8,1,97,F,71,10,3,123,26,Well
8,8,104,F,105,13,9,165,61,Well
14,3,171,F,25,6,5,77,-94,Severe
13,0,156,M,88,12,0,144,-12,Severe
7,3,87,F,34,7,0,84,-3,Mild
18,10,226,M,98,13,0,156,-70,Severe
6,4,76,F,16,5,11,71,-5,Mild
5,3,63,M,46,7,11,95,32,Well
8,3,99,F,109,14,1,169,70,Well
9,11,119,F,25,6,5,77,-42,Severe
12,3,147,F,78,11,0,132,-15,Severe
17,0,204,F,64,9,7,115,-89,Severe
18,4,220,F,110,14,3,171,-49,Severe
8,3,99,M,106,13,10,166,67,Well
9,4,112,M,16,5,11,71,-41,Severe
13,10,166,M,92,12,5,149,-17,Severe
9,1,109,M,110,14,3,171,62,Well
13,1,157,M,3,5,3,63,-94,Severe
13,11,167,F,95,12,9,153,-14,Severe
15,6,186,M,84,11,7,139,-47,Severe
9,8,116,F,86,11,10,142,26,Well
11,5,137,M,30,6,9,81,-56,Severe
6,3,75,M,50,8,3,99,24,Well
9,3,111,M,56,8,9,105,-6,Severe
9,3,111,M,18,6,1,73,-38,Severe
7,6,90,M,64,9,7,115,25,Well
7,4,88,F,33,6,11,83,-5,Mild
7,11,95,F,87,11,11,143,48,Well
12,2,146,F,59,9,1,109,-37,Severe
18,8,224,F,75,10,9,129,-95,Severe
7,10,94,M,70,10,2,122,28,Well
8,3,99,M,92,12,5,149,50,Well
6,10,82,F,34,7,0,84,2,Good
9,9,117,F,16,5,11,71,-46,Severe
7,0,84,F,55,8,8,104,20,Well
6,3,75,F,67,9,10,118,43,Well
9,3,111,M,92,12,5,149,38,Well
10,6,126,M,57,8,10,106,-20,Severe
15,1,181,M,100,13,3,159,-22,Severe
5,3,63,M,86,11,10,142,79,Well
11,7,139,F,2,5,3,63,-76,Severe
16,5,197,F,44,7,9,93,-104,Severe
17,8,212,F,9,5,7,67,-145,Severe
6,2,74,F,22,6,3,75,1,Good
18,0,216,F,91,12,4,148,-68,Severe
6,10,82,M,93,12,6,150,68,Well
12,4,148,M,44,7,9,93,-55,Severe
17,4,208,M,27,6,7,79,-129,Severe
9,7,115,M,11,5,8,68,-47,Severe
13,1,157,F,16,5,11,71,-86,Severe
17,5,209,F,20,6,2,74,-135,Severe
7,7,91,F,91,12,4,148,57,Well
16,3,195,M,96,12,10,154,-41,Severe
8,4,100,M,81,11,4,136,36,Well
16,5,197,F,37,7,3,87,-110,Severe
10,4,124,F,61,9,3,111,-13,Severe
8,9,105,M,80,11,3,135,30,Well
14,3,171,M,15,5,11,71,-100,Severe
5,4,64,F,43,7,8,92,28,Well
17,11,215,M,73,10,6,126,-89,Severe
7,8,92,F,45,7,10,94,2,Good
5,9,69,F,3,5,3,63,-6,Severe
15,3,183,F,47,8,0,96,-87,Severe
18,3,219,M,74,10,7,127,-92,Severe
14,10,178,M,21,6,2,74,-104,Severe
16,9,201,M,48,8,1,97,-104,Severe
8,1,97,M,84,11,7,139,42,Well
9,1,109,F,51,8,4,100,-9,Severe
13,10,166,F,45,7,10,94,-72,Severe
16,2,194,F,33,6,11,83,-111,Severe
10,8,128,F,23,6,4,76,-52,Severe
9,4,112,F,35,7,1,85,-27,Severe
6,1,73,M,54,8,7,103,30,Well
11,0,132,M,77,10,11,131,-1,Mild
14,0,168,M,38,7,4,88,-80,Severe
5,1,61,M,28,6,8,80,19,Well
10,11,131,M,18,6,1,73,-58,Severe
18,3,219,M,56,8,9,105,-114,Severe
14,3,171,F,86,11,10,142,-29,Severe
8,10,106,M,3,5,3,63,-43,Severe
12,11,155,F,103,13,6,162,7,Well
7,8,92,F,42,7,7,91,-1,Mild
11,5,137,M,41,7,6,90,-47,Severe
12,8,152,M,26,6,6,78,-74,Severe
18,2,218,F,14,5,10,70,-148,Severe
14,2,170,F,16,5,11,71,-99,Severe
14,6,174,F,9,5,7,67,-107,Severe
6,0,72,M,82,11,5,137,65,Well
9,0,108,F,96,12,10,154,46,Well
7,4,88,F,91,12,4,148,60,Well
11,8,140,M,82,11,5,137,-3,Mild
7,3,87,F,25,6,5,77,-10,Severe
17,2,206,F,92,12,5,149,-57,Severe
9,6,114,F,96,12,10,154,40,Well
14,2,170,F,67,9,10,118,-52,Severe
6,1,73,M,28,6,8,80,7,Well
5,5,65,F,22,6,3,75,10,Well
12,3,147,M,45,7,10,94,-53,Severe
9,11,119,M,24,6,5,77,-42,Severe
18,3,219,M,101,13,4,160,-59,Severe
5,9,69,F,41,7,6,90,21,Well
8,4,100,M,83,11,6,138,38,Well
14,7,175,F,36,7,2,86,-89,Severe
17,7,211,F,82,11,5,137,-74,Severe
7,3,87,M,31,6,9,81,-6,Severe
15,3,183,M,56,8,9,105,-78,Severe
9,7,115,M,93,12,6,150,35,Well
18,2,218,F,91,12,4,148,-70,Severe
17,4,208,M,62,9,4,112,-96,Severe
13,11,167,F,66,9,9,117,-50,Severe
14,5,173,F,68,10,0,120,-53,Severe
9,5,113,F,23,6,4,76,-37,Severe
11,10,142,F,44,7,9,93,-49,Severe
14,7,175,M,105,13,9,165,-10,Severe
7,8,92,M,72,10,4,124,32,Well
18,0,216,M,16,5,11,71,-145,Severe
9,10,118,F,40,7,5,89,-29,Severe
6,10,82,M,109,14,1,169,87,Well
17,3,207,F,17,6,0,72,-135,Severe
12,4,148,F,3,5,3,63,-85,Severe
13,3,159,F,49,8,2,98,-61,Severe
14,0,168,F,70,10,2,122,-46,Severe
7,6,90,M,99,13,1,157,67,Well
15,9,189,M,14,5,10,70,-119,Severe
9,8,116,M,11,5,8,68,-48,Severe
14,4,172,F,101,13,4,160,-12,Severe
15,2,182,M,29,6,8,80,-102,Severe
13,8,164,F,72,10,4,124,-40,Severe
17,4,208,M,87,11,11,143,-65,Severe
18,0,216,M,6,5,5,65,-151,Severe
12,5,149,F,55,8,8,104,-45,Severe
6,9,81,F,54,8,7,103,22,Well
6,3,75,F,27,6,7,79,4,Good
8,7,103,F,82,11,5,137,34,Well
13,7,163,M,80,11,3,135,-28,Severe
17,0,204,F,73,10,6,126,-78,Severe
8,8,104,F,87,11,11,143,39,Well
5,2,62,F,10,5,7,67,5,Good
8,3,99,M,87,11,11,143,44,Well
9,1,109,M,74,10,7,127,18,Well
16,4,196,F,21,6,2,74,-122,Severe
14,3,171,M,109,14,1,169,-2,Mild
16,1,193,F,63,9,6,114,-79,Severe
9,1,109,F,97,12,11,155,46,Well
12,3,147,F,24,6,5,77,-70,Severe
5,11,71,F,30,6,9,81,10,Well
14,9,177,F,31,6,9,81,-96,Severe
11,0,132,M,104,13,7,163,31,Well
14,11,179,M,91,12,4,148,-31,Severe
10,10,130,F,84,11,7,139,9,Well
18,3,219,M,90,12,3,147,-72,Severe
8,1,97,F,14,5,10,70,-27,Severe
9,5,113,M,34,7,0,84,-29,Severe
10,6,126,F,67,9,10,118,-8,Severe
16,8,200,F,9,5,7,67,-133,Severe
7,11,95,M,7,5,6,66,-29,Severe
13,6,162,M,34,7,0,84,-78,Severe
12,6,150,F,65,9,8,116,-34,Severe
8,4,100,F,44,7,9,93,-7,Severe
15,0,180,M,73,10,6,126,-54,Severe
5,3,63,M,32,6,10,82,19,Well
16,3,195,M,57,8,10,106,-89,Severe
14,6,174,M,96,12,10,154,-20,Severe
7,9,93,F,99,13,1,157,64,Well
5,1,61,M,50,8,3,99,38,Well
16,5,197,F,18,6,1,73,-124,Severe
14,2,170,M,25,6,5,77,-93,Severe
10,3,123,M,81,11,4,136,13,Well
16,6,198,F,92,12,5,149,-49,Severe
7,6,90,F,59,9,1,109,19,Well
8,9,105,M,71,10,3,123,18,Well
10,11,131,M,19,6,1,73,-58,Severe
11,3,135,M,21,6,2,74,-61,Severe
6,5,77,F,59,9,1,109,32,Well
8,9,105,F,70,10,2,122,17,Well
5,3,63,M,103,13,6,162,99,Well
16,5,197,F,28,6,8,80,-117,Severe
18,2,218,F,85,11,9,141,-77,Severe
9,2,110,F,25,6,5,77,-33,Severe
16,7,199,F,37,7,3,87,-112,Severe
9,5,113,F,106,13,10,166,53,Well
7,9,93,F,91,12,4,148,55,Well
16,8,200,F,76,10,10,130,-70,Severe
12,9,153,M,16,5,11,71,-82,Severe
11,0,132,F,8,5,6,66,-66,Severe
6,6,78,F,23,6,4,76,-2,Mild
9,3,111,M,47,8,0,96,-15,Severe
9,11,119,M,14,5,10,70,-49,Severe
9,7,115,M,90,12,3,147,32,Well
16,3,195,M,49,8,2,98,-97,Severe
9,3,111,F,20,6,2,74,-37,Severe
13,6,162,F,29,6,8,80,-82,Severe
15,5,185,M,65,9,8,116,-69,Severe
16,2,194,F,101,13,4,160,-34,Severe
14,3,171,M,66,9,9,117,-54,Severe
15,3,183,F,28,6,8,80,-103,Severe
12,3,147,F,91,12,4,148,1,Good
14,11,179,M,100,13,3,159,-20,Severe
13,1,157,F,76,10,10,130,-27,Severe
15,8,188,M,109,14,1,169,-19,Severe
14,0,168,M,74,10,7,127,-41,Severe
5,11,71,F,99,13,1,157,86,Well
6,9,81,M,33,6,11,83,2,Good
6,4,76,F,105,13,9,165,89,Well
13,1,157,M,44,7,9,93,-64,Severe
13,9,165,F,49,8,2,98,-67,Severe
11,3,135,M,75,10,9,129,-6,Severe
11,3,135,M,71,10,3,123,-12,Severe
13,4,160,M,31,6,9,81,-79,Severe
7,7,91,M,108,14,0,168,77,Well
12,11,155,M,53,8,6,102,-53,Severe
10,11,131,F,56,8,9,105,-26,Severe
14,2,170,F,38,7,4,88,-82,Severe
5,4,64,F,24,6,5,77,13,Well
18,7,223,F,76,10,10,130,-93,Severe
11,4,136,F,95,12,9,153,17,Well
15,1,181,M,59,9,1,109,-72,Severe
17,3,207,F,71,10,3,123,-84,Severe
5,3,63,F,74,10,7,127,64,Well
11,2,134,M,95,12,9,153,19,Well
14,3,171,F,69,10,1,121,-50,Severe
11,8,140,M,90,12,3,147,7,Well
9,9,117,M,33,6,11,83,-34,Severe
7,7,91,M,83,11,6,138,47,Well
10,2,122,F,94,12,7,151,29,Well
11,3,135,M,14,5,10,70,-65,Severe
8,3,99,M,6,5,5,65,-34,Severe
5,5,65,M,62,9,4,112,47,Well
13,7,163,F,71,10,3,123,-40,Severe
18,7,223,F,62,9,4,112,-111,Severe
10,1,121,M,93,12,6,150,29,Well
18,8,224,M,49,8,2,98,-126,Severe
8,9,105,M,27,6,7,79,-26,Severe
16,0,192,M,70,10,2,122,-70,Severe
9,5,113,F,100,13,3,159,46,Well
6,4,76,M,47,8,0,96,20,Well
13,4,160,M,3,5,3,63,-97,Severe
6,11,83,F,68,10,0,120,37,Well
12,4,148,F,12,5,9,69,-79,Severe
7,9,93,M,99,13,1,157,64,Well
9,4,112,M,59,9,1,109,-3,Mild
18,0,216,M,63,9,6,114,-102,Severe
11,2,134,F,61,9,3,111,-23,Severe
9,3,111,F,69,10,1,121,10,Well
11,8,140,F,6,5,5,65,-75,Severe
8,11,107,F,39,7,5,89,-18,Severe
18,6,222,F,32,6,10,82,-140,Severe
8,0,96,M,53,8,6,102,6,Well
8,1,97,F,101,13,4,160,63,Well
7,2,86,F,47,8,0,96,10,Well
18,6,222,F,107,13,11,167,-55,Severe
6,3,75,F,27,6,7,79,4,Good
16,0,192,F,83,11,6,138,-54,Severe
18,10,226,F,41,7,6,90,-136,Severe
8,7,103,F,26,6,6,78,-25,Severe
14,5,173,F,44,7,9,93,-80,Severe
7,3,87,F,102,13,6,162,75,Well
11,10,142,F,46,7,11,95,-47,Severe
5,3,63,F,27,6,7,79,16,Well
11,11,143,F,10,5,7,67,-76,Severe
6,2,74,M,41,7,6,90,16,Well
6,9,81,M,30,6,9,81,0,Neutral
5,8,68,F,58,9,0,108,40,Well
16,2,194,M,22,6,3,75,-119,Severe
9,6,114,F,66,9,9,117,3,Good
13,11,167,F,17,6,0,72,-95,Severe
10,3,123,F,62,9,4,112,-11,Severe
9,6,114,F,21,6,2,74,-40,Severe
15,1,181,M,8,5,6,66,-115,Severe
5,8,68,M,17,6,0,72,4,Good
11,10,142,M,79,11,1,133,-9,Severe
6,10,82,F,103,13,6,162,80,Well
11,1,133,M,79,11,1,133,0,Neutral
11,6,138,M,49,8,2,98,-40,Severe
11,0,132,M,95,12,9,153,21,Well
6,1,73,F,7,5,6,66,-7,Severe
18,7,223,M,41,7,6,90,-133,Severe
6,4,76,F,86,11,10,142,66,Well
8,4,100,M,3,5,3,63,-37,Severe
18,6,222,M,27,6,7,79,-143,Severe
14,2,170,F,102,13,6,162,-8,Severe
5,6,66,F,82,11,5,137,71,Well
12,2,146,M,48,8,1,97,-49,Severe
18,9,225,F,61,9,3,111,-114,Severe
8,2,98,F,42,7,7,91,-7,Severe
5,10,70,M,108,14,0,168,98,Well
12,10,154,F,45,7,10,94,-60,Severe
18,3,219,F,102,13,6,162,-57,Severe
10,9,129,M,105,13,9,165,36,Well
18,7,223,F,90,12,3,147,-76,Severe
12,8,152,F,21,6,2,74,-78,Severe
16,3,195,M,89,12,1,145,-50,Severe
18,3,219,M,76,10,10,130,-89,Severe
13,5,161,F,53,8,6,102,-59,Severe
15,6,186,F,92,12,5,149,-37,Severe
12,0,144,M,29,6,8,80,-64,Severe
17,0,204,M,90,12,3,147,-57,Severe
11,10,142,M,72,10,4,124,-18,Severe
12,1,145,F,2,5,3,63,-82,Severe
18,3,219,M,48,8,1,97,-122,Severe
9,8,116,M,40,7,5,89,-27,Severe
9,3,111,M,85,11,9,141,30,Well
7,7,91,F,84,11,7,139,48,Well
12,7,151,M,31,6,9,81,-70,Severe
5,3,63,F,73,10,6,126,63,Well
14,5,173,M,32,6,10,82,-91,Severe
15,7,187,M,24,6,5,77,-110,Severe
16,10,202,M,28,6,8,80,-122,Severe
12,4,148,F,4,5,4,64,-84,Severe
12,0,144,F,2,5,3,63,-81,Severe
15,0,180,F,31,6,9,81,-99,Severe
7,5,89,F,53,8,6,102,13,Well
10,7,127,M,92,12,5,149,22,Well
17,11,215,M,79,11,1,133,-82,Severe
11,6,138,F,89,12,1,145,7,Well
8,8,104,F,67,9,10,118,14,Well
5,0,60,M,55,8,8,104,44,Well
8,5,101,F,48,8,1,97,-4,Mild
13,3,159,M,101,13,4,160,1,Good
8,1,97,M,9,5,7,67,-30,Severe
13,10,166,M,28,6,8,80,-86,Severe
17,0,204,M,105,13,9,165,-39,Severe
8,10,106,F,70,10,2,122,16,Well
12,6,150,M,15,5,11,71,-79,Severe
18,3,219,M,73,10,6,126,-93,Severe
6,11,83,M,3,5,3,63,-20,Severe
15,6,186,M,28,6,8,80,-106,Severe
5,8,68,F,45,7,10,94,26,Well
11,7,139,F,34,7,0,84,-55,Severe
10,6,126,M,29,6,8,80,-46,Severe
13,10,166,M,68,10,0,120,-46,Severe
10,4,124,F,56,8,9,105,-19,Severe
18,4,220,F,106,13,10,166,-54,Severe
16,5,197,M,61,9,3,111,-86,Severe
16,0,192,F,91,12,4,148,-44,Severe
12,9,153,M,79,11,1,133,-20,Severe
17,10,214,M,90,12,3,147,-67,Severe
16,8,200,M,43,7,8,92,-108,Severe
5,0,60,F,90,12,3,147,87,Well
9,3,111,M,51,8,4,100,-11,Severe
13,7,163,M,41,7,6,90,-73,Severe
18,8,224,F,67,9,10,118,-106,Severe
10,8,128,F,57,8,10,106,-22,Severe
6,7,79,M,109,14,1,169,90,Well
13,11,167,M,31,6,9,81,-86,Severe
12,8,152,F,31,6,9,81,-71,Severe
18,6,222,M,26,6,6,78,-144,Severe
17,2,206,F,97,12,11,155,-51,Severe
18,11,227,F,108,14,0,168,-59,Severe
5,1,61,M,26,6,6,78,17,Well
15,11,191,M,46,7,11,95,-96,Severe
13,10,166,M,5,5,5,65,-101,Severe
13,8,164,F,40,7,5,89,-75,Severe
15,3,183,F,59,9,1,109,-74,Severe
9,1,109,F,74,10,7,127,18,Well
9,7,115,M,24,6,5,77,-38,Severe
11,6,138,F,65,9,8,116,-22,Severe
15,4,184,M,7,5,6,66,-118,Severe
13,5,161,F,106,13,10,166,5,Good
12,5,149,F,88,12,0,144,-5,Mild
17,5,209,M,23,6,4,76,-133,Severe
11,9,141,M,78,11,0,132,-9,Severe
8,3,99,F,103,13,6,162,63,Well
18,3,219,M,64,9,7,115,-104,Severe
17,5,209,F,85,11,9,141,-68,Severe
16,0,192,F,34,7,0,84,-108,Severe
6,9,81,F,33,6,11,83,2,Good
18,6,222,M,72,10,4,124,-98,Severe
15,2,182,F,78,11,0,132,-50,Severe
13,9,165,F,109,14,1,169,4,Good
12,3,147,M,77,10,11,131,-16,Severe
18,7,223,F,47,8,0,96,-127,Severe
6,7,79,F,27,6,7,79,0,Neutral
5,6,66,M,91,12,4,148,82,Well
10,1,121,F,107,13,11,167,46,Well
15,0,180,M,33,6,11,83,-97,Severe
14,7,175,F,61,9,3,111,-64,Severe
12,4,148,F,44,7,9,93,-55,Severe
15,3,183,M,90,12,3,147,-36,Severe
10,3,123,M,44,7,9,93,-30,Severe
15,3,183,F,84,11,7,139,-44,Severe
10,2,122,F,70,10,2,122,0,Neutral
10,9,129,F,20,6,2,74,-55,Severe
17,3,207,M,61,9,3,111,-96,Severe
14,9,177,F,11,5,8,68,-109,Severe
17,10,214,M,37,7,3,87,-127,Severe
17,3,207,F,77,10,11,131,-76,Severe
18,3,219,M,63,9,6,114,-105,Severe
17,9,213,F,76,10,10,130,-83,Severe
13,4,160,F,65,9,8,116,-44,Severe
16,11,203,F,20,6,2,74,-129,Severe
9,9,117,F,64,9,7,115,-2,Mild
15,7,187,M,5,5,5,65,-122,Severe
8,3,99,M,72,10,4,124,25,Well
16,2,194,F,34,7,0,84,-110,Severe
11,3,135,F,110,14,3,171,36,Well
5,3,63,F,26,6,6,78,15,Well
7,1,85,F,94,12,7,151,66,Well
8,2,98,F,27,6,7,79,-19,Severe
17,3,207,F,66,9,9,117,-90,Severe
11,1,133,M,29,6,8,80,-53,Severe
6,9,81,F,28,6,8,80,-1,Mild
7,10,94,F,43,7,8,92,-2,Mild
10,1,121,F,8,5,6,66,-55,Severe
15,10,190,M,4,5,4,64,-126,Severe
9,3,111,M,97,12,11,155,44,Well
7,4,88,F,79,11,1,133,45,Well
11,3,135,M,84,11,7,139,4,Good
9,10,118,F,46,7,11,95,-23,Severe
16,4,196,F,34,7,0,84,-112,Severe
12,7,151,M,24,6,5,77,-74,Severe
11,6,138,F,96,12,10,154,16,Well
18,2,218,M,14,5,10,70,-148,Severe
9,9,117,F,27,6,7,79,-38,Severe
9,11,119,M,93,12,6,150,31,Well
5,3,63,F,15,5,11,71,8,Well
13,7,163,F,33,6,11,83,-80,Severe
6,8,80,F,68,10,0,120,40,Well
5,8,68,M,8,5,6,66,-2,Mild
8,4,100,F,110,14,3,171,71,Well
14,8,176,F,23,6,4,76,-100,Severe
7,4,88,M,110,14,3,171,83,Well
7,8,92,F,43,7,8,92,0,Neutral
6,11,83,M,76,10,10,130,47,Well
6,6,78,F,82,11,5,137,59,Well
15,5,185,F,82,11,5,137,-48,Severe
6,0,72,M,76,10,10,130,58,Well
12,1,145,M,56,8,9,105,-40,Severe
17,3,207,M,42,7,7,91,-116,Severe
10,4,124,F,57,8,10,106,-18,Severe
12,10,154,F,109,14,1,169,15,Well
18,5,221,F,66,9,9,117,-104,Severe
16,9,201,M,13,5,9,69,-132,Severe
11,10,142,M,65,9,8,116,-26,Severe
15,1,181,F,71,10,3,123,-58,Severe
6,7,79,M,108,14,0,168,89,Well
9,11,119,M,104,13,7,163,44,Well
8,7,103,M,56,8,9,105,2,Good
10,9,129,M,21,6,2,74,-55,Severe
10,0,120,M,59,9,1,109,-11,Severe
18,10,226,F,8,5,6,66,-160,Severe
5,11,71,F,33,6,11,83,12,Well
10,5,125,M,107,13,11,167,42,Well
10,3,123,M,35,7,1,85,-38,Severe
11,5,137,F,85,11,9,141,4,Good
6,10,82,M,13,5,9,69,-13,Severe
5,3,63,M,9,5,7,67,4,Good
6,3,75,M,19,6,1,73,-2,Mild
11,4,136,M,44,7,9,93,-43,Severe
18,10,226,F,100,13,3,159,-67,Severe
8,4,100,M,50,8,3,99,-1,Mild
15,2,182,M,84,11,7,139,-43,Severe
8,0,96,F,50,8,3,99,3,Good
15,8,188,M,95,12,9,153,-35,Severe
12,9,153,M,23,6,4,76,-77,Severe
9,0,108,M,23,6,4,76,-32,Severe
6,6,78,M,19,6,1,73,-5,Mild
7,1,85,F,57,8,10,106,21,Well
6,11,83,F,36,7,2,86,3,Good
17,10,214,F,72,10,4,124,-90,Severe
13,5,161,F,43,7,8,92,-69,Severe
9,7,115,M,26,6,6,78,-37,Severe
11,11,143,M,30,6,9,81,-62,Severe
12,3,147,F,110,14,3,171,24,Well
15,7,187,M,77,10,11,131,-56,Severe
5,10,70,F,50,8,3,99,29,Well
5,7,67,M,42,7,7,91,24,Well
14,1,169,F,76,10,10,130,-39,Severe
8,6,102,M,95,12,9,153,51,Well
6,5,77,F,106,13,10,166,89,Well
5,10,70,M,55,8,8,104,34,Well
17,11,215,M,18,6,1,73,-142,Severe
12,6,150,M,82,11,5,137,-13,Severe
15,10,190,M,52,8,5,101,-89,Severe
8,9,105,M,43,7,8,92,-13,Severe
7,7,91,M,33,6,11,83,-8,Severe
8,7,103,F,107,13,11,167,64,Well
10,9,129,M,40,7,5,89,-40,Severe
7,3,87,F,89,12,1,145,58,Well
14,5,173,M,34,7,0,84,-89,Severe
8,0,96,M,60,9,2,110,14,Well
6,7,79,F,64,9,7,115,36,Well
8,11,107,F,9,5,7,67,-40,Severe
11,3,135,F,86,11,10,142,7,Well
8,1,97,M,14,5,10,70,-27,Severe
11,4,136,F,55,8,8,104,-32,Severe
10,2,122,F,9,5,7,67,-55,Severe
16,8,200,F,71,10,3,123,-77,Severe
9,9,117,F,63,9,6,114,-3,Mild
5,5,65,M,4,5,4,64,-1,Mild
7,8,92,F,54,8,7,103,11,Well
12,11,155,F,41,7,6,90,-65,Severe
15,8,188,M,40,7,5,89,-99,Severe
7,2,86,F,36,7,2,86,0,Neutral
16,11,203,M,39,7,5,89,-114,Severe
5,4,64,M,59,9,1,109,45,Well
6,6,78,M,80,11,3,135,57,Well
11,2,134,M,70,10,2,122,-12,Severe
11,11,143,F,58,9,0,108,-35,Severe
12,7,151,F,26,6,6,78,-73,Severe
10,3,123,M,64,9,7,115,-8,Severe
18,2,218,M,101,13,4,160,-58,Severe
9,4,112,M,77,10,11,131,19,Well
14,0,168,F,29,6,8,80,-88,Severe
17,1,205,F,60,9,2,110,-95,Severe
16,4,196,M,101,13,4,160,-36,Severe
8,1,97,F,107,13,11,167,70,Well
7,3,87,F,31,6,9,81,-6,Severe
18,7,223,F,95,12,9,153,-70,Severe
9,1,109,M,103,13,6,162,53,Well
6,1,73,F,108,14,0,168,95,Well
9,11,119,M,28,6,8,80,-39,Severe
5,1,61,F,88,12,0,144,83,Well
13,10,166,M,34,7,0,84,-82,Severe
7,5,89,M,16,5,11,71,-18,Severe
11,9,141,F,74,10,7,127,-14,Severe
6,7,79,F,47,8,0,96,17,Well
11,7,139,F,79,11,1,133,-6,Severe
5,0,60,F,100,13,3,159,99,Well
10,2,122,M,80,11,3,135,13,Well
7,4,88,M,54,8,7,103,15,Well
10,6,126,F,20,6,2,74,-52,Severe
6,2,74,M,48,8,1,97,23,Well
9,11,119,F,80,11,3,135,16,Well
11,2,134,M,12,5,9,69,-65,Severe
18,7,223,M,46,7,11,95,-128,Severe
14,2,170,M,16,5,11,71,-99,Severe
14,0,168,M,29,6,8,80,-88,Severe
9,2,110,F,79,11,1,133,23,Well
12,5,149,F,85,11,9,141,-8,Severe
15,10,190,F,36,7,2,86,-104,Severe
13,6,162,M,7,5,6,66,-96,Severe
5,9,69,F,31,6,9,81,12,Well
17,8,212,M,7,5,6,66,-146,Severe
18,4,220,F,75,10,9,129,-91,Severe
12,4,148,M,54,8,7,103,-45,Severe
7,3,87,M,57,8,10,106,19,Well
18,3,219,M,64,9,7,115,-104,Severe
14,6,174,M,66,9,9,117,-57,Severe
10,9,129,F,70,10,2,122,-7,Severe
18,11,227,F,53,8,6,102,-125,Severe
16,11,203,M,91,12,4,148,-55,Severe
13,3,159,M,100,13,3,159,0,Neutral
5,1,61,M,55,8,8,104,43,Well
5,3,63,F,42,7,7,91,28,Well
15,0,180,F,108,14,0,168,-12,Severe
5,6,66,F,65,9,8,116,50,Well
7,11,95,M,28,6,8,80,-15,Severe
12,0,144,F,99,13,1,157,13,Well
12,4,148,M,3,5,3,63,-85,Severe
16,2,194,F,66,9,9,117,-77,Severe
6,5,77,M,87,11,11,143,66,Well
10,3,123,M,58,9,0,108,-15,Severe
17,1,205,F,68,10,0,120,-85,Severe
9,5,113,M,9,5,7,67,-46,Severe
12,3,147,M,101,13,4,160,13,Well
17,0,204,M,54,8,7,103,-101,Severe
7,10,94,F,9,5,7,67,-27,Severe
11,3,135,F,97,12,11,155,20,Well
18,7,223,M,74,10,7,127,-96,Severe
18,7,223,M,110,14,3,171,-52,Severe
6,4,76,M,79,11,1,133,57,Well
13,10,166,F,16,5,11,71,-95,Severe
17,6,210,F,6,5,5,65,-145,Severe
17,5,209,M,97,12,11,155,-54,Severe
18,1,217,F,16,5,11,71,-146,Severe
18,11,227,F,86,11,10,142,-85,Severe
12,8,152,M,46,7,11,95,-57,Severe
7,3,87,F,55,8,8,104,17,Well
14,2,170,M,46,7,11,95,-75,Severe
16,9,201,F,25,6,5,77,-124,Severe
6,4,76,F,53,8,6,102,26,Well
18,6,222,F,70,10,2,122,-100,Severe
16,1,193,F,71,10,3,123,-70,Severe
10,3,123,F,75,10,9,129,6,Well
18,4,220,F,63,9,6,114,-106,Severe
7,3,87,F,99,13,1,157,70,Well
13,2,158,M,11,5,8,68,-90,Severe
11,8,140,F,87,11,11,143,3,Good
16,11,203,F,54,8,7,103,-100,Severe
9,0,108,M,93,12,6,150,42,Well
6,5,77,M,16,5,11,71,-6,Severe
12,6,150,M,61,9,3,111,-39,Severe
16,11,203,M,30,6,9,81,-122,Severe
10,2,122,M,29,6,8,80,-42,Severe
15,10,190,M,85,11,9,141,-49,Severe
15,9,189,M,92,12,5,149,-40,Severe
14,5,173,M,51,8,4,100,-73,Severe
9,9,117,F,66,9,9,117,0,Neutral
13,5,161,M,5,5,5,65,-96,Severe
18,3,219,F,44,7,9,93,-126,Severe
13,2,158,F,49,8,2,98,-60,Severe
18,5,221,M,43,7,8,92,-129,Severe
11,1,133,M,51,8,4,100,-33,Severe
12,9,153,F,71,10,3,123,-30,Severe
10,9,129,F,106,13,10,166,37,Well
9,2,110,M,32,6,10,82,-28,Severe
15,3,183,M,36,7,2,86,-97,Severe
15,9,189,F,60,9,2,110,-79,Severe
12,1,145,F,55,8,8,104,-41,Severe
9,8,116,M,28,6,8,80,-36,Severe
9,10,118,F,94,12,7,151,33,Well
7,0,84,F,110,14,3,171,87,Well
16,11,203,F,15,5,11,71,-132,Severe
7,9,93,F,37,7,3,87,-6,Severe
15,3,183,F,36,7,2,86,-97,Severe
12,10,154,M,38,7,4,88,-66,Severe
7,2,86,F,9,5,7,67,-19,Severe
12,7,151,M,104,13,7,163,12,Well
6,8,80,M,38,7,4,88,8,Well
8,2,98,F,105,13,9,165,67,Well
7,7,91,F,19,6,1,73,-18,Severe
14,2,170,F,58,9,0,108,-62,Severe
9,3,111,M,11,5,8,68,-43,Severe
12,4,148,M,55,8,8,104,-44,Severe
15,2,182,F,69,10,1,121,-61,Severe
13,3,159,F,40,7,5,89,-70,Severe
11,3,135,M,96,12,10,154,19,Well
14,4,172,M,49,8,2,98,-74,Severe
13,4,160,F,59,9,1,109,-51,Severe
13,0,156,F,94,12,7,151,-5,Mild
16,4,196,M,6,5,5,65,-131,Severe
6,2,74,F,85,11,9,141,67,Well
8,2,98,F,34,7,0,84,-14,Severe
6,9,81,F,66,9,9,117,36,Well
10,2,122,F,87,11,11,143,21,Well
12,4,148,F,17,6,0,72,-76,Severe
12,2,146,M,107,13,11,167,21,Well
16,10,202,F,42,7,7,91,-111,Severe
10,10,130,M,81,11,4,136,6,Well
18,0,216,M,60,9,2,110,-106,Severe
6,11,83,M,109,14,1,169,86,Well
5,0,60,F,69,10,1,121,61,Well
7,11,95,M,27,6,7,79,-16,Severe
16,3,195,M,2,5,3,63,-132,Severe
14,10,178,F,105,13,9,165,-13,Severe
15,7,187,F,10,5,7,67,-120,Severe
15,8,188,M,2,5,3,63,-125,Severe
5,8,68,M,22,6,3,75,7,Well
10,1,121,M,49,8,2,98,-23,Severe
15,2,182,F,60,9,2,110,-72,Severe
7,11,95,M,106,13,10,166,71,Well
10,2,122,M,89,12,1,145,23,Well
6,2,74,M,46,7,11,95,21,Well
6,3,75,F,31,6,9,81,6,Well
13,2,158,M,90,12,3,147,-11,Severe
12,2,146,M,103,13,6,162,16,Well
13,6,162,F,109,14,1,169,7,Well
7,7,91,M,98,13,0,156,65,Well
15,9,189,F,6,5,5,65,-124,Severe
11,8,140,M,37,7,3,87,-53,Severe
14,3,171,F,12,5,9,69,-102,Severe
13,8,164,M,89,12,1,145,-19,Severe
15,3,183,M,61,9,3,111,-72,Severe
5,5,65,M,79,11,1,133,68,Well
9,0,108,F,44,7,9,93,-15,Severe
15,4,184,M,56,8,9,105,-79,Severe
18,4,220,M,18,6,1,73,-147,Severe
18,8,224,M,17,6,0,72,-152,Severe
7,4,88,M,6,5,5,65,-23,Severe
17,7,211,M,53,8,6,102,-109,Severe
6,5,77,F,51,8,4,100,23,Well
15,4,184,F,6,5,5,65,-119,Severe
18,3,219,M,93,12,6,150,-69,Severe
17,3,207,F,64,9,7,115,-92,Severe
14,0,168,F,61,9,3,111,-57,Severe
16,1,193,M,65,9,8,116,-77,Severe
14,4,172,F,79,11,1,133,-39,Severe
16,3,195,F,73,10,6,126,-69,Severe
13,4,160,F,30,6,9,81,-79,Severe
7,8,92,F,59,9,1,109,17,Well
13,4,160,M,95,12,9,153,-7,Severe
15,4,184,M,83,11,6,138,-46,Severe
17,10,214,M,38,7,4,88,-126,Severe
18,7,223,M,32,6,10,82,-141,Severe
15,6,186,F,56,8,9,105,-81,Severe
9,6,114,F,88,12,0,144,30,Well
13,0,156,M,105,13,9,165,9,Well
6,10,82,M,12,5,9,69,-13,Severe
13,9,165,F,38,7,4,88,-77,Severe
15,6,186,F,12,5,9,69,-117,Severe
12,1,145,M,72,10,4,124,-21,Severe
6,9,81,M,3,5,3,63,-18,Severe
9,9,117,M,103,13,6,162,45,Well
17,10,214,M,83,11,6,138,-76,Severe
11,2,134,M,37,7,3,87,-47,Severe
6,1,73,M,84,11,7,139,66,Well
17,10,214,F,8,5,6,66,-148,Severe
14,9,177,F,8,5,6,66,-111,Severe
14,0,168,F,16,5,11,71,-97,Severe
9,6,114,F,106,13,10,166,52,Well
10,8,128,F,31,6,9,81,-47,Severe
18,1,217,M,108,14,0,168,-49,Severe
13,1,157,M,59,9,1,109,-48,Severe
11,9,141,F,88,12,0,144,3,Good
17,5,209,M,39,7,5,89,-120,Severe
14,2,170,M,47,8,0,96,-74,Severe
15,3,183,M,70,10,2,122,-61,Severe
14,3,171,F,20,6,2,74,-97,Severe
15,9,189,M,53,8,6,102,-87,Severe
6,6,78,M,65,9,8,116,38,Well
18,3,219,M,60,9,2,110,-109,Severe
5,10,70,F,108,14,0,168,98,Well
10,5,125,F,100,13,3,159,34,Well
6,11,83,M,110,14,3,171,88,Well
10,2,122,M,72,10,4,124,2,Good
17,5,209,F,73,10,6,126,-83,Severe
11,2,134,F,44,7,9,93,-41,Severe
12,3,147,M,93,12,6,150,3,Good
10,5,125,M,101,13,4,160,35,Well
15,2,182,F,46,7,11,95,-87,Severe
15,2,182,F,19,6,1,73,-109,Severe
13,4,160,M,42,7,7,91,-69,Severe
6,1,73,M,66,9,9,117,44,Well
18,8,224,M,108,14,0,168,-56,Severe
16,8,200,F,62,9,4,112,-88,Severe
11,0,132,M,80,11,3,135,3,Good
10,3,123,F,38,7,4,88,-35,Severe
8,2,98,M,97,12,11,155,57,Well
18,3,219,M,21,6,2,74,-145,Severe
15,4,184,F,57,8,10,106,-78,Severe
8,3,99,M,95,12,9,153,54,Well
18,1,217,F,104,13,7,163,-54,Severe
15,0,180,F,68,10,0,120,-60,Severe
12,6,150,M,46,7,11,95,-55,Severe
8,6,102,F,75,10,9,129,27,Well
7,3,87,M,97,12,11,155,68,Well
18,3,219,F,96,12,10,154,-65,Severe
15,3,183,F,34,7,0,84,-99,Severe
12,10,154,F,68,10,0,120,-34,Severe
17,8,212,F,35,7,1,85,-127,Severe
14,3,171,F,63,9,6,114,-57,Severe
15,5,185,F,42,7,7,91,-94,Severe
16,1,193,F,53,8,6,102,-91,Severe
18,4,220,F,26,6,6,78,-142,Severe
17,8,212,F,99,13,1,157,-55,Severe
5,3,63,M,27,6,7,79,16,Well
6,10,82,M,24,6,5,77,-5,Mild
9,4,112,M,102,13,6,162,50,Well
9,1,109,F,38,7,4,88,-21,Severe
5,0,60,M,19,6,1,73,13,Well
15,2,182,F,71,10,3,123,-59,Severe
15,9,189,M,95,12,9,153,-36,Severe
14,4,172,M,85,11,9,141,-31,Severe
6,11,83,F,92,12,5,149,66,Well
17,2,206,M,19,6,1,73,-133,Severe
12,0,144,F,31,6,9,81,-63,Severe
10,2,122,F,52,8,5,101,-21,Severe
12,8,152,F,48,8,1,97,-55,Severe
15,2,182,M,40,7,5,89,-93,Severe
11,3,135,F,57,8,10,106,-29,Severe
14,4,172,F,42,7,7,91,-81,Severe
7,1,85,F,65,9,8,116,31,Well
6,0,72,M,74,10,7,127,55,Well
12,2,146,F,86,11,10,142,-4,Mild
11,6,138,M,26,6,6,78,-60,Severe
13,6,162,M,52,8,5,101,-61,Severe
8,3,99,M,80,11,3,135,36,Well
12,3,147,F,96,12,10,154,7,Well
10,3,123,M,28,6,8,80,-43,Severe
18,6,222,M,86,11,10,142,-80,Severe
5,9,69,M,74,10,7,127,58,Well
18,9,225,M,79,11,1,133,-92,Severe
18,3,219,F,107,13,11,167,-52,Severe
10,10,130,M,21,6,2,74,-56,Severe
17,9,213,M,41,7,6,90,-123,Severe
13,0,156,M,59,9,1,109,-47,Severe
9,1,109,M,44,7,9,93,-16,Severe
11,4,136,F,13,5,9,69,-67,Severe
6,4,76,F,77,10,11,131,55,Well
11,8,140,M,42,7,7,91,-49,Severe
8,8,104,F,83,11,6,138,34,Well
18,3,219,F,3,5,3,63,-156,Severe
8,3,99,M,79,11,1,133,34,Well
8,9,105,F,88,12,0,144,39,Well
12,0,144,F,93,12,6,150,6,Well
6,9,81,F,44,7,9,93,12,Well
12,9,153,F,77,10,11,131,-22,Severe
18,9,225,M,18,6,1,73,-152,Severe
10,8,128,M,98,13,0,156,28,Well
15,7,187,M,47,8,0,96,-91,Severe
10,7,127,F,86,11,10,142,15,Well
17,3,207,F,42,7,7,91,-116,Severe
14,4,172,M,95,12,9,153,-19,Severe
16,11,203,M,63,9,6,114,-89,Severe
8,10,106,M,73,10,6,126,20,Well
16,7,199,F,76,10,10,130,-69,Severe
12,6,150,F,64,9,7,115,-35,Severe
16,9,201,F,41,7,6,90,-111,Severe
13,9,165,M,57,8,10,106,-59,Severe
7,10,94,M,95,12,9,153,59,Well
17,6,210,M,95,12,9,153,-57,Severe
9,3,111,M,90,12,3,147,36,Well
13,0,156,M,49,8,2,98,-58,Severe
15,5,185,F,39,7,5,89,-96,Severe
16,3,195,F,84,11,7,139,-56,Severe
15,1,181,M,110,14,3,171,-10,Severe
17,1,205,F,27,6,7,79,-126,Severe
15,5,185,M,75,10,9,129,-56,Severe
12,8,152,F,84,11,7,139,-13,Severe
10,2,122,M,52,8,5,101,-21,Severe
9,7,115,F,37,7,3,87,-28,Severe
14,10,178,M,18,6,1,73,-105,Severe
13,2,158,F,41,7,6,90,-68,Severe
13,7,163,M,57,8,10,106,-57,Severe
7,4,88,F,40,7,5,89,1,Good
5,4,64,F,69,10,1,121,57,Well
15,6,186,F,85,11,9,141,-45,Severe
6,3,75,M,50,8,3,99,24,Well
10,3,123,M,95,12,9,153,30,Well
9,4,112,F,46,7,11,95,-17,Severe
12,3,147,M,3,5,3,63,-84,Severe
13,6,162,M,48,8,1,97,-65,Severe
10,1,121,M,37,7,3,87,-34,Severe
10,8,128,F,45,7,10,94,-34,Severe
15,1,181,M,86,11,10,142,-39,Severe
10,1,121,F,74,10,7,127,6,Well
5,3,63,M,35,7,1,85,22,Well
10,5,125,M,6,5,5,65,-60,Severe
14,2,170,F,7,5,6,66,-104,Severe
6,2,74,M,36,7,2,86,12,Well
10,3,123,F,85,11,9,141,18,Well
6,7,79,F,108,14,0,168,89,Well
16,3,195,M,85,11,9,141,-54,Severe
18,7,223,F,82,11,5,137,-86,Severe
15,2,182,M,47,8,0,96,-86,Severe
17,1,205,M,71,10,3,123,-82,Severe
11,2,134,F,31,6,9,81,-53,Severe
12,5,149,F,25,6,5,77,-72,Severe
13,9,165,M,53,8,6,102,-63,Severe
15,0,180,F,11,5,8,68,-112,Severe
12,10,154,F,55,8,8,104,-50,Severe
9,3,111,F,72,10,4,124,13,Well
8,0,96,M,83,11,6,138,42,Well
14,4,172,M,17,6,0,72,-100,Severe
18,9,225,M,68,10,0,120,-105,Severe
11,9,141,F,5,5,5,65,-76,Severe
9,10,118,M,26,6,6,78,-40,Severe
10,2,122,M,27,6,7,79,-43,Severe
7,9,93,F,34,7,0,84,-9,Severe
6,8,80,F,13,5,9,69,-11,Severe
9,7,115,F,102,13,6,162,47,Well
12,7,151,M,30,6,9,81,-70,Severe
7,6,90,M,89,12,1,145,55,Well
11,3,135,F,63,9,6,114,-21,Severe
13,10,166,M,109,14,1,169,3,Good
11,8,140,F,38,7,4,88,-52,Severe
7,8,92,F,33,6,11,83,-9,Severe
16,7,199,F,5,5,5,65,-134,Severe
6,11,83,F,110,14,3,171,88,Well
18,1,217,F,110,14,3,171,-46,Severe
7,10,94,M,80,11,3,135,41,Well
17,4,208,F,92,12,5,149,-59,Severe
18,6,222,F,101,13,4,160,-62,Severe
14,2,170,F,110,14,3,171,1,Good
17,2,206,M,82,11,5,137,-69,Severe
8,6,102,M,81,11,4,136,34,Well
9,2,110,F,82,11,5,137,27,Well
17,4,208,F,37,7,3,87,-121,Severe
18,5,221,M,60,9,2,110,-111,Severe
9,3,111,F,90,12,3,147,36,Well
6,11,83,M,28,6,8,80,-3,Mild
15,5,185,M,17,6,0,72,-113,Severe
7,10,94,M,87,11,11,143,49,Well
7,7,91,M,86,11,10,142,51,Well
8,3,99,F,68,10,0,120,21,Well
12,5,149,M,12,5,9,69,-80,Severe
16,4,196,F,81,11,4,136,-60,Severe
9,3,111,M,75,10,9,129,18,Well
13,3,159,M,41,7,6,90,-69,Severe
5,11,71,M,13,5,9,69,-2,Mild
7,9,93,F,109,14,1,169,76,Well
14,9,177,F,106,13,10,166,-11,Severe
9,7,115,F,107,13,11,167,52,Well
6,5,77,F,56,8,9,105,28,Well
13,3,159,F,53,8,6,102,-57,Severe
15,6,186,M,77,10,11,131,-55,Severe
7,3,87,M,91,12,4,148,61,Well
11,3,135,F,26,6,6,78,-57,Severe
15,6,186,F,2,5,3,63,-123,Severe
17,6,210,M,17,6,0,72,-138,Severe
10,9,129,F,39,7,5,89,-40,Severe
18,4,220,M,44,7,9,93,-127,Severe
15,8,188,F,93,12,6,150,-38,Severe
17,9,213,M,98,13,0,156,-57,Severe
11,10,142,F,94,12,7,151,9,Well
18,7,223,M,23,6,4,76,-147,Severe
11,3,135,F,106,13,10,166,31,Well
8,1,97,M,35,7,1,85,-12,Severe
13,4,160,M,27,6,7,79,-81,Severe
17,1,205,M,77,10,11,131,-74,Severe
7,10,94,M,6,5,5,65,-29,Severe
9,10,118,M,24,6,5,77,-41,Severe
9,6,114,F,80,11,3,135,21,Well
8,8,104,F,61,9,3,111,7,Well
18,11,227,M,27,6,7,79,-148,Severe
18,6,222,F,12,5,9,69,-153,Severe
18,10,226,F,7,5,6,66,-160,Severe
6,9,81,M,10,5,7,67,-14,Severe
18,10,226,M,103,13,6,162,-64,Severe
17,8,212,F,34,7,0,84,-128,Severe
6,10,82,M,21,6,2,74,-8,Severe
16,6,198,M,54,8,7,103,-95,Severe
15,2,182,M,41,7,6,90,-92,Severe
9,10,118,F,108,14,0,168,50,Well
5,9,69,M,95,12,9,153,84,Well
17,3,207,M,95,12,9,153,-54,Severe
6,5,77,M,62,9,4,112,35,Well
10,4,124,F,10,5,7,67,-57,Severe
14,4,172,F,10,5,7,67,-105,Severe
6,4,76,M,41,7,6,90,14,Well
17,1,205,F,101,13,4,160,-45,Severe
9,11,119,M,58,9,0,108,-11,Severe
13,9,165,F,96,12,10,154,-11,Severe
13,9,165,F,14,5,10,70,-95,Severe
16,4,196,F,51,8,4,100,-96,Severe
13,4,160,F,74,10,7,127,-33,Severe
13,10,166,F,48,8,1,97,-69,Severe
7,2,86,F,91,12,4,148,62,Well
14,11,179,M,71,10,3,123,-56,Severe
14,11,179,M,28,6,8,80,-99,Severe
10,5,125,F,30,6,9,81,-44,Severe
17,3,207,F,29,6,8,80,-127,Severe
16,10,202,M,47,8,0,96,-106,Severe
16,2,194,F,23,6,4,76,-118,Severe
14,10,178,F,13,5,9,69,-109,Severe
6,9,81,F,57,8,10,106,25,Well
16,3,195,F,65,9,8,116,-79,Severe
17,5,209,M,48,8,1,97,-112,Severe
6,6,78,M,110,14,3,171,93,Well
17,11,215,M,40,7,5,89,-126,Severe
12,1,145,M,14,5,10,70,-75,Severe
18,8,224,F,46,7,11,95,-129,Severe
10,2,122,M,87,11,11,143,21,Well
8,0,96,F,97,12,11,155,59,Well
7,7,91,F,28,6,8,80,-11,Severe
7,8,92,M,40,7,5,89,-3,Mild
11,5,137,F,84,11,7,139,2,Good
9,9,117,F,110,14,3,171,54,Well
15,7,187,F,73,10,6,126,-61,Severe
6,2,74,M,82,11,5,137,63,Well
9,7,115,M,44,7,9,93,-22,Severe
6,4,76,F,58,9,0,108,32,Well
15,9,189,F,93,12,6,150,-39,Severe
14,0,168,M,63,9,6,114,-54,Severe
5,3,63,F,48,8,1,97,34,Well
9,4,112,F,77,10,11,131,19,Well
17,8,212,M,39,7,5,89,-123,Severe
9,10,118,M,78,11,0,132,14,Well
17,5,209,F,105,13,9,165,-44,Severe
16,1,193,F,3,5,3,63,-130,Severe
17,4,208,M,23,6,4,76,-132,Severe
14,2,170,M,52,8,5,101,-69,Severe
7,8,92,F,57,8,10,106,14,Well
12,3,147,M,25,6,5,77,-70,Severe
6,11,83,M,59,9,1,109,26,Well
18,2,218,M,90,12,3,147,-71,Severe
12,4,148,M,5,5,5,65,-83,Severe
12,4,148,F,104,13,7,163,15,Well
13,4,160,F,27,6,7,79,-81,Severe
18,9,225,F,23,6,4,76,-149,Severe
8,0,96,M,62,9,4,112,16,Well
12,1,145,M,91,12,4,148,3,Good
13,8,164,F,93,12,6,150,-14,Severe
7,4,88,M,47,8,0,96,8,Well
15,8,188,M,53,8,6,102,-86,Severe
9,8,116,M,50,8,3,99,-17,Severe
11,2,134,F,4,5,4,64,-70,Severe
16,9,201,F,20,6,2,74,-127,Severe
6,8,80,M,14,5,10,70,-10,Severe
6,10,82,F,107,13,11,167,85,Well
17,10,214,M,6,5,5,65,-149,Severe
11,10,142,M,48,8,1,97,-45,Severe
5,5,65,M,83,11,6,138,73,Well
5,11,71,F,92,12,5,149,78,Well
18,10,226,M,109,14,1,169,-57,Severe
7,11,95,F,75,10,9,129,34,Well
7,5,89,M,109,14,1,169,80,Well
9,5,113,M,6,5,5,65,-48,Severe
6,5,77,M,12,5,9,69,-8,Severe
12,8,152,F,4,5,4,64,-88,Severe
6,1,73,F,11,5,8,68,-5,Mild
15,9,189,M,110,14,3,171,-18,Severe
9,7,115,F,18,6,1,73,-42,Severe
14,2,170,F,30,6,9,81,-89,Severe
10,3,123,F,53,8,6,102,-21,Severe
10,2,122,F,44,7,9,93,-29,Severe
17,6,210,F,81,11,4,136,-74,Severe
7,6,90,M,73,10,6,126,36,Well
9,3,111,F,11,5,8,68,-43,Severe
13,10,166,M,57,8,10,106,-60,Severe
16,9,201,F,10,5,7,67,-134,Severe
8,3,99,M,74,10,7,127,28,Well
6,8,80,M,9,5,7,67,-13,Severe
13,6,162,M,44,7,9,93,-69,Severe
13,4,160,F,57,8,10,106,-54,Severe
7,4,88,F,35,7,1,85,-3,Mild
5,8,68,F,92,12,5,149,81,Well
16,7,199,M,92,12,5,149,-50,Severe
13,2,158,F,89,12,1,145,-13,Severe
7,4,88,M,48,8,1,97,9,Well
12,1,145,F,90,12,3,147,2,Good
7,7,91,M,68,10,0,120,29,Well
13,7,163,M,33,6,11,83,-80,Severe
15,3,183,F,66,9,9,117,-66,Severe
17,8,212,M,44,7,9,93,-119,Severe
11,4,136,F,109,14,1,169,33,Well
12,1,145,M,92,12,5,149,4,Good
9,1,109,F,34,7,0,84,-25,Severe
14,9,177,M,108,14,0,168,-9,Severe
18,7,223,M,108,14,0,168,-55,Severe
9,10,118,F,72,10,4,124,6,Well
6,4,76,F,5,5,5,65,-11,Severe
16,3,195,M,80,11,3,135,-60,Severe
16,9,201,M,17,6,0,72,-129,Severe
14,9,177,M,98,13,0,156,-21,Severe
7,1,85,F,2,5,3,63,-22,Severe
7,0,84,F,2,5,3,63,-21,Severe
10,10,130,M,14,5,10,70,-60,Severe
15,11,191,F,101,13,4,160,-31,Severe
15,0,180,M,80,11,3,135,-45,Severe
11,5,137,M,65,9,8,116,-21,Severe
9,7,115,F,103,13,6,162,47,Well
10,7,127,F,87,11,11,143,16,Well
15,3,183,M,96,12,10,154,-29,Severe
11,8,140,M,85,11,9,141,1,Good
17,8,212,F,14,5,10,70,-142,Severe
13,11,167,F,79,11,1,133,-34,Severe
16,6,198,F,47,8,0,96,-102,Severe
5,5,65,F,54,8,7,103,38,Well
14,3,171,M,99,13,1,157,-14,Severe
15,1,181,F,25,6,5,77,-104,Severe
7,7,91,M,55,8,8,104,13,Well
9,10,118,M,15,5,11,71,-47,Severe
5,9,69,M,28,6,8,80,11,Well
18,11,227,M,48,8,1,97,-130,Severe
9,1,109,F,92,12,5,149,40,Well
9,10,118,M,88,12,0,144,26,Well
18,10,226,F,23,6,4,76,-150,Severe
7,6,90,F,105,13,9,165,75,Well
16,2,194,M,38,7,4,88,-106,Severe
14,10,178,F,101,13,4,160,-18,Severe
18,10,226,M,107,13,11,167,-59,Severe
14,8,176,M,30,6,9,81,-95,Severe
16,7,199,M,50,8,3,99,-100,Severe
5,8,68,F,31,6,9,81,13,Well
7,6,90,M,106,13,10,166,76,Well
16,6,198,F,29,6,8,80,-118,Severe
18,3,219,M,101,13,4,160,-59,Severe
11,7,139,M,71,10,3,123,-16,Severe
17,8,212,F,98,13,0,156,-56,Severe
9,4,112,F,4,5,4,64,-48,Severe
8,1,97,F,105,13,9,165,68,Well
10,9,129,M,59,9,1,109,-20,Severe
16,10,202,M,19,6,1,73,-129,Severe
12,1,145,M,83,11,6,138,-7,Severe
7,8,92,M,73,10,6,126,34,Well
9,3,111,F,27,6,7,79,-32,Severe
17,3,207,F,105,13,9,165,-42,Severe
10,8,128,M,24,6,5,77,-51,Severe
7,8,92,M,91,12,4,148,56,Well
14,5,173,F,26,6,6,78,-95,Severe
15,0,180,M,7,5,6,66,-114,Severe
12,0,144,M,101,13,4,160,16,Well
11,3,135,F,21,6,2,74,-61,Severe
6,10,82,F,53,8,6,102,20,Well
7,6,90,F,97,12,11,155,65,Well
16,0,192,F,24,6,5,77,-115,Severe
10,9,129,F,18,6,1,73,-56,Severe
8,1,97,M,55,8,8,104,7,Well
10,8,128,M,91,12,4,148,20,Well
15,8,188,F,7,5,6,66,-122,Severe
15,3,183,M,15,5,11,71,-112,Severe
7,10,94,M,58,9,0,108,14,Well
7,3,87,F,101,13,4,160,73,Well
5,0,60,F,13,5,9,69,9,Well
6,0,72,M,97,12,11,155,83,Well
7,3,87,F,62,9,4,112,25,Well
5,3,63,F,30,6,9,81,18,Well
10,10,130,F,47,8,0,96,-34,Severe
7,2,86,F,25,6,5,77,-9,Severe
17,2,206,M,45,7,10,94,-112,Severe
10,9,129,M,20,6,2,74,-55,Severe
12,0,144,F,106,13,10,166,22,Well
18,4,220,F,33,6,11,83,-137,Severe
5,6,66,M,79,11,1,133,67,Well
14,1,169,F,70,10,2,122,-47,Severe
15,10,190,F,18,6,1,73,-117,Severe
15,11,191,M,91,12,4,148,-43,Severe
18,3,219,F,92,12,5,149,-70,Severe
7,1,85,M,53,8,6,102,17,Well
14,3,171,M,13,5,9,69,-102,Severe
7,3,87,M,92,12,5,149,62,Well
18,5,221,M,59,9,1,109,-112,Severe
16,7,199,F,16,5,11,71,-128,Severe
14,8,176,M,29,6,8,80,-96,Severe
9,3,111,M,74,10,7,127,16,Well
13,4,160,F,44,7,9,93,-67,Severe
18,3,219,M,68,10,0,120,-99,Severe
12,10,154,F,6,5,5,65,-89,Severe
9,10,118,M,16,5,11,71,-47,Severe
17,4,208,M,79,11,1,133,-75,Severe
16,4,196,F,68,10,0,120,-76,Severe
16,1,193,M,87,11,11,143,-50,Severe
8,9,105,M,109,14,1,169,64,Well
17,7,211,F,88,12,0,144,-67,Severe
8,3,99,M,8,5,6,66,-33,Severe
18,8,224,F,21,6,2,74,-150,Severe
16,1,193,M,73,10,6,126,-67,Severe
18,8,224,M,58,9,0,108,-116,Severe
6,3,75,M,102,13,6,162,87,Well
17,4,208,M,30,6,9,81,-127,Severe
10,0,120,F,40,7,5,89,-31,Severe
16,1,193,F,34,7,0,84,-109,Severe
8,5,101,F,2,5,3,63,-38,Severe
14,4,172,F,40,7,5,89,-83,Severe
11,4,136,F,10,5,7,67,-69,Severe
7,6,90,F,107,13,11,167,77,Well
15,8,188,F,39,7,5,89,-99,Severe
16,7,199,F,34,7,0,84,-115,Severe
9,8,116,F,55,8,8,104,-12,Severe
18,4,220,M,56,8,9,105,-115,Severe
17,0,204,M,22,6,3,75,-129,Severe
17,7,211,M,10,5,7,67,-144,Severe
6,3,75,F,7,5,6,66,-9,Severe
6,5,77,F,26,6,6,78,1,Good
8,5,101,M,27,6,7,79,-22,Severe
16,3,195,M,54,8,7,103,-92,Severe
15,4,184,M,35,7,1,85,-99,Severe
14,4,172,M,9,5,7,67,-105,Severe
8,1,97,F,35,7,1,85,-12,Severe
18,3,219,F,105,13,9,165,-54,Severe
12,0,144,F,96,12,10,154,10,Well
16,8,200,M,65,9,8,116,-84,Severe
5,5,65,F,80,11,3,135,70,Well
9,5,113,M,92,12,5,149,36,Well
8,3,99,F,71,10,3,123,24,Well
8,9,105,M,41,7,6,90,-15,Severe
17,3,207,F,38,7,4,88,-119,Severe
17,0,204,F,82,11,5,137,-67,Severe
6,1,73,M,22,6,3,75,2,Good
17,3,207,M,54,8,7,103,-104,Severe
6,11,83,F,51,8,4,100,17,Well
5,0,60,M,51,8,4,100,40,Well
16,8,200,F,57,8,10,106,-94,Severe
7,6,90,M,48,8,1,97,7,Well
16,7,199,F,3,5,3,63,-136,Severe
5,3,63,M,100,13,3,159,96,Well
6,8,80,F,75,10,9,129,49,Well
16,6,198,F,99,13,1,157,-41,Severe
13,2,158,M,91,12,4,148,-10,Severe
10,11,131,F,61,9,3,111,-20,Severe
5,1,61,F,7,5,6,66,5,Good
18,4,220,F,68,10,0,120,-100,Severe
12,6,150,F,8,5,6,66,-84,Severe
14,1,169,F,11,5,8,68,-101,Severe
18,8,224,F,110,14,3,171,-53,Severe
15,10,190,F,48,8,1,97,-93,Severe
12,0,144,M,90,12,3,147,3,Good
16,4,196,F,91,12,4,148,-48,Severe
18,7,223,M,73,10,6,126,-97,Severe
18,11,227,M,102,13,6,162,-65,Severe
9,5,113,F,20,6,2,74,-39,Severe
14,4,172,F,6,5,5,65,-107,Severe
6,4,76,F,57,8,10,106,30,Well
16,6,198,F,61,9,3,111,-87,Severe
7,3,87,F,67,9,10,118,31,Well
12,8,152,M,97,12,11,155,3,Good
18,3,219,M,87,11,11,143,-76,Severe
16,7,199,M,77,10,11,131,-68,Severe
5,1,61,M,56,8,9,105,44,Well
15,3,183,M,29,6,8,80,-103,Severe
12,1,145,F,40,7,5,89,-56,Severe
18,9,225,M,77,10,11,131,-94,Severe
16,2,194,M,55,8,8,104,-90,Severe
12,5,149,F,34,7,0,84,-65,Severe
15,7,187,F,5,5,5,65,-122,Severe
13,3,159,M,110,14,3,171,12,Well
13,2,158,F,80,11,3,135,-23,Severe
8,7,103,F,56,8,9,105,2,Good
16,0,192,M,2,5,3,63,-129,Severe
9,5,113,F,16,5,11,71,-42,Severe
9,11,119,F,32,6,10,82,-37,Severe
8,2,98,F,66,9,9,117,19,Well
5,4,64,M,108,14,0,168,104,Well
13,5,161,M,9,5,7,67,-94,Severe
13,6,162,M,37,7,3,87,-75,Severe
15,9,189,M,54,8,7,103,-86,Severe
7,8,92,M,76,10,10,130,38,Well
14,4,172,F,93,12,6,150,-22,Severe
13,3,159,M,77,10,11,131,-28,Severe
14,4,172,M,44,7,9,93,-79,Severe
8,0,96,F,93,12,6,150,54,Well
10,8,128,F,65,9,8,116,-12,Severe
17,4,208,M,68,10,0,120,-88,Severe
8,6,102,F,47,8,0,96,-6,Severe
9,10,118,M,52,8,5,101,-17,Severe
13,0,156,M,67,9,10,118,-38,Severe
15,3,183,M,61,9,3,111,-72,Severe
9,8,116,M,47,8,0,96,-20,Severe
9,6,114,M,21,6,2,74,-40,Severe
7,5,89,M,85,11,9,141,52,Well
11,11,143,M,85,11,9,141,-2,Mild
8,11,107,M,44,7,9,93,-14,Severe
11,8,140,F,101,13,4,160,20,Well
12,3,147,M,18,6,1,73,-74,Severe
14,6,174,F,46,7,11,95,-79,Severe
8,8,104,M,5,5,5,65,-39,Severe
11,9,141,F,4,5,4,64,-77,Severe
16,6,198,M,87,11,11,143,-55,Severe
8,7,103,F,28,6,8,80,-23,Severe
13,5,161,M,45,7,10,94,-67,Severe
5,8,68,M,70,10,2,122,54,Well
15,3,183,M,71,10,3,123,-60,Severe
8,1,97,M,105,13,9,165,68,Well
10,4,124,M,41,7,6,90,-34,Severe
9,9,117,F,109,14,1,169,52,Well
14,5,173,F,49,8,2,98,-75,Severe
13,9,165,M,43,7,8,92,-73,Severe
9,1,109,F,75,10,9,129,20,Well
9,9,117,M,8,5,6,66,-51,Severe
13,3,159,F,31,6,9,81,-78,Severe
12,8,152,M,104,13,7,163,11,Well
15,7,187,M,44,7,9,93,-94,Severe
8,4,100,F,98,13,0,156,56,Well
16,6,198,F,9,5,7,67,-131,Severe
15,9,189,F,56,8,9,105,-84,Severe
13,11,167,F,77,10,11,131,-36,Severe
17,7,211,F,64,9,7,115,-96,Severe
13,9,165,M,84,11,7,139,-26,Severe
16,8,200,M,72,10,4,124,-76,Severe
7,3,87,M,7,5,6,66,-21,Severe
6,3,75,F,110,14,3,171,96,Well
9,2,110,F,77,10,11,131,21,Well
5,4,64,F,51,8,4,100,36,Well
11,5,137,M,110,14,3,171,34,Well
5,10,70,F,54,8,7,103,33,Well
7,8,92,M,38,7,4,88,-4,Mild
12,6,150,M,95,12,9,153,3,Good
12,3,147,F,48,8,1,97,-50,Severe
16,5,197,F,95,12,9,153,-44,Severe
16,1,193,M,62,9,4,112,-81,Severe
6,1,73,M,70,10,2,122,49,Well
10,5,125,M,81,11,4,136,11,Well
10,10,130,M,43,7,8,92,-38,Severe
15,11,191,F,71,10,3,123,-68,Severe
10,4,124,M,61,9,3,111,-13,Severe
16,3,195,M,108,14,0,168,-27,Severe
8,2,98,F,23,6,4,76,-22,Severe
17,7,211,M,105,13,9,165,-46,Severe
18,8,224,F,93,12,6,150,-74,Severe
18,10,226,F,31,6,9,81,-145,Severe
5,0,60,F,81,11,4,136,76,Well
13,4,160,M,46,7,11,95,-65,Severe
6,4,76,M,6,5,5,65,-11,Severe
13,5,161,F,83,11,6,138,-23,Severe
12,2,146,F,107,13,11,167,21,Well
18,10,226,F,96,12,10,154,-72,Severe
15,5,185,M,66,9,9,117,-68,Severe
5,10,70,M,26,6,6,78,8,Well
9,1,109,F,11,5,8,68,-41,Severe
7,11,95,F,46,7,11,95,0,Neutral
10,6,126,M,81,11,4,136,10,Well
9,1,109,F,37,7,3,87,-22,Severe
5,1,61,M,73,10,6,126,65,Well
8,5,101,M,85,11,9,141,40,Well
9,10,118,F,110,14,3,171,53,Well
12,6,150,F,10,5,7,67,-83,Severe
5,11,71,M,48,8,1,97,26,Well
15,9,189,F,103,13,6,162,-27,Severe
5,3,63,F,29,6,8,80,17,Well
12,8,152,M,13,5,9,69,-83,Severe
16,6,198,F,50,8,3,99,-99,Severe
16,4,196,F,12,5,9,69,-127,Severe
13,6,162,M,106,13,10,166,4,Good
7,8,92,M,70,10,2,122,30,Well
9,0,108,F,66,9,9,117,9,Well
18,0,216,F,94,12,7,151,-65,Severe
5,11,71,M,53,8,6,102,31,Well
11,2,134,M,21,6,2,74,-60,Severe
12,7,151,M,21,6,2,74,-77,Severe
10,4,124,F,15,5,11,71,-53,Severe
9,0,108,F,9,5,7,67,-41,Severe
10,7,127,F,33,6,11,83,-44,Severe
10,5,125,F,58,9,0,108,-17,Severe
18,6,222,M,67,9,10,118,-104,Severe
6,8,80,M,86,11,10,142,62,Well
12,0,144,F,58,9,0,108,-36,Severe
10,8,128,M,80,11,3,135,7,Well
12,10,154,F,26,6,6,78,-76,Severe
6,6,78,F,108,14,0,168,90,Well
12,9,153,F,104,13,7,163,10,Well
14,4,172,M,68,10,0,120,-52,Severe
11,5,137,M,85,11,9,141,4,Good
7,9,93,M,101,13,4,160,67,Well
6,3,75,M,76,10,10,130,55,Well
10,7,127,F,49,8,2,98,-29,Severe
5,2,62,F,106,13,10,166,104,Well
12,8,152,M,54,8,7,103,-49,Severe
14,10,178,F,18,6,1,73,-105,Severe
16,4,196,F,22,6,3,75,-121,Severe
6,5,77,F,69,10,1,121,44,Well
18,7,223,F,37,7,3,87,-136,Severe
11,9,141,M,42,7,7,91,-50,Severe
15,11,191,M,8,5,6,66,-125,Severe
11,4,136,M,39,7,5,89,-47,Severe
18,5,221,F,14,5,10,70,-151,Severe
12,11,155,F,36,7,2,86,-69,Severe
14,6,174,F,69,10,1,121,-53,Severe
5,1,61,M,87,11,11,143,82,Well
11,9,141,F,2,5,3,63,-78,Severe
5,0,60,M,27,6,7,79,19,Well
9,5,113,M,96,12,10,154,41,Well
6,5,77,M,88,12,0,144,67,Well
10,8,128,M,105,13,9,165,37,Well
13,8,164,M,66,9,9,117,-47,Severe
14,11,179,M,44,7,9,93,-86,Severe
11,3,135,M,98,13,0,156,21,Well
6,4,76,M,92,12,5,149,73,Well
6,6,78,F,100,13,3,159,81,Well
17,7,211,M,34,7,0,84,-127,Severe
10,8,128,M,108,14,0,168,40,Well
15,8,188,F,58,9,0,108,-80,Severe
12,11,155,M,15,5,11,71,-84,Severe
15,10,190,F,38,7,4,88,-102,Severe
11,5,137,F,2,5,3,63,-74,Severe
12,4,148,F,86,11,10,142,-6,Severe
14,1,169,F,37,7,3,87,-82,Severe
10,9,129,F,80,11,3,135,6,Well
14,7,175,M,35,7,1,85,-90,Severe
16,4,196,M,45,7,10,94,-102,Severe
14,3,171,F,35,7,1,85,-86,Severe
5,0,60,F,4,5,4,64,4,Good
11,6,138,F,31,6,9,81,-57,Severe
14,8,176,M,79,11,1,133,-43,Severe
9,5,113,M,104,13,7,163,50,Well
14,0,168,F,27,6,7,79,-89,Severe
7,9,93,F,8,5,6,66,-27,Severe
6,4,76,M,69,10,1,121,45,Well
13,4,160,M,54,8,7,103,-57,Severe
7,2,86,M,66,9,9,117,31,Well
5,11,71,F,24,6,5,77,6,Well
9,0,108,F,85,11,9,141,33,Well
6,8,80,F,41,7,6,90,10,Well
5,6,66,F,69,10,1,121,55,Well
10,3,123,M,85,11,9,141,18,Well
11,3,135,F,22,6,3,75,-60,Severe
18,3,219,F,28,6,8,80,-139,Severe
7,6,90,M,98,13,0,156,66,Well
15,6,186,M,75,10,9,129,-57,Severe
8,3,99,F,52,8,5,101,2,Good
7,7,91,M,78,11,0,132,41,Well
15,8,188,M,106,13,10,166,-22,Severe
13,11,167,F,63,9,6,114,-53,Severe
15,6,186,M,46,7,11,95,-91,Severe
5,9,69,M,83,11,6,138,69,Well
14,3,171,M,101,13,4,160,-11,Severe
15,2,182,M,67,9,10,118,-64,Severe
17,5,209,M,75,10,9,129,-80,Severe
8,7,103,F,85,11,9,141,38,Well
17,1,205,F,46,7,11,95,-110,Severe
15,11,191,M,71,10,3,123,-68,Severe
7,3,87,M,95,12,9,153,66,Well
18,6,222,F,84,11,7,139,-83,Severe
8,11,107,F,76,10,10,130,23,Well
5,3,63,M,35,7,1,85,22,Well
11,1,133,M,21,6,2,74,-59,Severe
18,1,217,M,38,7,4,88,-129,Severe
16,0,192,M,62,9,4,112,-80,Severe
15,5,185,M,19,6,1,73,-112,Severe
13,8,164,M,42,7,7,91,-73,Severe
9,7,115,F,54,8,7,103,-12,Severe
8,9,105,M,69,10,1,121,16,Well
14,0,168,F,102,13,6,162,-6,Severe
14,9,177,M,54,8,7,103,-74,Severe
9,4,112,F,45,7,10,94,-18,Severe
13,7,163,M,43,7,8,92,-71,Severe
15,9,189,F,89,12,1,145,-44,Severe
10,9,129,M,81,11,4,136,7,Well
14,3,171,F,43,7,8,92,-79,Severe
15,7,187,M,69,10,1,121,-66,Severe
10,10,130,M,104,13,7,163,33,Well
16,2,194,M,65,9,8,116,-78,Severe
13,5,161,M,101,13,4,160,-1,Mild
15,7,187,F,58,9,0,108,-79,Severe
6,9,81,F,21,6,2,74,-7,Severe
9,0,108,F,55,8,8,104,-4,Mild
12,11,155,F,91,12,4,148,-7,Severe
12,2,146,M,37,7,3,87,-59,Severe
17,9,213,M,70,10,2,122,-91,Severe
18,5,221,F,7,5,6,66,-155,Severe
6,1,73,M,56,8,9,105,32,Well
17,2,206,F,70,10,2,122,-84,Severe
18,0,216,M,7,5,6,66,-150,Severe
6,6,78,M,36,7,2,86,8,Well
14,0,168,F,92,12,5,149,-19,Severe
13,10,166,M,88,12,0,144,-22,Severe
5,4,64,F,6,5,5,65,1,Good
5,3,63,F,88,12,0,144,81,Well
12,5,149,F,4,5,4,64,-85,Severe
17,7,211,F,59,9,1,109,-102,Severe
13,9,165,M,12,5,9,69,-96,Severe
15,4,184,M,85,11,9,141,-43,Severe
13,5,161,M,110,14,3,171,10,Well
17,1,205,M,33,6,11,83,-122,Severe
6,8,80,F,99,13,1,157,77,Well
6,0,72,F,51,8,4,100,28,Well
5,8,68,F,4,5,4,64,-4,Mild
13,10,166,M,24,6,5,77,-89,Severe
7,10,94,F,52,8,5,101,7,Well
6,4,76,M,17,6,0,72,-4,Mild
17,9,213,F,61,9,3,111,-102,Severe
12,10,154,F,54,8,7,103,-51,Severe
16,9,201,F,94,12,7,151,-50,Severe
5,1,61,M,11,5,8,68,7,Well
8,2,98,M,29,6,8,80,-18,Severe
8,0,96,F,79,11,1,133,37,Well
5,9,69,M,50,8,3,99,30,Well
9,5,113,F,105,13,9,165,52,Well
7,9,93,M,90,12,3,147,54,Well
9,9,117,F,8,5,6,66,-51,Severe
12,9,153,M,98,13,0,156,3,Good
12,3,147,M,65,9,8,116,-31,Severe
16,0,192,M,36,7,2,86,-106,Severe
9,3,111,F,28,6,8,80,-31,Severe
7,8,92,M,18,6,1,73,-19,Severe
8,7,103,F,44,7,9,93,-10,Severe
7,10,94,M,15,5,11,71,-23,Severe
17,10,214,M,92,12,5,149,-65,Severe
14,3,171,M,71,10,3,123,-48,Severe
5,7,67,F,46,7,11,95,28,Well
18,0,216,M,44,7,9,93,-123,Severe
5,0,60,F,98,13,0,156,96,Well
6,1,73,F,2,5,3,63,-10,Severe
16,6,198,M,14,5,10,70,-128,Severe
9,6,114,M,26,6,6,78,-36,Severe
13,2,158,F,18,6,1,73,-85,Severe
6,2,74,F,61,9,3,111,37,Well
16,3,195,M,14,5,10,70,-125,Severe
6,4,76,F,35,7,1,85,9,Well
15,7,187,F,88,12,0,144,-43,Severe
6,8,80,M,53,8,6,102,22,Well
16,8,200,M,30,6,9,81,-119,Severe
16,1,193,F,68,10,0,120,-73,Severe
10,0,120,M,46,7,11,95,-25,Severe
13,5,161,F,96,12,10,154,-7,Severe
14,11,179,F,2,5,3,63,-116,Severe
6,11,83,F,59,9,1,109,26,Well
7,6,90,F,8,5,6,66,-24,Severe
7,2,86,M,78,11,0,132,46,Well
16,5,197,M,83,11,6,138,-59,Severe
10,4,124,F,11,5,8,68,-56,Severe
14,10,178,F,92,12,5,149,-29,Severe
17,1,205,F,45,7,10,94,-111,Severe
8,5,101,F,75,10,9,129,28,Well
6,3,75,M,44,7,9,93,18,Well
8,10,106,F,47,8,0,96,-10,Severe
12,5,149,M,15,5,11,71,-78,Severe
11,2,134,M,67,9,10,118,-16,Severe
9,10,118,F,59,9,1,109,-9,Severe
10,4,124,F,110,14,3,171,47,Well
16,10,202,M,6,5,5,65,-137,Severe
16,4,196,M,12,5,9,69,-127,Severe
6,7,79,F,100,13,3,159,80,Well
7,0,84,F,91,12,4,148,64,Well
15,11,191,M,34,7,0,84,-107,Severe
18,11,227,M,53,8,6,102,-125,Severe
13,6,162,M,35,7,1,85,-77,Severe
10,5,125,F,47,8,0,96,-29,Severe
11,10,142,F,9,5,7,67,-75,Severe
18,11,227,F,54,8,7,103,-124,Severe
14,8,176,M,22,6,3,75,-101,Severe
9,6,114,M,44,7,9,93,-21,Severe
14,8,176,F,21,6,2,74,-102,Severe
16,8,200,F,92,12,5,149,-51,Severe
16,3,195,M,72,10,4,124,-71,Severe
12,3,147,F,80,11,3,135,-12,Severe
12,3,147,F,34,7,0,84,-63,Severe
6,7,79,M,48,8,1,97,18,Well
10,10,130,M,72,10,4,124,-6,Severe
10,11,131,M,56,8,9,105,-26,Severe
6,10,82,M,110,14,3,171,89,Well
17,8,212,F,94,12,7,151,-61,Severe
8,9,105,F,16,5,11,71,-34,Severe
11,1,133,F,18,6,1,73,-60,Severe
7,11,95,F,95,12,9,153,58,Well
11,0,132,F,15,5,11,71,-61,Severe
6,10,82,F,22,6,3,75,-7,Severe
12,11,155,F,22,6,3,75,-80,Severe
5,2,62,M,54,8,7,103,41,Well
10,4,124,M,16,5,11,71,-53,Severe
18,7,223,F,24,6,5,77,-146,Severe
14,5,173,M,100,13,3,159,-14,Severe
5,4,64,M,40,7,5,89,25,Well
10,1,121,M,110,14,3,171,50,Well
17,6,210,F,79,11,1,133,-77,Severe
8,2,98,F,29,6,8,80,-18,Severe
18,7,223,M,91,12,4,148,-75,Severe
11,3,135,M,45,7,10,94,-41,Severe
6,11,83,F,5,5,5,65,-18,Severe
9,3,111,M,52,8,5,101,-10,Severe
16,4,196,F,19,6,1,73,-123,Severe
13,8,164,F,30,6,9,81,-83,Severe
18,5,221,M,30,6,9,81,-140,Severe
9,6,114,F,89,12,1,145,31,Well
9,11,119,F,55,8,8,104,-15,Severe
14,7,175,F,69,10,1,121,-54,Severe
18,5,221,F,28,6,8,80,-141,Severe
5,8,68,F,48,8,1,97,29,Well
13,6,162,F,6,5,5,65,-97,Severe
15,4,184,F,51,8,4,100,-84,Severe
13,3,159,F,16,5,11,71,-88,Severe
5,7,67,M,64,9,7,115,48,Well
16,8,200,F,97,12,11,155,-45,Severe
5,1,61,F,52,8,5,101,40,Well
8,7,103,M,102,13,6,162,59,Well
11,2,134,F,14,5,10,70,-64,Severe
17,1,205,M,100,13,3,159,-46,Severe
12,6,150,F,32,6,10,82,-68,Severe
14,10,178,F,34,7,0,84,-94,Severe
7,4,88,F,9,5,7,67,-21,Severe
15,1,181,M,5,5,5,65,-116,Severe
9,3,111,F,35,7,1,85,-26,Severe
7,4,88,M,74,10,7,127,39,Well
10,8,128,F,61,9,3,111,-17,Severe
5,10,70,M,28,6,8,80,10,Well
10,4,124,F,90,12,3,147,23,Well
8,1,97,F,18,6,1,73,-24,Severe
13,1,157,M,60,9,2,110,-47,Severe
13,5,161,F,59,9,1,109,-52,Severe
6,8,80,M,46,7,11,95,15,Well
16,6,198,M,93,12,6,150,-48,Severe
6,6,78,F,10,5,7,67,-11,Severe
13,10,166,F,80,11,3,135,-31,Severe
5,0,60,F,18,6,1,73,13,Well
10,8,128,F,77,10,11,131,3,Good
16,11,203,M,9,5,7,67,-136,Severe
11,5,137,M,31,6,9,81,-56,Severe
13,7,163,F,106,13,10,166,3,Good
10,5,125,F,44,7,9,93,-32,Severe
9,6,114,M,91,12,4,148,34,Well
18,3,219,F,89,12,1,145,-74,Severe
13,0,156,F,82,11,5,137,-19,Severe
15,8,188,M,55,8,8,104,-84,Severe
6,3,75,M,97,12,11,155,80,Well
11,3,135,M,19,6,1,73,-62,Severe
11,1,133,F,82,11,5,137,4,Good
8,4,100,F,69,10,1,121,21,Well
15,4,184,F,61,9,3,111,-73,Severe
13,1,157,F,17,6,0,72,-85,Severe
13,4,160,M,55,8,8,104,-56,Severe
9,2,110,M,75,10,9,129,19,Well
6,8,80,M,31,6,9,81,1,Good
9,1,109,M,45,7,10,94,-15,Severe
8,8,104,M,58,9,0,108,4,Good
9,6,114,M,54,8,7,103,-11,Severe
14,1,169,M,27,6,7,79,-90,Severe
11,0,132,M,85,11,9,141,9,Well
17,10,214,F,2,5,3,63,-151,Severe
16,7,199,F,38,7,4,88,-111,Severe
18,5,221,M,90,12,3,147,-74,Severe
12,6,150,F,90,12,3,147,-3,Mild
16,8,200,F,78,11,0,132,-68,Severe
16,4,196,F,56,8,9,105,-91,Severe
15,3,183,M,75,10,9,129,-54,Severe
17,3,207,F,46,7,11,95,-112,Severe
13,9,165,M,8,5,6,66,-99,Severe
16,1,193,F,15,5,11,71,-122,Severe
11,2,134,M,5,5,5,65,-69,Severe
18,11,227,F,36,7,2,86,-141,Severe
17,5,209,M,80,11,3,135,-74,Severe
18,3,219,M,58,9,0,108,-111,Severe
6,6,78,F,92,12,5,149,71,Well
9,7,115,F,88,12,0,144,29,Well
18,5,221,M,63,9,6,114,-107,Severe
7,3,87,M,52,8,5,101,14,Well
15,5,185,F,76,10,10,130,-55,Severe
9,9,117,M,91,12,4,148,31,Well
10,9,129,M,30,6,9,81,-48,Severe
8,5,101,M,68,10,0,120,19,Well
6,8,80,F,58,9,0,108,28,Well
13,0,156,M,62,9,4,112,-44,Severe
18,9,225,M,54,8,7,103,-122,Severe
6,2,74,F,26,6,6,78,4,Good
9,9,117,F,69,10,1,121,4,Good
18,0,216,M,80,11,3,135,-81,Severe
10,3,123,F,94,12,7,151,28,Well
7,4,88,F,58,9,0,108,20,Well
8,6,102,M,12,5,9,69,-33,Severe
13,7,163,F,37,7,3,87,-76,Severe
14,3,171,F,89,12,1,145,-26,Severe
10,8,128,F,36,7,2,86,-42,Severe
5,1,61,M,68,10,0,120,59,Well
12,1,145,M,28,6,8,80,-65,Severe
12,10,154,F,86,11,10,142,-12,Severe
13,9,165,F,63,9,6,114,-51,Severe
14,6,174,M,100,13,3,159,-15,Severe
12,8,152,M,99,13,1,157,5,Good
9,9,117,M,66,9,9,117,0,Neutral
14,0,168,M,18,6,1,73,-95,Severe
10,3,123,F,91,12,4,148,25,Well
13,2,158,M,78,11,0,132,-26,Severe
10,1,121,M,106,13,10,166,45,Well
14,1,169,M,72,10,4,124,-45,Severe
7,10,94,M,49,8,2,98,4,Good
13,8,164,M,13,5,9,69,-95,Severe
14,6,174,M,51,8,4,100,-74,Severe
18,8,224,F,51,8,4,100,-124,Severe
10,1,121,F,81,11,4,136,15,Well
13,9,165,F,91,12,4,148,-17,Severe
13,0,156,M,29,6,8,80,-76,Severe
13,3,159,M,20,6,2,74,-85,Severe
14,3,171,F,31,6,9,81,-90,Severe
9,5,113,F,78,11,0,132,19,Well
16,6,198,M,106,13,10,166,-32,Severe
9,2,110,M,49,8,2,98,-12,Severe
16,7,199,M,12,5,9,69,-130,Severe
10,7,127,F,38,7,4,88,-39,Severe
17,3,207,F,106,13,10,166,-41,Severe
11,2,134,F,50,8,3,99,-35,Severe
12,8,152,M,34,7,0,84,-68,Severe
8,10,106,M,9,5,7,67,-39,Severe
17,2,206,M,26,6,6,78,-128,Severe
10,5,125,F,102,13,6,162,37,Well
11,0,132,M,2,5,3,63,-69,Severe
11,2,134,F,78,11,0,132,-2,Mild
18,2,218,M,20,6,2,74,-144,Severe
14,0,168,F,73,10,6,126,-42,Severe
12,4,148,F,21,6,2,74,-74,Severe
16,3,195,M,25,6,5,77,-118,Severe
5,9,69,F,78,11,0,132,63,Well
18,9,225,M,17,6,0,72,-153,Severe
17,4,208,M,105,13,9,165,-43,Severe
15,10,190,F,66,9,9,117,-73,Severe
12,5,149,M,39,7,5,89,-60,Severe
13,3,159,M,78,11,0,132,-27,Severe
6,3,75,F,39,7,5,89,14,Well
12,0,144,M,85,11,9,141,-3,Mild
11,4,136,F,22,6,3,75,-61,Severe
12,7,151,M,54,8,7,103,-48,Severe
18,11,227,F,105,13,9,165,-62,Severe
6,1,73,F,46,7,11,95,22,Well
7,3,87,F,31,6,9,81,-6,Severe
8,10,106,F,40,7,5,89,-17,Severe
10,11,131,M,43,7,8,92,-39,Severe
18,8,224,M,24,6,5,77,-147,Severe
13,4,160,M,78,11,0,132,-28,Severe
15,3,183,M,38,7,4,88,-95,Severe
6,3,75,F,52,8,5,101,26,Well
14,8,176,M,99,13,1,157,-19,Severe
9,5,113,M,37,7,3,87,-26,Severe
7,9,93,F,85,11,9,141,48,Well
13,7,163,M,21,6,2,74,-89,Severe
15,3,183,F,95,12,9,153,-30,Severe
11,6,138,F,105,13,9,165,27,Well
13,8,164,M,85,11,9,141,-23,Severe
10,9,129,F,83,11,6,138,9,Well
13,5,161,M,89,12,1,145,-16,Severe
16,11,203,F,102,13,6,162,-41,Severe
11,7,139,M,105,13,9,165,26,Well
11,7,139,M,2,5,3,63,-76,Severe
17,0,204,M,53,8,6,102,-102,Severe
7,3,87,F,56,8,9,105,18,Well
17,9,213,M,44,7,9,93,-120,Severe
13,5,161,F,68,10,0,120,-41,Severe
14,4,172,M,57,8,10,106,-66,Severe
13,10,166,F,69,10,1,121,-45,Severe
17,4,208,M,104,13,7,163,-45,Severe
8,5,101,F,41,7,6,90,-11,Severe
17,6,210,M,99,13,1,157,-53,Severe
12,0,144,M,87,11,11,143,-1,Mild
6,8,80,F,19,6,1,73,-7,Severe
11,7,139,M,76,10,10,130,-9,Severe
10,2,122,F,35,7,1,85,-37,Severe
17,2,206,F,110,14,3,171,-35,Severe
6,0,72,M,80,11,3,135,63,Well
12,10,154,F,92,12,5,149,-5,Mild
7,7,91,F,79,11,1,133,42,Well
16,3,195,F,5,5,5,65,-130,Severe
8,3,99,M,93,12,6,150,51,Well
13,6,162,M,41,7,6,90,-72,Severe
7,6,90,F,95,12,9,153,63,Well
6,0,72,M,101,13,4,160,88,Well
5,7,67,F,4,5,4,64,-3,Mild
10,0,120,F,6,5,5,65,-55,Severe
13,2,158,M,61,9,3,111,-47,Severe
17,0,204,F,47,8,0,96,-108,Severe
18,8,224,F,17,6,0,72,-152,Severe
13,1,157,M,89,12,1,145,-12,Severe
13,0,156,M,100,13,3,159,3,Good
15,0,180,M,74,10,7,127,-53,Severe
18,9,225,M,93,12,6,150,-75,Severe
6,4,76,F,101,13,4,160,84,Well
18,5,221,F,51,8,4,100,-121,Severe
10,8,128,M,40,7,5,89,-39,Severe
5,4,64,F,86,11,10,142,78,Well
18,9,225,M,83,11,6,138,-87,Severe
11,3,135,M,43,7,8,92,-43,Severe
5,5,65,M,43,7,8,92,27,Well
17,0,204,F,6,5,5,65,-139,Severe
10,4,124,F,74,10,7,127,3,Good
18,0,216,M,22,6,3,75,-141,Severe
11,9,141,F,23,6,4,76,-65,Severe
18,4,220,M,42,7,7,91,-129,Severe
12,5,149,F,43,7,8,92,-57,Severe
8,2,98,M,26,6,6,78,-20,Severe
16,11,203,F,37,7,3,87,-116,Severe
7,9,93,M,39,7,5,89,-4,Mild
15,10,190,F,4,5,4,64,-126,Severe
15,1,181,M,36,7,2,86,-95,Severe
11,10,142,M,96,12,10,154,12,Well
13,2,158,M,24,6,5,77,-81,Severe
15,5,185,F,95,12,9,153,-32,Severe
12,3,147,M,5,5,5,65,-82,Severe
18,6,222,F,57,8,10,106,-116,Severe
8,6,102,M,85,11,9,141,39,Well
6,11,83,F,77,10,11,131,48,Well
13,7,163,F,107,13,11,167,4,Good
8,5,101,F,105,13,9,165,64,Well
14,9,177,F,88,12,0,144,-33,Severe
8,3,99,F,10,5,7,67,-32,Severe
17,4,208,F,105,13,9,165,-43,Severe
9,10,118,M,33,6,11,83,-35,Severe
13,0,156,M,34,7,0,84,-72,Severe
15,3,183,F,105,13,9,165,-18,Severe
14,3,171,F,11,5,8,68,-103,Severe
14,9,177,F,40,7,5,89,-88,Severe
11,4,136,F,30,6,9,81,-55,Severe
17,8,212,M,107,13,11,167,-45,Severe
17,3,207,F,23,6,4,76,-131,Severe
11,6,138,F,41,7,6,90,-48,Severe
10,3,123,M,68,10,0,120,-3,Mild
6,5,77,M,27,6,7,79,2,Good
15,8,188,M,46,7,11,95,-93,Severe
17,2,206,F,93,12,6,150,-56,Severe
12,10,154,F,28,6,8,80,-74,Severe
6,3,75,M,72,10,4,124,49,Well
12,1,145,M,90,12,3,147,2,Good
18,9,225,F,64,9,7,115,-110,Severe
14,3,171,F,107,13,11,167,-4,Mild
13,3,159,M,77,10,11,131,-28,Severe
11,0,132,F,92,12,5,149,17,Well
5,6,66,F,54,8,7,103,37,Well
9,5,113,F,10,5,7,67,-46,Severe
16,6,198,F,18,6,1,73,-125,Severe
9,3,111,F,29,6,8,80,-31,Severe
13,1,157,F,57,8,10,106,-51,Severe
6,11,83,F,28,6,8,80,-3,Mild
17,0,204,M,72,10,4,124,-80,Severe
11,11,143,F,55,8,8,104,-39,Severe
15,4,184,M,21,6,2,74,-110,Severe
7,0,84,M,12,5,9,69,-15,Severe
10,7,127,M,108,14,0,168,41,Well
9,6,114,M,96,12,10,154,40,Well
7,2,86,F,44,7,9,93,7,Well
6,10,82,M,37,7,3,87,5,Good
18,4,220,M,33,6,11,83,-137,Severe
16,10,202,M,40,7,5,89,-113,Severe
18,8,224,F,25,6,5,77,-147,Severe
5,8,68,F,42,7,7,91,23,Well
14,8,176,F,48,8,1,97,-79,Severe
12,8,152,M,27,6,7,79,-73,Severe
17,10,214,F,98,13,0,156,-58,Severe
11,8,140,M,40,7,5,89,-51,Severe
12,9,153,M,11,5,8,68,-85,Severe
16,8,200,F,25,6,5,77,-123,Severe
10,9,129,F,64,9,7,115,-14,Severe
16,2,194,F,7,5,6,66,-128,Severe
12,1,145,F,82,11,5,137,-8,Severe
9,8,116,F,45,7,10,94,-22,Severe
11,1,133,F,58,9,0,108,-25,Severe
18,1,217,M,87,11,11,143,-74,Severe
18,5,221,M,52,8,5,101,-120,Severe
6,8,80,M,77,10,11,131,51,Well
16,8,200,F,101,13,4,160,-40,Severe
6,6,78,M,20,6,2,74,-4,Mild
9,4,112,M,49,8,2,98,-14,Severe
18,11,227,F,96,12,10,154,-73,Severe
5,11,71,M,57,8,10,106,35,Well
16,10,202,F,100,13,3,159,-43,Severe
15,1,181,F,18,6,1,73,-108,Severe
11,2,134,M,4,5,4,64,-70,Severe
16,8,200,F,54,8,7,103,-97,Severe
18,0,216,M,108,14,0,168,-48,Severe
7,10,94,M,96,12,10,154,60,Well
16,9,201,M,90,12,3,147,-54,Severe
16,1,193,M,32,6,10,82,-111,Severe
17,9,213,F,107,13,11,167,-46,Severe
14,6,174,M,58,9,0,108,-66,Severe
10,10,130,M,8,5,6,66,-64,Severe
5,6,66,M,25,6,5,77,11,Well
9,10,118,M,53,8,6,102,-16,Severe
15,7,187,M,14,5,10,70,-117,Severe
5,11,71,F,63,9,6,114,43,Well
15,8,188,M,89,12,1,145,-43,Severe
12,3,147,F,10,5,7,67,-80,Severe
9,6,114,F,68,10,0,120,6,Well
11,8,140,F,19,6,1,73,-67,Severe
17,9,213,F,38,7,4,88,-125,Severe
5,0,60,M,6,5,5,65,5,Good
9,6,114,M,109,14,1,169,55,Well
13,7,163,F,74,10,7,127,-36,Severe
5,4,64,M,31,6,9,81,17,Well
6,11,83,F,34,7,0,84,1,Good
18,10,226,M,106,13,10,166,-60,Severe
9,1,109,F,54,8,7,103,-6,Severe
11,9,141,M,23,6,4,76,-65,Severe
5,11,71,M,5,5,5,65,-6,Severe
8,6,102,M,70,10,2,122,20,Well
7,0,84,F,25,6,5,77,-7,Severe
10,6,126,F,30,6,9,81,-45,Severe
13,9,165,F,84,11,7,139,-26,Severe
12,10,154,M,41,7,6,90,-64,Severe
11,6,138,F,101,13,4,160,22,Well
12,3,147,M,19,6,1,73,-74,Severe
10,1,121,M,8,5,6,66,-55,Severe
11,1,133,M,37,7,3,87,-46,Severe
12,4,148,F,54,8,7,103,-45,Severe
7,3,87,M,68,10,0,120,33,Well
12,8,152,F,60,9,2,110,-42,Severe
18,11,227,M,15,5,11,71,-156,Severe
5,3,63,F,53,8,6,102,39,Well
17,1,205,F,73,10,6,126,-79,Severe
12,3,147,M,55,8,8,104,-43,Severe
6,5,77,F,95,12,9,153,76,Well
8,1,97,F,94,12,7,151,54,Well
7,1,85,F,17,6,0,72,-13,Severe
8,8,104,M,18,6,1,73,-31,Severe
5,1,61,M,71,10,3,123,62,Well
10,3,123,M,83,11,6,138,15,Well
17,2,206,F,91,12,4,148,-58,Severe
6,9,81,M,66,9,9,117,36,Well
17,11,215,F,109,14,1,169,-46,Severe
16,2,194,F,4,5,4,64,-130,Severe
7,11,95,F,101,13,4,160,65,Well
17,3,207,F,24,6,5,77,-130,Severe
14,11,179,M,110,14,3,171,-8,Severe
16,7,199,F,30,6,9,81,-118,Severe
9,1,109,M,66,9,9,117,8,Well
9,2,110,F,72,10,4,124,14,Well
5,3,63,F,51,8,4,100,37,Well
14,1,169,M,47,8,0,96,-73,Severe
10,6,126,M,16,5,11,71,-55,Severe
8,2,98,F,90,12,3,147,49,Well
10,7,127,F,102,13,6,162,35,Well
7,5,89,M,49,8,2,98,9,Well
15,1,181,M,24,6,5,77,-104,Severe
17,11,215,M,90,12,3,147,-68,Severe
8,2,98,M,85,11,9,141,43,Well
8,11,107,F,100,13,3,159,52,Well
5,11,71,F,20,6,2,74,3,Good
11,3,135,M,73,10,6,126,-9,Severe
9,10,118,F,34,7,0,84,-34,Severe
5,4,64,F,67,9,10,118,54,Well
9,8,116,M,14,5,10,70,-46,Severe
13,6,162,F,39,7,5,89,-73,Severe
7,9,93,F,31,6,9,81,-12,Severe
7,5,89,F,22,6,3,75,-14,Severe
13,3,159,F,7,5,6,66,-93,Severe
12,0,144,F,84,11,7,139,-5,Mild
16,4,196,F,67,9,10,118,-78,Severe
13,8,164,F,41,7,6,90,-74,Severe
18,5,221,M,40,7,5,89,-132,Severe
10,9,129,F,95,12,9,153,24,Well
8,10,106,F,77,10,11,131,25,Well
6,1,73,M,90,12,3,147,74,Well
5,4,64,M,55,8,8,104,40,Well
9,4,112,F,67,9,10,118,6,Well
11,11,143,F,41,7,6,90,-53,Severe
11,1,133,M,86,11,10,142,9,Well
15,5,185,F,75,10,9,129,-56,Severe
6,9,81,M,69,10,1,121,40,Well
16,4,196,M,23,6,4,76,-120,Severe
8,0,96,F,2,5,3,63,-33,Severe
18,1,217,F,80,11,3,135,-82,Severe
7,11,95,M,8,5,6,66,-29,Severe
6,3,75,M,44,7,9,93,18,Well
14,2,170,M,50,8,3,99,-71,Severe
15,1,181,M,55,8,8,104,-77,Severe
11,11,143,F,42,7,7,91,-52,Severe
7,10,94,M,5,5,5,65,-29,Severe
5,3,63,M,30,6,9,81,18,Well
5,3,63,F,22,6,3,75,12,Well
17,1,205,F,7,5,6,66,-139,Severe
10,5,125,M,63,9,6,114,-11,Severe
10,9,129,M,53,8,6,102,-27,Severe
12,0,144,M,16,5,11,71,-73,Severe
9,6,114,M,61,9,3,111,-3,Mild
8,5,101,M,54,8,7,103,2,Good
6,9,81,F,83,11,6,138,57,Well
16,1,193,M,72,10,4,124,-69,Severe
14,0,168,F,33,6,11,83,-85,Severe
15,10,190,F,3,5,3,63,-127,Severe
9,1,109,F,88,12,0,144,35,Well
5,3,63,M,50,8,3,99,36,Well
6,8,80,M,104,13,7,163,83,Well
8,6,102,F,35,7,1,85,-17,Severe
8,11,107,M,109,14,1,169,62,Well
14,8,176,F,100,13,3,159,-17,Severe
16,3,195,M,56,8,9,105,-90,Severe
6,5,77,M,102,13,6,162,85,Well
9,5,113,M,20,6,2,74,-39,Severe
14,7,175,M,49,8,2,98,-77,Severe
13,11,167,F,18,6,1,73,-94,Severe
5,6,66,F,9,5,7,67,1,Good
9,3,111,M,68,10,0,120,9,Well
16,3,195,F,70,10,2,122,-73,Severe
17,9,213,F,71,10,3,123,-90,Severe
12,5,149,M,55,8,8,104,-45,Severe
6,3,75,F,79,11,1,133,58,Well
15,7,187,F,76,10,10,130,-57,Severe
7,6,90,M,88,12,0,144,54,Well
6,11,83,F,107,13,11,167,84,Well
12,9,153,M,63,9,6,114,-39,Severe
7,3,87,M,12,5,9,69,-18,Severe
17,6,210,M,75,10,9,129,-81,Severe
13,3,159,F,65,9,8,116,-43,Severe
11,10,142,M,105,13,9,165,23,Well
16,5,197,M,94,12,7,151,-46,Severe
5,9,69,F,61,9,3,111,42,Well
17,2,206,M,24,6,5,77,-129,Severe
9,4,112,M,8,5,6,66,-46,Severe
7,10,94,F,38,7,4,88,-6,Severe
12,9,153,M,17,6,0,72,-81,Severe
13,3,159,M,50,8,3,99,-60,Severe
11,10,142,M,15,5,11,71,-71,Severe
14,3,171,F,38,7,4,88,-83,Severe
13,10,166,M,20,6,2,74,-92,Severe
8,3,99,M,5,5,5,65,-34,Severe
6,1,73,M,81,11,4,136,63,Well
13,6,162,M,90,12,3,147,-15,Severe
16,2,194,M,67,9,10,118,-76,Severe
5,4,64,F,95,12,9,153,89,Well
17,11,215,F,73,10,6,126,-89,Severe
6,3,75,M,48,8,1,97,22,Well
17,0,204,M,33,6,11,83,-121,Severe
16,5,197,M,36,7,2,86,-111,Severe
5,7,67,M,28,6,8,80,13,Well
12,3,147,M,61,9,3,111,-36,Severe
12,9,153,F,52,8,5,101,-52,Severe
6,4,76,M,27,6,7,79,3,Good
16,2,194,M,70,10,2,122,-72,Severe
7,0,84,F,4,5,4,64,-20,Severe
14,10,178,M,78,11,0,132,-46,Severe
10,4,124,M,20,6,2,74,-50,Severe
5,7,67,M,85,11,9,141,74,Well
15,6,186,F,52,8,5,101,-85,Severe
9,7,115,M,48,8,1,97,-18,Severe
16,11,203,M,97,12,11,155,-48,Severe
15,10,190,M,17,6,0,72,-118,Severe
18,1,217,F,46,7,11,95,-122,Severe
11,7,139,M,3,5,3,63,-76,Severe
10,7,127,M,77,10,11,131,4,Good
8,10,106,M,80,11,3,135,29,Well
17,4,208,M,49,8,2,98,-110,Severe
12,10,154,M,10,5,7,67,-87,Severe
8,8,104,F,71,10,3,123,19,Well
8,4,100,F,52,8,5,101,1,Good
15,10,190,F,99,13,1,157,-33,Severe
17,1,205,M,86,11,10,142,-63,Severe
10,1,121,F,26,6,6,78,-43,Severe
8,0,96,F,19,6,1,73,-23,Severe
18,0,216,F,54,8,7,103,-113,Severe
10,9,129,F,82,11,5,137,8,Well
5,3,63,F,69,10,1,121,58,Well
11,11,143,F,33,6,11,83,-60,Severe
8,3,99,M,95,12,9,153,54,Well
12,7,151,M,108,14,0,168,17,Well
11,2,134,F,77,10,11,131,-3,Mild
14,3,171,M,75,10,9,129,-42,Severe
14,7,175,F,87,11,11,143,-32,Severe
10,11,131,M,12,5,9,69,-62,Severe
16,3,195,M,53,8,6,102,-93,Severe
11,9,141,F,102,13,6,162,21,Well
15,9,189,M,102,13,6,162,-27,Severe
10,4,124,M,13,5,9,69,-55,Severe
11,4,136,F,96,12,10,154,18,Well
14,6,174,M,56,8,9,105,-69,Severe
7,1,85,F,101,13,4,160,75,Well
12,1,145,M,34,7,0,84,-61,Severe
13,9,165,M,60,9,2,110,-55,Severe
8,11,107,F,78,11,0,132,25,Well
9,10,118,M,27,6,7,79,-39,Severe
12,5,149,F,106,13,10,166,17,Well
8,9,105,M,53,8,6,102,-3,Mild
18,9,225,M,56,8,9,105,-120,Severe
8,10,106,M,29,6,8,80,-26,Severe
6,10,82,M,104,13,7,163,81,Well
10,3,123,M,15,5,11,71,-52,Severe
13,2,158,F,14,5,10,70,-88,Severe
14,0,168,F,77,10,11,131,-37,Severe
11,4,136,F,25,6,5,77,-59,Severe
10,8,128,M,110,14,3,171,43,Well
13,2,158,F,81,11,4,136,-22,Severe
10,4,124,F,21,6,2,74,-50,Severe
15,9,189,F,73,10,6,126,-63,Severe
14,4,172,M,42,7,7,91,-81,Severe
16,8,200,F,89,12,1,145,-55,Severe
6,11,83,M,20,6,2,74,-9,Severe
5,9,69,M,39,7,5,89,20,Well
17,7,211,F,67,9,10,118,-93,Severe
10,4,124,F,51,8,4,100,-24,Severe
10,0,120,M,7,5,6,66,-54,Severe
17,5,209,F,86,11,10,142,-67,Severe
8,5,101,F,82,11,5,137,36,Well
18,0,216,F,101,13,4,160,-56,Severe
9,10,118,F,60,9,2,110,-8,Severe
13,4,160,M,58,9,0,108,-52,Severe
14,2,170,F,96,12,10,154,-16,Severe
17,3,207,M,26,6,6,78,-129,Severe
17,8,212,F,96,12,10,154,-58,Severe
14,1,169,F,65,9,8,116,-53,Severe
16,0,192,F,69,10,1,121,-71,Severe
6,3,75,M,4,5,4,64,-11,Severe
8,5,101,F,71,10,3,123,22,Well
18,5,221,M,3,5,3,63,-158,Severe
11,5,137,F,20,6,2,74,-63,Severe
13,6,162,M,103,13,6,162,0,Neutral
9,8,116,F,104,13,7,163,47,Well
7,11,95,F,47,8,0,96,1,Good
11,11,143,M,54,8,7,103,-40,Severe
12,11,155,M,54,8,7,103,-52,Severe
17,1,205,M,75,10,9,129,-76,Severe
14,10,178,F,61,9,3,111,-67,Severe
18,2,218,M,74,10,7,127,-91,Severe
9,7,115,M,17,6,0,72,-43,Severe
16,3,195,M,102,13,6,162,-33,Severe
11,2,134,F,27,6,7,79,-55,Severe
14,5,173,F,72,10,4,124,-49,Severe
12,11,155,F,89,12,1,145,-10,Severe
17,3,207,F,73,10,6,126,-81,Severe
9,4,112,M,51,8,4,100,-12,Severe
14,5,173,M,45,7,10,94,-79,Severe
17,7,211,F,79,11,1,133,-78,Severe
11,1,133,F,90,12,3,147,14,Well
16,9,201,M,105,13,9,165,-36,Severe
10,5,125,M,82,11,5,137,12,Well
15,5,185,M,15,5,11,71,-114,Severe
9,1,109,M,101,13,4,160,51,Well
9,10,118,M,108,14,0,168,50,Well
17,8,212,F,110,14,3,171,-41,Severe
11,11,143,F,36,7,2,86,-57,Severe
10,4,124,M,78,11,0,132,8,Well
14,5,173,F,18,6,1,73,-100,Severe
15,10,190,F,8,5,6,66,-124,Severe
8,3,99,F,39,7,5,89,-10,Severe
10,6,126,M,62,9,4,112,-14,Severe
18,9,225,M,27,6,7,79,-146,Severe
13,8,164,F,76,10,10,130,-34,Severe
11,10,142,M,37,7,3,87,-55,Severe
13,9,165,M,86,11,10,142,-23,Severe
15,8,188,M,44,7,9,93,-95,Severe
12,2,146,F,95,12,9,153,7,Well
14,0,168,M,14,5,10,70,-98,Severe
10,1,121,F,108,14,0,168,47,Well
12,0,144,M,99,13,1,157,13,Well
16,6,198,M,94,12,7,151,-47,Severe
18,10,226,F,79,11,1,133,-93,Severe
9,8,116,M,26,6,6,78,-38,Severe
9,6,114,F,70,10,2,122,8,Well
17,1,205,M,55,8,8,104,-101,Severe
10,9,129,F,60,9,2,110,-19,Severe
6,2,74,F,48,8,1,97,23,Well
6,0,72,M,78,11,0,132,60,Well
7,3,87,F,72,10,4,124,37,Well
6,3,75,F,7,5,6,66,-9,Severe
13,2,158,F,88,12,0,144,-14,Severe
12,1,145,M,84,11,7,139,-6,Severe
9,9,117,F,90,12,3,147,30,Well
10,6,126,M,110,14,3,171,45,Well
5,2,62,M,108,14,0,168,106,Well
10,10,130,M,92,12,5,149,19,Well
14,7,175,F,71,10,3,123,-52,Severe
6,2,74,M,73,10,6,126,52,Well
11,7,139,M,66,9,9,117,-22,Severe
18,4,220,F,60,9,2,110,-110,Severe
8,0,96,F,27,6,7,79,-17,Severe
18,5,221,M,65,9,8,116,-105,Severe
5,3,63,F,7,5,6,66,3,Good
11,0,132,M,66,9,9,117,-15,Severe
18,3,219,F,7,5,6,66,-153,Severe
9,11,119,M,79,11,1,133,14,Well
18,6,222,F,85,11,9,141,-81,Severe
11,4,136,F,71,10,3,123,-13,Severe
16,3,195,F,4,5,4,64,-131,Severe
6,4,76,M,10,5,7,67,-9,Severe
8,7,103,M,71,10,3,123,20,Well
6,5,77,F,109,14,1,169,92,Well
18,2,218,M,61,9,3,111,-107,Severe
14,9,177,F,49,8,2,98,-79,Severe
6,10,82,M,31,6,9,81,-1,Mild
15,10,190,M,82,11,5,137,-53,Severe
8,6,102,F,58,9,0,108,6,Well
6,11,83,F,38,7,4,88,5,Good
5,4,64,M,10,5,7,67,3,Good
12,3,147,F,83,11,6,138,-9,Severe
12,4,148,F,41,7,6,90,-58,Severe
14,9,177,F,92,12,5,149,-28,Severe
9,0,108,M,82,11,5,137,29,Well
12,4,148,M,45,7,10,94,-54,Severe
10,6,126,M,97,12,11,155,29,Well
17,7,211,F,77,10,11,131,-80,Severe
17,10,214,F,58,9,0,108,-106,Severe
10,10,130,F,68,10,0,120,-10,Severe
6,4,76,M,61,9,3,111,35,Well
15,6,186,F,66,9,9,117,-69,Severe
11,8,140,M,29,6,8,80,-60,Severe
11,3,135,M,72,10,4,124,-11,Severe
7,10,94,M,38,7,4,88,-6,Severe
18,2,218,F,93,12,6,150,-68,Severe
9,6,114,F,104,13,7,163,49,Well
13,10,166,F,87,11,11,143,-23,Severe
9,1,109,F,96,12,10,154,45,Well
13,3,159,M,93,12,6,150,-9,Severe
7,10,94,M,28,6,8,80,-14,Severe
13,3,159,F,101,13,4,160,1,Good
7,9,93,F,68,10,0,120,27,Well
18,3,219,F,40,7,5,89,-130,Severe
11,4,136,F,72,10,4,124,-12,Severe
10,9,129,F,61,9,3,111,-18,Severe
15,8,188,M,50,8,3,99,-89,Severe
9,5,113,F,38,7,4,88,-25,Severe
14,2,170,F,65,9,8,116,-54,Severe
12,11,155,M,63,9,6,114,-41,Severe
8,0,96,M,31,6,9,81,-15,Severe
12,3,147,M,80,11,3,135,-12,Severe
15,3,183,M,74,10,7,127,-56,Severe
10,8,128,F,8,5,6,66,-62,Severe
11,1,133,M,7,5,6,66,-67,Severe
14,8,176,M,61,9,3,111,-65,Severe
7,8,92,F,30,6,9,81,-11,Severe
12,2,146,F,36,7,2,86,-60,Severe
13,10,166,M,50,8,3,99,-67,Severe
13,3,159,F,47,8,0,96,-63,Severe
6,6,78,F,68,10,0,120,42,Well
9,3,111,M,89,12,1,145,34,Well
5,10,70,M,87,11,11,143,73,Well
9,3,111,F,33,6,11,83,-28,Severe
17,3,207,F,4,5,4,64,-143,Severe
9,1,109,M,7,5,6,66,-43,Severe
14,11,179,M,80,11,3,135,-44,Severe
17,9,213,F,78,11,0,132,-81,Severe
13,9,165,F,83,11,6,138,-27,Severe
11,3,135,F,5,5,5,65,-70,Severe
11,3,135,M,36,7,2,86,-49,Severe
15,3,183,F,5,5,5,65,-118,Severe
12,9,153,M,106,13,10,166,13,Well
16,3,195,F,30,6,9,81,-114,Severe
7,10,94,M,32,6,10,82,-12,Severe
13,9,165,M,76,10,10,130,-35,Severe
8,2,98,M,25,6,5,77,-21,Severe
10,10,130,M,71,10,3,123,-7,Severe
14,5,173,M,105,13,9,165,-8,Severe
8,5,101,F,69,10,1,121,20,Well
15,1,181,F,75,10,9,129,-52,Severe
16,11,203,M,105,13,9,165,-38,Severe
7,6,90,F,99,13,1,157,67,Well
17,0,204,F,3,5,3,63,-141,Severe
9,10,118,M,45,7,10,94,-24,Severe
8,10,106,F,36,7,2,86,-20,Severe
12,2,146,M,63,9,6,114,-32,Severe
13,9,165,F,89,12,1,145,-20,Severe
18,3,219,F,86,11,10,142,-77,Severe
6,11,83,F,45,7,10,94,11,Well
15,9,189,M,104,13,7,163,-26,Severe
5,11,71,M,9,5,7,67,-4,Mild
5,5,65,F,31,6,9,81,16,Well
10,9,129,M,102,13,6,162,33,Well
17,5,209,M,3,5,3,63,-146,Severe
5,11,71,F,26,6,6,78,7,Well
10,3,123,F,74,10,7,127,4,Good
7,10,94,F,66,9,9,117,23,Well
11,0,132,M,32,6,10,82,-50,Severe
9,1,109,M,91,12,4,148,39,Well
17,1,205,F,84,11,7,139,-66,Severe
13,8,164,F,91,12,4,148,-16,Severe
9,8,116,M,9,5,7,67,-49,Severe
14,0,168,F,25,6,5,77,-91,Severe
10,9,129,M,106,13,10,166,37,Well
18,8,224,M,102,13,6,162,-62,Severe
7,3,87,M,22,6,3,75,-12,Severe
14,4,172,M,59,9,1,109,-63,Severe
11,0,132,M,60,9,2,110,-22,Severe
16,2,194,F,99,13,1,157,-37,Severe
10,8,128,M,39,7,5,89,-39,Severe
7,3,87,F,65,9,8,116,29,Well
10,0,120,F,62,9,4,112,-8,Severe
8,3,99,M,41,7,6,90,-9,Severe
9,9,117,M,93,12,6,150,33,Well
17,3,207,M,24,6,5,77,-130,Severe
16,6,198,M,24,6,5,77,-121,Severe
15,8,188,M,64,9,7,115,-73,Severe
9,10,118,M,69,10,1,121,3,Good
6,0,72,M,92,12,5,149,77,Well
15,3,183,F,81,11,4,136,-47,Severe
15,9,189,M,33,6,11,83,-106,Severe
17,6,210,M,86,11,10,142,-68,Severe
18,0,216,F,49,8,2,98,-118,Severe
11,10,142,M,91,12,4,148,6,Well
12,2,146,F,104,13,7,163,17,Well
11,11,143,F,94,12,7,151,8,Well
10,6,126,F,50,8,3,99,-27,Severe
12,6,150,M,8,5,6,66,-84,Severe
6,10,82,M,86,11,10,142,60,Well
5,4,64,M,16,5,11,71,7,Well
14,3,171,F,103,13,6,162,-9,Severe
7,5,89,F,37,7,3,87,-2,Mild
18,11,227,M,37,7,3,87,-140,Severe
5,6,66,M,60,9,2,110,44,Well
9,0,108,F,89,12,1,145,37,Well
9,10,118,F,24,6,5,77,-41,Severe
18,10,226,M,73,10,6,126,-100,Severe
12,1,145,M,38,7,4,88,-57,Severe
9,10,118,F,19,6,1,73,-45,Severe
12,3,147,M,20,6,2,74,-73,Severe
18,1,217,M,42,7,7,91,-126,Severe
7,0,84,M,46,7,11,95,11,Well
6,10,82,M,43,7,8,92,10,Well
15,10,190,M,78,11,0,132,-58,Severe
12,6,150,F,83,11,6,138,-12,Severe
7,9,93,F,69,10,1,121,28,Well
18,0,216,M,64,9,7,115,-101,Severe
9,3,111,M,15,5,11,71,-40,Severe
5,0,60,F,47,8,0,96,36,Well
5,2,62,F,69,10,1,121,59,Well
12,8,152,F,11,5,8,68,-84,Severe
18,4,220,M,17,6,0,72,-148,Severe
18,3,219,F,81,11,4,136,-83,Severe
12,11,155,M,45,7,10,94,-61,Severe
15,3,183,M,40,7,5,89,-94,Severe
5,5,65,F,72,10,4,124,59,Well
15,11,191,M,43,7,8,92,-99,Severe
10,3,123,M,65,9,8,116,-7,Severe
7,11,95,M,109,14,1,169,74,Well
6,9,81,M,74,10,7,127,46,Well
10,3,123,F,109,14,1,169,46,Well
5,9,69,F,84,11,7,139,70,Well
11,1,133,F,40,7,5,89,-44,Severe
7,0,84,M,93,12,6,150,66,Well
12,2,146,M,89,12,1,145,-1,Mild
6,1,73,F,9,5,7,67,-6,Severe
9,3,111,F,102,13,6,162,51,Well
17,11,215,M,65,9,8,116,-99,Severe
18,4,220,F,52,8,5,101,-119,Severe
13,1,157,M,22,6,3,75,-82,Severe
6,8,80,M,35,7,1,85,5,Good
14,0,168,F,12,5,9,69,-99,Severe
10,7,127,M,76,10,10,130,3,Good
13,2,158,F,73,10,6,126,-32,Severe
10,1,121,F,60,9,2,110,-11,Severe
17,11,215,F,107,13,11,167,-48,Severe
9,11,119,F,24,6,5,77,-42,Severe
7,6,90,F,7,5,6,66,-24,Severe
14,9,177,F,38,7,4,88,-89,Severe
18,9,225,M,15,5,11,71,-154,Severe
6,3,75,F,101,13,4,160,85,Well
17,4,208,M,21,6,2,74,-134,Severe
10,3,123,M,4,5,4,64,-59,Severe
12,0,144,F,36,7,2,86,-58,Severe
8,2,98,M,91,12,4,148,50,Well
12,4,148,F,46,7,11,95,-53,Severe
14,5,173,F,48,8,1,97,-76,Severe
15,9,189,F,36,7,2,86,-103,Severe
12,4,148,F,106,13,10,166,18,Well
7,4,88,F,78,11,0,132,44,Well
7,9,93,M,69,10,1,121,28,Well
17,4,208,M,11,5,8,68,-140,Severe
6,7,79,F,14,5,10,70,-9,Severe
7,11,95,M,39,7,5,89,-6,Severe
7,7,91,F,85,11,9,141,50,Well
11,10,142,F,28,6,8,80,-62,Severe
5,4,64,F,70,10,2,122,58,Well
10,9,129,F,58,9,0,108,-21,Severe
16,7,199,F,79,11,1,133,-66,Severe
16,7,199,M,87,11,11,143,-56,Severe
7,11,95,F,27,6,7,79,-16,Severe
14,0,168,M,99,13,1,157,-11,Severe
13,8,164,F,44,7,9,93,-71,Severe
12,2,146,F,80,11,3,135,-11,Severe
13,6,162,F,105,13,9,165,3,Good
11,5,137,M,44,7,9,93,-44,Severe
18,5,221,M,95,12,9,153,-68,Severe
16,0,192,F,39,7,5,89,-103,Severe
18,10,226,F,33,6,11,83,-143,Severe
11,4,136,F,78,11,0,132,-4,Mild
5,8,68,M,56,8,9,105,37,Well
6,3,75,M,84,11,7,139,64,Well
10,10,130,F,110,14,3,171,41,Well
15,7,187,M,104,13,7,163,-24,Severe
12,7,151,F,19,6,1,73,-78,Severe
17,0,204,M,2,5,3,63,-141,Severe
5,5,65,F,9,5,7,67,2,Good
11,11,143,M,42,7,7,91,-52,Severe
7,8,92,M,58,9,0,108,16,Well
5,10,70,F,58,9,0,108,38,Well
14,1,169,F,104,13,7,163,-6,Severe
13,2,158,F,39,7,5,89,-69,Severe
11,9,141,F,105,13,9,165,24,Well
10,0,120,M,15,5,11,71,-49,Severe
17,3,207,M,60,9,2,110,-97,Severe
6,11,83,M,44,7,9,93,10,Well
13,3,159,M,53,8,6,102,-57,Severe
6,7,79,M,73,10,6,126,47,Well
16,4,196,M,25,6,5,77,-119,Severe
11,9,141,F,103,13,6,162,21,Well
7,7,91,M,54,8,7,103,12,Well
8,6,102,M,108,14,0,168,66,Well
17,8,212,F,16,5,11,71,-141,Severe
5,11,71,M,72,10,4,124,53,Well
16,0,192,F,98,13,0,156,-36,Severe
5,3,63,M,107,13,11,167,104,Well
15,5,185,F,59,9,1,109,-76,Severe
16,6,198,M,8,5,6,66,-132,Severe
10,2,122,F,21,6,2,74,-48,Severe
10,1,121,M,95,12,9,153,32,Well
16,4,196,F,70,10,2,122,-74,Severe
16,3,195,M,51,8,4,100,-95,Severe
7,8,92,M,30,6,9,81,-11,Severe
7,0,84,M,9,5,7,67,-17,Severe
16,10,202,F,52,8,5,101,-101,Severe
6,8,80,F,61,9,3,111,31,Well
10,11,131,F,22,6,3,75,-56,Severe
11,10,142,F,93,12,6,150,8,Well
11,1,133,F,86,11,10,142,9,Well
5,10,70,F,81,11,4,136,66,Well
16,6,198,F,96,12,10,154,-44,Severe
13,3,159,F,106,13,10,166,7,Well
14,3,171,F,102,13,6,162,-9,Severe
15,4,184,M,3,5,3,63,-121,Severe
14,9,177,F,72,10,4,124,-53,Severe
12,3,147,M,59,9,1,109,-38,Severe
5,2,62,M,64,9,7,115,53,Well
11,7,139,M,61,9,3,111,-28,Severe
13,2,158,M,14,5,10,70,-88,Severe
17,7,211,M,14,5,10,70,-141,Severe
8,4,100,M,76,10,10,130,30,Well
5,10,70,M,92,12,5,149,79,Well
7,2,86,M,79,11,1,133,47,Well
13,8,164,M,71,10,3,123,-41,Severe
11,0,132,M,87,11,11,143,11,Well
16,3,195,F,103,13,6,162,-33,Severe
13,5,161,M,58,9,0,108,-53,Severe
10,8,128,M,58,9,0,108,-20,Severe
14,3,171,F,14,5,10,70,-101,Severe
9,1,109,M,11,5,8,68,-41,Severe
10,8,128,F,28,6,8,80,-48,Severe
7,4,88,M,98,13,0,156,68,Well
13,0,156,F,7,5,6,66,-90,Severe
6,2,74,F,76,10,10,130,56,Well
6,8,80,M,39,7,5,89,9,Well
16,5,197,M,96,12,10,154,-43,Severe
9,3,111,M,104,13,7,163,52,Well
15,8,188,M,56,8,9,105,-83,Severe
15,3,183,F,106,13,10,166,-17,Severe
8,1,97,M,5,5,5,65,-32,Severe
5,5,65,M,89,12,1,145,80,Well
15,9,189,M,98,13,0,156,-33,Severe
17,8,212,M,70,10,2,122,-90,Severe
12,1,145,M,60,9,2,110,-35,Severe
13,8,164,M,52,8,5,101,-63,Severe
17,2,206,M,4,5,4,64,-142,Severe
13,2,158,M,7,5,6,66,-92,Severe
12,3,147,M,73,10,6,126,-21,Severe
8,6,102,F,67,9,10,118,16,Well
14,0,168,M,65,9,8,116,-52,Severe
17,0,204,F,24,6,5,77,-127,Severe
17,2,206,F,99,13,1,157,-49,Severe
8,7,103,M,29,6,8,80,-23,Severe
18,10,226,F,15,5,11,71,-155,Severe
10,3,123,F,3,5,3,63,-60,Severe
7,7,91,M,31,6,9,81,-10,Severe
15,9,189,F,91,12,4,148,-41,Severe
9,2,110,F,10,5,7,67,-43,Severe
15,9,189,F,31,6,9,81,-108,Severe
10,1,121,M,31,6,9,81,-40,Severe
7,1,85,F,24,6,5,77,-8,Severe
5,7,67,F,24,6,5,77,10,Well
7,7,91,F,82,11,5,137,46,Well
7,3,87,M,35,7,1,85,-2,Mild
13,9,165,F,32,6,10,82,-83,Severe
9,0,108,F,49,8,2,98,-10,Severe
12,8,152,F,18,6,1,73,-79,Severe
14,6,174,M,109,14,1,169,-5,Mild
9,9,117,F,28,6,8,80,-37,Severe
11,11,143,M,40,7,5,89,-54,Severe
15,7,187,F,45,7,10,94,-93,Severe
16,2,194,F,69,10,1,121,-73,Severe
9,4,112,F,37,7,3,87,-25,Severe
11,4,136,M,45,7,10,94,-42,Severe
15,6,186,M,109,14,1,169,-17,Severe
10,9,129,F,7,5,6,66,-63,Severe
7,2,86,F,17,6,0,72,-14,Severe
8,4,100,F,75,10,9,129,29,Well
5,7,67,F,81,11,4,136,69,Well
9,4,112,M,81,11,4,136,24,Well
18,1,217,F,69,10,1,121,-96,Severe
8,2,98,M,103,13,6,162,64,Well
11,11,143,F,48,8,1,97,-46,Severe
18,6,222,F,37,7,3,87,-135,Severe
10,11,131,F,64,9,7,115,-16,Severe
6,1,73,F,34,7,0,84,11,Well
8,9,105,M,52,8,5,101,-4,Mild
8,4,100,F,21,6,2,74,-26,Severe
12,3,147,M,8,5,6,66,-81,Severe
16,2,194,F,95,12,9,153,-41,Severe
7,6,90,F,70,10,2,122,32,Well
11,8,140,F,31,6,9,81,-59,Severe
6,6,78,F,8,5,6,66,-12,Severe
12,11,155,F,27,6,7,79,-76,Severe
12,1,145,F,101,13,4,160,15,Well
9,0,108,F,82,11,5,137,29,Well
14,3,171,F,60,9,2,110,-61,Severe
7,2,86,M,95,12,9,153,67,Well
18,8,224,F,83,11,6,138,-86,Severe
9,7,115,F,35,7,1,85,-30,Severe
17,8,212,F,21,6,2,74,-138,Severe
12,3,147,F,76,10,10,130,-17,Severe
6,6,78,F,96,12,10,154,76,Well
15,3,183,M,26,6,6,78,-105,Severe
11,6,138,F,48,8,1,97,-41,Severe
6,1,73,F,26,6,6,78,5,Good
9,8,116,F,29,6,8,80,-36,Severe
15,2,182,M,18,6,1,73,-109,Severe
17,6,210,F,52,8,5,101,-109,Severe
11,9,141,F,13,5,9,69,-72,Severe
15,3,183,F,60,9,2,110,-73,Severe
8,4,100,F,90,12,3,147,47,Well
15,3,183,F,29,6,8,80,-103,Severe
10,9,129,F,107,13,11,167,38,Well
14,4,172,F,31,6,9,81,-91,Severe
14,5,173,F,69,10,1,121,-52,Severe
10,2,122,F,72,10,4,124,2,Good
15,4,184,F,34,7,0,84,-100,Severe
15,1,181,F,19,6,1,73,-108,Severe
10,5,125,F,19,6,1,73,-52,Severe
16,9,201,F,80,11,3,135,-66,Severe
6,3,75,M,108,14,0,168,93,Well
17,9,213,F,24,6,5,77,-136,Severe
17,5,209,M,59,9,1,109,-100,Severe
17,3,207,F,70,10,2,122,-85,Severe
18,8,224,M,67,9,10,118,-106,Severe
12,3,147,F,22,6,3,75,-72,Severe
17,2,206,F,103,13,6,162,-44,Severe
8,2,98,F,74,10,7,127,29,Well
15,8,188,F,34,7,0,84,-104,Severe
13,5,161,M,85,11,9,141,-20,Severe
14,2,170,F,45,7,10,94,-76,Severe
13,4,160,M,63,9,6,114,-46,Severe
13,10,166,M,11,5,8,68,-98,Severe
13,0,156,F,105,13,9,165,9,Well
10,1,121,F,101,13,4,160,39,Well
16,10,202,M,8,5,6,66,-136,Severe
9,3,111,M,20,6,2,74,-37,Severe
11,8,140,M,60,9,2,110,-30,Severe
13,1,157,F,63,9,6,114,-43,Severe
16,11,203,M,62,9,4,112,-91,Severe
14,5,173,F,28,6,8,80,-93,Severe
18,0,216,M,76,10,10,130,-86,Severe
8,9,105,M,97,12,11,155,50,Well
12,3,147,M,104,13,7,163,16,Well
11,3,135,M,104,13,7,163,28,Well
7,3,87,F,81,11,4,136,49,Well
13,8,164,M,58,9,0,108,-56,Severe
7,5,89,F,39,7,5,89,0,Neutral
5,1,61,F,65,9,8,116,55,Well
18,3,219,M,51,8,4,100,-119,Severe
9,9,117,F,70,10,2,122,5,Good
17,3,207,F,69,10,1,121,-86,Severe
10,1,121,M,33,6,11,83,-38,Severe
11,9,141,M,67,9,10,118,-23,Severe
17,2,206,M,70,10,2,122,-84,Severe
9,5,113,F,17,6,0,72,-41,Severe
6,1,73,F,37,7,3,87,14,Well
16,3,195,F,2,5,3,63,-132,Severe
16,8,200,M,51,8,4,100,-100,Severe
13,9,165,F,10,5,7,67,-98,Severe
18,6,222,M,31,6,9,81,-141,Severe
9,7,115,M,25,6,5,77,-38,Severe
15,4,184,M,37,7,3,87,-97,Severe
6,7,79,F,107,13,11,167,88,Well
13,11,167,F,31,6,9,81,-86,Severe
7,3,87,M,61,9,3,111,24,Well
15,11,191,M,103,13,6,162,-29,Severe
16,1,193,M,49,8,2,98,-95,Severe
17,3,207,M,86,11,10,142,-65,Severe
15,4,184,F,25,6,5,77,-107,Severe
10,1,121,F,80,11,3,135,14,Well
6,4,76,M,101,13,4,160,84,Well
14,3,171,F,7,5,6,66,-105,Severe
5,6,66,M,69,10,1,121,55,Well
13,10,166,F,40,7,5,89,-77,Severe
16,8,200,F,48,8,1,97,-103,Severe
16,11,203,F,45,7,10,94,-109,Severe
12,0,144,M,20,6,2,74,-70,Severe
8,6,102,F,80,11,3,135,33,Well
13,0,156,M,72,10,4,124,-32,Severe
16,8,200,M,20,6,2,74,-126,Severe
12,3,147,M,47,8,0,96,-51,Severe
17,3,207,F,25,6,5,77,-130,Severe
15,9,189,F,51,8,4,100,-89,Severe
17,0,204,M,94,12,7,151,-53,Severe
13,2,158,M,48,8,1,97,-61,Severe
9,0,108,F,86,11,10,142,34,Well
11,7,139,M,97,12,11,155,16,Well
7,6,90,F,85,11,9,141,51,Well
9,10,118,F,97,12,11,155,37,Well
18,5,221,M,85,11,9,141,-80,Severe
5,11,71,M,101,13,4,160,89,Well
12,3,147,F,39,7,5,89,-58,Severe
5,11,71,F,14,5,10,70,-1,Mild
14,10,178,F,83,11,6,138,-40,Severe
15,0,180,F,95,12,9,153,-27,Severe
17,3,207,M,63,9,6,114,-93,Severe
8,9,105,F,93,12,6,150,45,Well
11,11,143,F,39,7,5,89,-54,Severe
12,6,150,F,77,10,11,131,-19,Severe
12,10,154,M,9,5,7,67,-87,Severe
12,10,154,M,28,6,8,80,-74,Severe
16,5,197,M,32,6,10,82,-115,Severe
14,0,168,M,52,8,5,101,-67,Severe
15,10,190,M,35,7,1,85,-105,Severe
5,3,63,M,34,7,0,84,21,Well
18,8,224,F,108,14,0,168,-56,Severe
12,1,145,F,70,10,2,122,-23,Severe
13,10,166,F,106,13,10,166,0,Neutral
18,7,223,F,57,8,10,106,-117,Severe
15,7,187,F,30,6,9,81,-106,Severe
10,11,131,F,38,7,4,88,-43,Severe
8,1,97,M,18,6,1,73,-24,Severe
10,0,120,M,88,12,0,144,24,Well
6,5,77,F,23,6,4,76,-1,Mild
8,9,105,F,23,6,4,76,-29,Severe
15,4,184,M,103,13,6,162,-22,Severe
15,0,180,F,63,9,6,114,-66,Severe
17,10,214,F,47,8,0,96,-118,Severe
16,1,193,F,91,12,4,148,-45,Severe
9,10,118,M,38,7,4,88,-30,Severe
13,0,156,M,47,8,0,96,-60,Severe
14,9,177,M,52,8,5,101,-76,Severe
18,5,221,F,2,5,3,63,-158,Severe
14,5,173,M,90,12,3,147,-26,Severe
16,10,202,F,59,9,1,109,-93,Severe
6,8,80,M,29,6,8,80,0,Neutral
13,7,163,M,53,8,6,102,-61,Severe
15,6,186,F,59,9,1,109,-77,Severe
16,3,195,M,76,10,10,130,-65,Severe
13,6,162,M,69,10,1,121,-41,Severe
10,10,130,M,99,13,1,157,27,Well
11,3,135,F,33,6,11,83,-52,Severe
18,0,216,F,73,10,6,126,-90,Severe
9,5,113,M,36,7,2,86,-27,Severe
16,7,199,M,25,6,5,77,-122,Severe
15,6,186,M,20,6,2,74,-112,Severe
18,6,222,M,9,5,7,67,-155,Severe
7,10,94,M,17,6,0,72,-22,Severe
17,7,211,M,94,12,7,151,-60,Severe
9,5,113,F,92,12,5,149,36,Well
12,2,146,F,24,6,5,77,-69,Severe
14,2,170,M,41,7,6,90,-80,Severe
11,5,137,M,20,6,2,74,-63,Severe
17,7,211,F,41,7,6,90,-121,Severe
18,6,222,F,106,13,10,166,-56,Severe
9,10,118,M,56,8,9,105,-13,Severe
14,2,170,M,14,5,10,70,-100,Severe
15,2,182,F,84,11,7,139,-43,Severe
17,8,212,M,106,13,10,166,-46,Severe
17,8,212,M,17,6,0,72,-140,Severe
11,2,134,M,49,8,2,98,-36,Severe
6,1,73,F,49,8,2,98,25,Well
11,5,137,M,66,9,9,117,-20,Severe
17,10,214,F,71,10,3,123,-91,Severe
16,10,202,F,86,11,10,142,-60,Severe
11,5,137,M,24,6,5,77,-60,Severe
10,3,123,M,86,11,10,142,19,Well
14,8,176,M,14,5,10,70,-106,Severe
10,10,130,F,12,5,9,69,-61,Severe
11,0,132,F,78,11,0,132,0,Neutral
7,2,86,F,105,13,9,165,79,Well
12,8,152,F,24,6,5,77,-75,Severe
9,9,117,M,30,6,9,81,-36,Severe
6,2,74,F,18,6,1,73,-1,Mild
13,3,159,F,46,7,11,95,-64,Severe
7,8,92,F,56,8,9,105,13,Well
12,10,154,M,22,6,3,75,-79,Severe
11,3,135,M,30,6,9,81,-54,Severe
18,9,225,F,30,6,9,81,-144,Severe
16,1,193,F,98,13,0,156,-37,Severe
8,3,99,M,106,13,10,166,67,Well
9,11,119,M,21,6,2,74,-45,Severe
8,6,102,F,17,6,0,72,-30,Severe
14,3,171,M,6,5,5,65,-106,Severe
18,1,217,F,43,7,8,92,-125,Severe
11,7,139,M,36,7,2,86,-53,Severe
10,7,127,F,52,8,5,101,-26,Severe
14,6,174,M,48,8,1,97,-77,Severe
15,3,183,F,104,13,7,163,-20,Severe
8,8,104,M,51,8,4,100,-4,Mild
11,5,137,F,45,7,10,94,-43,Severe
9,6,114,M,39,7,5,89,-25,Severe
10,7,127,M,42,7,7,91,-36,Severe
14,7,175,M,52,8,5,101,-74,Severe
6,4,76,F,92,12,5,149,73,Well
5,6,66,M,12,5,9,69,3,Good
12,9,153,M,29,6,8,80,-73,Severe
10,0,120,M,40,7,5,89,-31,Severe
13,0,156,M,76,10,10,130,-26,Severe
16,9,201,M,35,7,1,85,-116,Severe
7,2,86,M,73,10,6,126,40,Well
9,1,109,M,6,5,5,65,-44,Severe
9,6,114,M,3,5,3,63,-51,Severe
9,5,113,M,97,12,11,155,42,Well
6,4,76,F,90,12,3,147,71,Well
14,5,173,F,20,6,2,74,-99,Severe
11,3,135,F,62,9,4,112,-23,Severe
15,9,189,F,70,10,2,122,-67,Severe
15,5,185,F,51,8,4,100,-85,Severe
14,3,171,M,30,6,9,81,-90,Severe
12,11,155,F,7,5,6,66,-89,Severe
12,5,149,M,106,13,10,166,17,Well
8,10,106,M,25,6,5,77,-29,Severe
17,3,207,F,14,5,10,70,-137,Severe
5,9,69,F,47,8,0,96,27,Well
14,5,173,M,47,8,0,96,-77,Severe
16,5,197,M,62,9,4,112,-85,Severe
16,2,194,M,19,6,1,73,-121,Severe
11,0,132,M,92,12,5,149,17,Well
18,7,223,F,33,6,11,83,-140,Severe
9,7,115,M,8,5,6,66,-49,Severe
16,7,199,M,37,7,3,87,-112,Severe
12,1,145,M,26,6,6,78,-67,Severe
10,11,131,M,67,9,10,118,-13,Severe
5,7,67,M,26,6,6,78,11,Well
15,9,189,M,10,5,7,67,-122,Severe
18,2,218,F,68,10,0,120,-98,Severe
11,6,138,M,83,11,6,138,0,Neutral
9,1,109,M,23,6,4,76,-33,Severe
8,10,106,M,62,9,4,112,6,Well
11,5,137,M,71,10,3,123,-14,Severe
16,1,193,F,64,9,7,115,-78,Severe
6,7,79,F,52,8,5,101,22,Well
12,5,149,M,63,9,6,114,-35,Severe
14,6,174,M,16,5,11,71,-103,Severe
5,6,66,F,60,9,2,110,44,Well
17,4,208,M,95,12,9,153,-55,Severe
8,8,104,F,14,5,10,70,-34,Severe
12,2,146,M,24,6,5,77,-69,Severe
7,1,85,M,94,12,7,151,66,Well
15,3,183,M,5,5,5,65,-118,Severe
17,8,212,M,50,8,3,99,-113,Severe
18,3,219,M,34,7,0,84,-135,Severe
8,5,101,M,99,13,1,157,56,Well
14,7,175,F,104,13,7,163,-12,Severe
10,1,121,F,10,5,7,67,-54,Severe
16,8,200,F,60,9,2,110,-90,Severe
10,11,131,M,52,8,5,101,-30,Severe
8,11,107,F,29,6,8,80,-27,Severe
10,8,128,F,54,8,7,103,-25,Severe
8,3,99,M,33,6,11,83,-16,Severe
7,3,87,M,49,8,2,98,11,Well
7,9,93,M,54,8,7,103,10,Well
16,1,193,F,62,9,4,112,-81,Severe
12,1,145,M,103,13,6,162,17,Well
10,6,126,M,26,6,6,78,-48,Severe
8,8,104,M,82,11,5,137,33,Well
11,5,137,M,67,9,10,118,-19,Severe
12,5,149,M,38,7,4,88,-61,Severe
8,11,107,M,31,6,9,81,-26,Severe
17,3,207,F,2,5,3,63,-144,Severe
15,3,183,M,88,12,0,144,-39,Severe
8,4,100,F,108,14,0,168,68,Well
8,7,103,M,7,5,6,66,-37,Severe
12,8,152,F,69,10,1,121,-31,Severe
7,5,89,F,92,12,5,149,60,Well
11,4,136,M,105,13,9,165,29,Well
5,8,68,M,3,5,3,63,-5,Mild
12,4,148,M,81,11,4,136,-12,Severe
10,3,123,M,17,6,0,72,-51,Severe
15,9,189,M,91,12,4,148,-41,Severe
13,10,166,F,96,12,10,154,-12,Severe
7,6,90,F,39,7,5,89,-1,Mild
13,7,163,F,17,6,0,72,-91,Severe
16,4,196,F,27,6,7,79,-117,Severe
18,3,219,F,92,12,5,149,-70,Severe
14,0,168,M,41,7,6,90,-78,Severe
18,7,223,M,10,5,7,67,-156,Severe
18,8,224,M,42,7,7,91,-133,Severe
7,1,85,M,23,6,4,76,-9,Severe
17,8,212,F,88,12,0,144,-68,Severe
15,3,183,F,18,6,1,73,-110,Severe
9,7,115,F,17,6,0,72,-43,Severe
9,6,114,F,36,7,2,86,-28,Severe
12,10,154,M,90,12,3,147,-7,Severe
13,6,162,F,30,6,9,81,-81,Severe
18,10,226,M,40,7,5,89,-137,Severe
16,0,192,F,15,5,11,71,-121,Severe
11,10,142,M,45,7,10,94,-48,Severe
13,8,164,F,38,7,4,88,-76,Severe
14,4,172,M,105,13,9,165,-7,Severe
14,7,175,M,47,8,0,96,-79,Severe
11,11,143,F,34,7,0,84,-59,Severe
10,7,127,F,67,9,10,118,-9,Severe
14,3,171,M,79,11,1,133,-38,Severe
17,4,208,M,13,5,9,69,-139,Severe
15,8,188,M,45,7,10,94,-94,Severe
14,10,178,M,85,11,9,141,-37,Severe
14,2,170,F,41,7,6,90,-80,Severe
16,4,196,M,88,12,0,144,-52,Severe
13,8,164,F,33,6,11,83,-81,Severe
16,3,195,F,77,10,11,131,-64,Severe
7,5,89,M,4,5,4,64,-25,Severe
15,1,181,M,48,8,1,97,-84,Severe
11,3,135,F,99,13,1,157,22,Well
14,11,179,F,103,13,6,162,-17,Severe
10,1,121,M,69,10,1,121,0,Neutral
13,7,163,F,67,9,10,118,-45,Severe
16,8,200,M,91,12,4,148,-52,Severe
15,7,187,M,48,8,1,97,-90,Severe
12,1,145,M,101,13,4,160,15,Well
17,3,207,F,97,12,11,155,-52,Severe
15,3,183,M,48,8,1,97,-86,Severe
12,5,149,F,65,9,8,116,-33,Severe
17,6,210,M,80,11,3,135,-75,Severe
13,4,160,F,23,6,4,76,-84,Severe
14,5,173,F,61,9,3,111,-62,Severe
17,8,212,F,106,13,10,166,-46,Severe
7,7,91,M,56,8,9,105,14,Well
14,5,173,F,25,6,5,77,-96,Severe
8,11,107,F,91,12,4,148,41,Well
8,3,99,F,102,13,6,162,63,Well
5,8,68,M,28,6,8,80,12,Well
15,7,187,M,55,8,8,104,-83,Severe
10,4,124,F,3,5,3,63,-61,Severe
18,4,220,F,108,14,0,168,-52,Severe
13,6,162,M,53,8,6,102,-60,Severe
12,4,148,F,69,10,1,121,-27,Severe
15,8,188,F,13,5,9,69,-119,Severe
16,10,202,M,81,11,4,136,-66,Severe
13,11,167,M,72,10,4,124,-43,Severe
5,1,61,M,99,13,1,157,96,Well
7,0,84,F,79,11,1,133,49,Well
10,7,127,M,105,13,9,165,38,Well
16,11,203,F,79,11,1,133,-70,Severe
12,5,149,F,62,9,4,112,-37,Severe
10,3,123,F,64,9,7,115,-8,Severe
14,6,174,M,69,10,1,121,-53,Severe
18,11,227,F,87,11,11,143,-84,Severe
13,8,164,F,64,9,7,115,-49,Severe
15,4,184,F,88,12,0,144,-40,Severe
15,9,189,M,73,10,6,126,-63,Severe
6,5,77,M,100,13,3,159,82,Well
15,0,180,F,73,10,6,126,-54,Severe
13,2,158,M,63,9,6,114,-44,Severe
5,0,60,F,72,10,4,124,64,Well
16,3,195,F,102,13,6,162,-33,Severe
16,6,198,M,79,11,1,133,-65,Severe
15,2,182,F,94,12,7,151,-31,Severe
10,4,124,M,18,6,1,73,-51,Severe
14,10,178,F,99,13,1,157,-21,Severe
9,3,111,F,11,5,8,68,-43,Severe
9,8,116,M,3,5,3,63,-53,Severe
16,10,202,F,105,13,9,165,-37,Severe
7,0,84,F,15,5,11,71,-13,Severe
18,6,222,M,82,11,5,137,-85,Severe
6,1,73,F,81,11,4,136,63,Well
16,5,197,M,15,5,11,71,-126,Severe
5,2,62,M,16,5,11,71,9,Well
14,11,179,M,107,13,11,167,-12,Severe
10,2,122,M,28,6,8,80,-42,Severe
18,3,219,F,42,7,7,91,-128,Severe
13,7,163,M,28,6,8,80,-83,Severe
16,3,195,M,43,7,8,92,-103,Severe
5,2,62,F,109,14,1,169,107,Well
10,7,127,M,84,11,7,139,12,Well
11,4,136,F,108,14,0,168,32,Well
10,5,125,F,85,11,9,141,16,Well
7,6,90,M,10,5,7,67,-23,Severe
7,10,94,M,105,13,9,165,71,Well
10,3,123,M,91,12,4,148,25,Well
15,10,190,M,74,10,7,127,-63,Severe
10,3,123,F,65,9,8,116,-7,Severe
17,9,213,M,90,12,3,147,-66,Severe
8,8,104,M,13,5,9,69,-35,Severe
7,4,88,F,39,7,5,89,1,Good
17,11,215,M,100,13,3,159,-56,Severe
8,4,100,M,99,13,1,157,57,Well
8,3,99,M,55,8,8,104,5,Good
5,3,63,M,67,9,10,118,55,Well
9,4,112,F,110,14,3,171,59,Well
16,5,197,M,37,7,3,87,-110,Severe
13,3,159,M,72,10,4,124,-35,Severe
10,3,123,F,34,7,0,84,-39,Severe
7,3,87,F,61,9,3,111,24,Well
14,8,176,F,69,10,1,121,-55,Severe
7,11,95,M,55,8,8,104,9,Well
12,1,145,F,16,5,11,71,-74,Severe
13,3,159,F,59,9,1,109,-50,Severe
11,11,143,M,15,5,11,71,-72,Severe
14,3,171,F,17,6,0,72,-99,Severe
15,3,183,M,8,5,6,66,-117,Severe
11,2,134,M,45,7,10,94,-40,Severe
7,11,95,M,60,9,2,110,15,Well
12,1,145,F,37,7,3,87,-58,Severe
11,2,134,F,43,7,8,92,-42,Severe
8,4,100,F,46,7,11,95,-5,Mild
7,6,90,M,63,9,6,114,24,Well
14,11,179,M,106,13,10,166,-13,Severe
7,0,84,F,52,8,5,101,17,Well
17,11,215,F,88,12,0,144,-71,Severe
13,11,167,F,64,9,7,115,-52,Severe
9,8,116,M,61,9,3,111,-5,Mild
15,3,183,F,87,11,11,143,-40,Severe
18,5,221,F,54,8,7,103,-118,Severe
10,1,121,F,19,6,1,73,-48,Severe
13,10,166,F,72,10,4,124,-42,Severe
5,9,69,F,93,12,6,150,81,Well
8,2,98,M,100,13,3,159,61,Well
7,5,89,M,18,6,1,73,-16,Severe
9,5,113,M,26,6,6,78,-35,Severe
14,3,171,M,47,8,0,96,-75,Severe
15,5,185,F,108,14,0,168,-17,Severe
14,10,178,M,26,6,6,78,-100,Severe
7,6,90,M,65,9,8,116,26,Well
10,9,129,F,76,10,10,130,1,Good
16,3,195,M,19,6,1,73,-122,Severe
10,2,122,F,36,7,2,86,-36,Severe
11,7,139,M,86,11,10,142,3,Good
12,6,150,M,28,6,8,80,-70,Severe
15,7,187,F,56,8,9,105,-82,Severe
13,1,157,M,35,7,1,85,-72,Severe
6,4,76,M,63,9,6,114,38,Well
15,2,182,F,66,9,9,117,-65,Severe
13,7,163,F,79,11,1,133,-30,Severe
8,8,104,F,104,13,7,163,59,Well
8,3,99,M,65,9,8,116,17,Well
9,9,117,F,56,8,9,105,-12,Severe
15,10,190,F,80,11,3,135,-55,Severe
15,4,184,F,46,7,11,95,-89,Severe
13,4,160,M,98,13,0,156,-4,Mild
17,0,204,F,27,6,7,79,-125,Severe
14,5,173,F,100,13,3,159,-14,Severe
7,6,90,M,39,7,5,89,-1,Mild
17,3,207,M,50,8,3,99,-108,Severe
11,0,132,M,90,12,3,147,15,Well
6,4,76,F,42,7,7,91,15,Well
9,3,111,M,14,5,10,70,-41,Severe
8,9,105,F,97,12,11,155,50,Well
14,3,171,M,96,12,10,154,-17,Severe
13,0,156,M,3,5,3,63,-93,Severe
14,9,177,F,48,8,1,97,-80,Severe
13,3,159,M,21,6,2,74,-85,Severe
5,0,60,F,54,8,7,103,43,Well
17,10,214,M,76,10,10,130,-84,Severe
5,5,65,F,27,6,7,79,14,Well
6,3,75,F,58,9,0,108,33,Well
9,8,116,M,110,14,3,171,55,Well
6,10,82,M,3,5,3,63,-19,Severe
11,8,140,F,42,7,7,91,-49,Severe
17,3,207,M,10,5,7,67,-140,Severe
12,3,147,F,58,9,0,108,-39,Severe
7,10,94,M,78,11,0,132,38,Well
6,5,77,F,60,9,2,110,33,Well
12,0,144,F,88,12,0,144,0,Neutral
13,11,167,M,20,6,2,74,-93,Severe
10,7,127,M,37,7,3,87,-40,Severe
11,3,135,M,109,14,1,169,34,Well
9,2,110,M,67,9,10,118,8,Well
8,8,104,F,110,14,3,171,67,Well
6,2,74,M,21,6,2,74,0,Neutral
9,6,114,F,10,5,7,67,-47,Severe
6,9,81,F,73,10,6,126,45,Well
10,3,123,F,99,13,1,157,34,Well
9,1,109,F,94,12,7,151,42,Well
5,7,67,M,106,13,10,166,99,Well
16,4,196,M,14,5,10,70,-126,Severe
8,0,96,F,29,6,8,80,-16,Severe
12,3,147,M,52,8,5,101,-46,Severe
18,2,218,M,38,7,4,88,-130,Severe
16,4,196,F,73,10,6,126,-70,Severe
15,7,187,M,21,6,2,74,-113,Severe
17,10,214,F,74,10,7,127,-87,Severe
11,3,135,M,35,7,1,85,-50,Severe
15,5,185,F,79,11,1,133,-52,Severe
12,5,149,F,2,5,3,63,-86,Severe
10,3,123,F,14,5,10,70,-53,Severe
9,3,111,M,8,5,6,66,-45,Severe
17,2,206,M,50,8,3,99,-107,Severe
9,9,117,M,67,9,10,118,1,Good
7,7,91,F,105,13,9,165,74,Well
9,1,109,M,48,8,1,97,-12,Severe
12,3,147,F,105,13,9,165,18,Well
16,1,193,M,99,13,1,157,-36,Severe
10,11,131,M,32,6,10,82,-49,Severe
7,3,87,M,62,9,4,112,25,Well
9,6,114,F,53,8,6,102,-12,Severe
13,8,164,F,66,9,9,117,-47,Severe
18,0,216,M,38,7,4,88,-128,Severe
6,7,79,M,107,13,11,167,88,Well
6,0,72,M,29,6,8,80,8,Well
16,5,197,M,38,7,4,88,-109,Severe
16,9,201,M,70,10,2,122,-79,Severe
12,2,146,M,10,5,7,67,-79,Severe
15,3,183,M,82,11,5,137,-46,Severe
17,1,205,F,29,6,8,80,-125,Severe
16,0,192,M,37,7,3,87,-105,Severe
15,2,182,F,86,11,10,142,-40,Severe
6,3,75,M,45,7,10,94,19,Well
11,2,134,M,29,6,8,80,-54,Severe
12,7,151,M,11,5,8,68,-83,Severe
12,3,147,F,39,7,5,89,-58,Severe
13,3,159,F,105,13,9,165,6,Well
9,7,115,M,101,13,4,160,45,Well
17,3,207,M,7,5,6,66,-141,Severe
7,7,91,F,64,9,7,115,24,Well
17,6,210,F,73,10,6,126,-84,Severe
15,4,184,M,93,12,6,150,-34,Severe
14,11,179,F,95,12,9,153,-26,Severe
17,4,208,F,86,11,10,142,-66,Severe
8,2,98,F,99,13,1,157,59,Well
13,5,161,F,28,6,8,80,-81,Severe
8,2,98,M,110,14,3,171,73,Well
14,2,170,M,103,13,6,162,-8,Severe
14,7,175,M,42,7,7,91,-84,Severe
16,0,192,F,95,12,9,153,-39,Severe
13,11,167,M,8,5,6,66,-101,Severe
14,2,170,F,4,5,4,64,-106,Severe
7,6,90,M,85,11,9,141,51,Well
9,4,112,M,80,11,3,135,23,Well
6,3,75,M,87,11,11,143,68,Well
7,3,87,M,44,7,9,93,6,Well
15,10,190,M,80,11,3,135,-55,Severe
10,10,130,M,95,12,9,153,23,Well
14,3,171,F,42,7,7,91,-80,Severe
8,1,97,F,30,6,9,81,-16,Severe
14,9,177,F,96,12,10,154,-23,Severe
17,0,204,F,63,9,6,114,-90,Severe
17,5,209,M,99,13,1,157,-52,Severe
15,8,188,F,78,11,0,132,-56,Severe
15,5,185,F,55,8,8,104,-81,Severe
10,0,120,F,95,12,9,153,33,Well
18,10,226,F,77,10,11,131,-95,Severe
17,7,211,M,67,9,10,118,-93,Severe
16,10,202,F,106,13,10,166,-36,Severe
12,6,150,M,106,13,10,166,16,Well
7,0,84,F,88,12,0,144,60,Well
16,10,202,F,95,12,9,153,-49,Severe
6,1,73,F,76,10,10,130,57,Well
8,7,103,F,110,14,3,171,68,Well
6,11,83,M,98,13,0,156,73,Well
10,8,128,F,51,8,4,100,-28,Severe
18,5,221,F,6,5,5,65,-156,Severe
17,3,207,F,61,9,3,111,-96,Severe
5,3,63,F,92,12,5,149,86,Well
16,6,198,M,55,8,8,104,-94,Severe
11,3,135,F,46,7,11,95,-40,Severe
15,1,181,M,52,8,5,101,-80,Severe
17,3,207,F,45,7,10,94,-113,Severe
14,11,179,F,34,7,0,84,-95,Severe
11,2,134,M,51,8,4,100,-34,Severe
18,11,227,F,63,9,6,114,-113,Severe
6,9,81,F,97,12,11,155,74,Well
11,4,136,F,87,11,11,143,7,Well
14,6,174,F,58,9,0,108,-66,Severe
18,3,219,F,20,6,2,74,-145,Severe
8,6,102,M,45,7,10,94,-8,Severe
11,3,135,M,84,11,7,139,4,Good
15,9,189,F,23,6,4,76,-113,Severe
17,10,214,M,91,12,4,148,-66,Severe
17,0,204,F,53,8,6,102,-102,Severe
10,9,129,F,23,6,4,76,-53,Severe
17,4,208,M,99,13,1,157,-51,Severe
8,8,104,F,68,10,0,120,16,Well
6,3,75,M,99,13,1,157,82,Well
9,1,109,F,83,11,6,138,29,Well
10,6,126,F,69,10,1,121,-5,Mild
10,9,129,F,85,11,9,141,12,Well
11,3,135,F,107,13,11,167,32,Well
11,10,142,F,37,7,3,87,-55,Severe
18,10,226,M,75,10,9,129,-97,Severe
18,8,224,M,81,11,4,136,-88,Severe
13,3,159,F,86,11,10,142,-17,Severe
13,11,167,M,51,8,4,100,-67,Severe
17,7,211,F,60,9,2,110,-101,Severe
12,7,151,M,102,13,6,162,11,Well
18,2,218,M,71,10,3,123,-95,Severe
10,11,131,M,105,13,9,165,34,Well
13,3,159,F,80,11,3,135,-24,Severe
16,5,197,F,83,11,6,138,-59,Severe
14,4,172,M,53,8,6,102,-70,Severe
11,3,135,M,87,11,11,143,8,Well
17,3,207,F,89,12,1,145,-62,Severe
12,7,151,F,110,14,3,171,20,Well
5,7,67,F,108,14,0,168,101,Well
11,2,134,M,27,6,7,79,-55,Severe
10,1,121,M,48,8,1,97,-24,Severe
6,10,82,M,14,5,10,70,-12,Severe
10,1,121,M,32,6,10,82,-39,Severe
7,10,94,M,40,7,5,89,-5,Mild
17,6,210,F,92,12,5,149,-61,Severe
16,9,201,F,68,10,0,120,-81,Severe
13,4,160,M,22,6,3,75,-85,Severe
17,5,209,F,2,5,3,63,-146,Severe
14,6,174,M,60,9,2,110,-64,Severe
6,4,76,M,65,9,8,116,40,Well
13,8,164,F,67,9,10,118,-46,Severe
13,3,159,M,109,14,1,169,10,Well
15,5,185,M,89,12,1,145,-40,Severe
16,7,199,M,90,12,3,147,-52,Severe
16,3,195,F,19,6,1,73,-122,Severe
5,0,60,F,22,6,3,75,15,Well
17,5,209,M,76,10,10,130,-79,Severe
18,11,227,F,51,8,4,100,-127,Severe
11,6,138,M,50,8,3,99,-39,Severe
18,6,222,M,98,13,0,156,-66,Severe
6,3,75,F,87,11,11,143,68,Well
15,1,181,F,63,9,6,114,-67,Severe
18,2,218,F,70,10,2,122,-96,Severe
16,5,197,F,80,11,3,135,-62,Severe
6,7,79,F,104,13,7,163,84,Well
16,8,200,M,101,13,4,160,-40,Severe
15,5,185,M,32,6,10,82,-103,Severe
11,7,139,M,99,13,1,157,18,Well
18,11,227,M,94,12,7,151,-76,Severe
18,6,222,F,78,11,0,132,-90,Severe
16,1,193,F,59,9,1,109,-84,Severe
18,0,216,M,61,9,3,111,-105,Severe
17,5,209,M,43,7,8,92,-117,Severe
17,11,215,F,29,6,8,80,-135,Severe
7,4,88,M,65,9,8,116,28,Well
11,3,135,F,49,8,2,98,-37,Severe
9,5,113,M,44,7,9,93,-20,Severe
8,3,99,M,48,8,1,97,-2,Mild
17,5,209,M,46,7,11,95,-114,Severe
7,7,91,F,29,6,8,80,-11,Severe
16,2,194,M,78,11,0,132,-62,Severe
17,1,205,F,100,13,3,159,-46,Severe
8,6,102,F,77,10,11,131,29,Well
18,4,220,F,3,5,3,63,-157,Severe
8,3,99,M,18,6,1,73,-26,Severe
15,3,183,F,80,11,3,135,-48,Severe
6,11,83,M,47,8,0,96,13,Well
9,8,116,M,89,12,1,145,29,Well
8,9,105,F,42,7,7,91,-14,Severe
10,3,123,M,70,10,2,122,-1,Mild
9,11,119,F,39,7,5,89,-30,Severe
7,1,85,F,52,8,5,101,16,Well
10,9,129,F,65,9,8,116,-13,Severe
15,0,180,F,88,12,0,144,-36,Severe
14,6,174,M,11,5,8,68,-106,Severe
14,4,172,F,90,12,3,147,-25,Severe
7,3,87,M,106,13,10,166,79,Well
15,10,190,F,103,13,6,162,-28,Severe
7,5,89,F,28,6,8,80,-9,Severe
10,0,120,F,30,6,9,81,-39,Severe
7,0,84,F,56,8,9,105,21,Well
8,8,104,M,98,13,0,156,52,Well
17,3,207,F,96,12,10,154,-53,Severe
9,7,115,F,76,10,10,130,15,Well
12,7,151,F,7,5,6,66,-85,Severe
14,2,170,F,31,6,9,81,-89,Severe
5,9,69,M,88,12,0,144,75,Well
18,11,227,F,40,7,5,89,-138,Severe
16,8,200,F,105,13,9,165,-35,Severe
13,0,156,F,38,7,4,88,-68,Severe
12,0,144,F,97,12,11,155,11,Well
6,4,76,M,82,11,5,137,61,Well
8,9,105,M,90,12,3,147,42,Well
10,9,129,M,51,8,4,100,-29,Severe
12,7,151,F,92,12,5,149,-2,Mild
18,7,223,F,66,9,9,117,-106,Severe
15,0,180,F,81,11,4,136,-44,Severe
8,3,99,F,72,10,4,124,25,Well
8,2,98,F,89,12,1,145,47,Well
13,3,159,M,46,7,11,95,-64,Severe
7,3,87,F,27,6,7,79,-8,Severe
10,1,121,F,13,5,9,69,-52,Severe
15,0,180,M,23,6,4,76,-104,Severe
10,8,128,M,15,5,11,71,-57,Severe
10,0,120,F,97,12,11,155,35,Well
12,0,144,M,11,5,8,68,-76,Severe
16,10,202,F,56,8,9,105,-97,Severe
17,9,213,F,58,9,0,108,-105,Severe
18,3,219,M,12,5,9,69,-150,Severe
13,8,164,M,101,13,4,160,-4,Mild
5,6,66,M,62,9,4,112,46,Well
10,7,127,M,52,8,5,101,-26,Severe
18,6,222,M,77,10,11,131,-91,Severe
5,0,60,F,5,5,5,65,5,Good
6,3,75,F,92,12,5,149,74,Well
16,8,200,F,20,6,2,74,-126,Severe
13,0,156,F,39,7,5,89,-67,Severe
18,1,217,M,62,9,4,112,-105,Severe
9,9,117,M,84,11,7,139,22,Well
18,9,225,M,5,5,5,65,-160,Severe
14,1,169,M,32,6,10,82,-87,Severe
17,0,204,F,81,11,4,136,-68,Severe
11,3,135,F,83,11,6,138,3,Good
14,3,171,M,77,10,11,131,-40,Severe
6,9,81,F,47,8,0,96,15,Well
7,5,89,M,84,11,7,139,50,Well
10,5,125,M,55,8,8,104,-21,Severe
18,10,226,M,61,9,3,111,-115,Severe
11,3,135,M,100,13,3,159,24,Well
17,8,212,F,51,8,4,100,-112,Severe
10,3,123,F,28,6,8,80,-43,Severe
14,11,179,F,19,6,1,73,-106,Severe
16,3,195,M,4,5,4,64,-131,Severe
13,1,157,M,64,9,7,115,-42,Severe
15,4,184,M,55,8,8,104,-80,Severe
16,3,195,M,4,5,4,64,-131,Severe
10,0,120,F,21,6,2,74,-46,Severe
9,2,110,M,62,9,4,112,2,Good
14,10,178,M,20,6,2,74,-104,Severe
17,1,205,F,106,13,10,166,-39,Severe
14,7,175,M,9,5,7,67,-108,Severe
13,5,161,M,82,11,5,137,-24,Severe
11,1,133,F,50,8,3,99,-34,Severe
8,2,98,M,99,13,1,157,59,Well
9,3,111,M,14,5,10,70,-41,Severe
14,2,170,F,32,6,10,82,-88,Severe
7,3,87,F,45,7,10,94,7,Well
18,9,225,M,12,5,9,69,-156,Severe
17,1,205,F,41,7,6,90,-115,Severe
8,7,103,M,37,7,3,87,-16,Severe
14,3,171,M,81,11,4,136,-35,Severe
8,7,103,M,12,5,9,69,-34,Severe
12,2,146,F,31,6,9,81,-65,Severe
11,1,133,M,83,11,6,138,5,Good
16,6,198,F,33,6,11,83,-115,Severe
8,3,99,M,13,5,9,69,-30,Severe
17,2,206,F,18,6,1,73,-133,Severe
7,7,91,F,52,8,5,101,10,Well
14,0,168,F,26,6,6,78,-90,Severe
6,6,78,M,50,8,3,99,21,Well
15,11,191,M,79,11,1,133,-58,Severe
7,1,85,M,76,10,10,130,45,Well
17,11,215,M,27,6,7,79,-136,Severe
10,2,122,F,12,5,9,69,-53,Severe
16,2,194,F,46,7,11,95,-99,Severe
17,9,213,M,20,6,2,74,-139,Severe
9,3,111,M,35,7,1,85,-26,Severe
17,8,212,M,61,9,3,111,-101,Severe
15,7,187,M,85,11,9,141,-46,Severe
13,8,164,F,10,5,7,67,-97,Severe
14,7,175,F,105,13,9,165,-10,Severe
14,1,169,F,49,8,2,98,-71,Severe
14,10,178,F,77,10,11,131,-47,Severe
14,1,169,M,97,12,11,155,-14,Severe
18,6,222,M,85,11,9,141,-81,Severe
6,6,78,M,15,5,11,71,-7,Severe
10,2,122,M,91,12,4,148,26,Well
6,10,82,M,49,8,2,98,16,Well
11,8,140,F,48,8,1,97,-43,Severe
9,3,111,M,46,7,11,95,-16,Severe
15,1,181,M,54,8,7,103,-78,Severe
14,1,169,M,30,6,9,81,-88,Severe
9,0,108,F,93,12,6,150,42,Well
7,2,86,F,4,5,4,64,-22,Severe
8,2,98,M,49,8,2,98,0,Neutral
5,8,68,F,26,6,6,78,10,Well
11,1,133,F,75,10,9,129,-4,Mild
17,3,207,M,17,6,0,72,-135,Severe
13,9,165,F,65,9,8,116,-49,Severe
17,3,207,M,72,10,4,124,-83,Severe
14,9,177,M,59,9,1,109,-68,Severe
10,9,129,F,104,13,7,163,34,Well
15,9,189,M,2,5,3,63,-126,Severe
9,10,118,F,61,9,3,111,-7,Severe
7,3,87,M,6,5,5,65,-22,Severe
13,3,159,M,35,7,1,85,-74,Severe
9,10,118,M,10,5,7,67,-51,Severe
11,9,141,M,81,11,4,136,-5,Mild
8,3,99,F,54,8,7,103,4,Good
12,3,147,M,33,6,11,83,-64,Severe
13,2,158,M,4,5,4,64,-94,Severe
10,3,123,F,25,6,5,77,-46,Severe
13,1,157,F,12,5,9,69,-88,Severe
13,2,158,M,79,11,1,133,-25,Severe
8,8,104,M,59,9,1,109,5,Good
14,1,169,M,8,5,6,66,-103,Severe
13,11,167,F,33,6,11,83,-84,Severe
9,6,114,M,78,11,0,132,18,Well
9,1,109,F,7,5,6,66,-43,Severe
13,10,166,F,13,5,9,69,-97,Severe
10,10,130,M,2,5,3,63,-67,Severe
5,6,66,M,5,5,5,65,-1,Mild
15,9,189,F,98,13,0,156,-33,Severe
8,3,99,F,96,12,10,154,55,Well
16,5,197,F,54,8,7,103,-94,Severe
7,0,84,F,67,9,10,118,34,Well
5,4,64,F,87,11,11,143,79,Well
17,9,213,F,16,5,11,71,-142,Severe
11,4,136,M,110,14,3,171,35,Well
6,3,75,F,69,10,1,121,46,Well
9,10,118,M,49,8,2,98,-20,Severe
14,6,174,F,6,5,5,65,-109,Severe
14,3,171,F,66,9,9,117,-54,Severe
13,2,158,F,101,13,4,160,2,Good
15,6,186,M,63,9,6,114,-72,Severe
11,10,142,F,107,13,11,167,25,Well
10,5,125,M,67,9,10,118,-7,Severe
10,11,131,F,12,5,9,69,-62,Severe
9,9,117,M,102,13,6,162,45,Well
16,3,195,F,55,8,8,104,-91,Severe
6,9,81,M,44,7,9,93,12,Well
6,4,76,M,35,7,1,85,9,Well
16,0,192,F,36,7,2,86,-106,Severe
8,0,96,M,97,12,11,155,59,Well
5,2,62,M,100,13,3,159,97,Well
17,3,207,F,103,13,6,162,-45,Severe
16,7,199,F,73,10,6,126,-73,Severe
8,0,96,M,95,12,9,153,57,Well
11,8,140,M,43,7,8,92,-48,Severe
12,2,146,F,3,5,3,63,-83,Severe
5,4,64,F,108,14,0,168,104,Well
18,1,217,M,26,6,6,78,-139,Severe
14,4,172,M,22,6,3,75,-97,Severe
10,11,131,F,102,13,6,162,31,Well
18,3,219,F,73,10,6,126,-93,Severe
6,3,75,M,99,13,1,157,82,Well
7,5,89,M,28,6,8,80,-9,Severe
13,10,166,M,46,7,11,95,-71,Severe
16,6,198,F,23,6,4,76,-122,Severe
13,4,160,F,109,14,1,169,9,Well
14,10,178,F,54,8,7,103,-75,Severe
9,9,117,F,100,13,3,159,42,Well
12,5,149,F,64,9,7,115,-34,Severe
9,7,115,M,88,12,0,144,29,Well
8,0,96,M,108,14,0,168,72,Well
9,10,118,M,6,5,5,65,-53,Severe
11,1,133,F,15,5,11,71,-62,Severe
15,1,181,F,27,6,7,79,-102,Severe
13,8,164,F,77,10,11,131,-33,Severe
13,3,159,F,96,12,10,154,-5,Mild
11,6,138,M,34,7,0,84,-54,Severe
16,2,194,M,59,9,1,109,-85,Severe
8,10,106,M,46,7,11,95,-11,Severe
14,3,171,F,105,13,9,165,-6,Severe
11,3,135,M,27,6,7,79,-56,Severe
16,3,195,M,31,6,9,81,-114,Severe
17,5,209,F,19,6,1,73,-136,Severe
15,5,185,F,41,7,6,90,-95,Severe
11,6,138,F,109,14,1,169,31,Well
12,6,150,F,46,7,11,95,-55,Severe
14,3,171,M,14,5,10,70,-101,Severe
7,1,85,F,56,8,9,105,20,Well
13,2,158,F,21,6,2,74,-84,Severe
16,9,201,F,100,13,3,159,-42,Severe
9,6,114,M,9,5,7,67,-47,Severe
10,5,125,M,94,12,7,151,26,Well
5,1,61,M,13,5,9,69,8,Well
13,11,167,M,29,6,8,80,-87,Severe
11,3,135,M,15,5,11,71,-64,Severe
9,3,111,F,36,7,2,86,-25,Severe
5,4,64,F,84,11,7,139,75,Well
11,6,138,F,73,10,6,126,-12,Severe
12,10,154,M,20,6,2,74,-80,Severe
9,2,110,M,41,7,6,90,-20,Severe
8,7,103,F,94,12,7,151,48,Well
8,11,107,M,20,6,2,74,-33,Severe
7,9,93,M,21,6,2,74,-19,Severe
6,11,83,M,105,13,9,165,82,Well
8,2,98,F,83,11,6,138,40,Well
14,2,170,F,53,8,6,102,-68,Severe
16,8,200,F,100,13,3,159,-41,Severe
18,8,224,F,99,13,1,157,-67,Severe
11,10,142,F,108,14,0,168,26,Well
18,11,227,F,110,14,3,171,-56,Severe
5,5,65,M,93,12,6,150,85,Well
8,5,101,M,38,7,4,88,-13,Severe
12,6,150,F,35,7,1,85,-65,Severe
8,10,106,M,59,9,1,109,3,Good
6,7,79,M,12,5,9,69,-10,Severe
9,2,110,F,66,9,9,117,7,Well
10,1,121,M,109,14,1,169,48,Well
15,8,188,F,2,5,3,63,-125,Severe
8,3,99,F,72,10,4,124,25,Well
10,7,127,M,101,13,4,160,33,Well
8,11,107,M,40,7,5,89,-18,Severe
9,11,119,F,60,9,2,110,-9,Severe
18,1,217,F,61,9,3,111,-106,Severe
8,8,104,F,20,6,2,74,-30,Severe
8,0,96,F,15,5,11,71,-25,Severe
18,1,217,M,50,8,3,99,-118,Severe
17,4,208,F,17,6,0,72,-136,Severe
8,2,98,F,30,6,9,81,-17,Severe
12,4,148,F,109,14,1,169,21,Well
15,6,186,F,62,9,4,112,-74,Severe
15,8,188,M,25,6,5,77,-111,Severe
10,3,123,M,61,9,3,111,-12,Severe
15,0,180,F,104,13,7,163,-17,Severe
17,1,205,F,52,8,5,101,-104,Severe
8,3,99,F,80,11,3,135,36,Well
10,6,126,M,22,6,3,75,-51,Severe
10,4,124,M,72,10,4,124,0,Neutral
12,10,154,F,30,6,9,81,-73,Severe
13,0,156,F,33,6,11,83,-73,Severe
7,3,87,F,66,9,9,117,30,Well
13,1,157,M,39,7,5,89,-68,Severe
7,1,85,M,8,5,6,66,-19,Severe
14,11,179,F,63,9,6,114,-65,Severe
14,6,174,F,67,9,10,118,-56,Severe
18,6,222,F,99,13,1,157,-65,Severe
5,9,69,M,47,8,0,96,27,Well
7,3,87,M,14,5,10,70,-17,Severe
8,8,104,F,74,10,7,127,23,Well
14,6,174,F,65,9,8,116,-58,Severe
12,2,146,F,37,7,3,87,-59,Severe
15,6,186,F,99,13,1,157,-29,Severe
13,7,163,F,43,7,8,92,-71,Severe
11,4,136,M,42,7,7,91,-45,Severe
13,1,157,F,3,5,3,63,-94,Severe
18,3,219,F,49,8,2,98,-121,Severe
15,11,191,F,53,8,6,102,-89,Severe
9,9,117,F,103,13,6,162,45,Well
9,4,112,M,9,5,7,67,-45,Severe
15,4,184,M,57,8,10,106,-78,Severe
14,9,177,F,50,8,3,99,-78,Severe
8,1,97,F,89,12,1,145,48,Well
14,8,176,F,75,10,9,129,-47,Severe
17,3,207,F,9,5,7,67,-140,Severe
14,3,171,M,90,12,3,147,-24,Severe
6,9,81,M,57,8,10,106,25,Well
10,5,125,F,20,6,2,74,-51,Severe
15,3,183,M,11,5,8,68,-115,Severe
18,10,226,F,20,6,2,74,-152,Severe
12,6,150,M,9,5,7,67,-83,Severe
8,10,106,M,7,5,6,66,-40,Severe
12,5,149,M,5,5,5,65,-84,Severe
16,5,197,F,13,5,9,69,-128,Severe
18,10,226,F,55,8,8,104,-122,Severe
6,0,72,F,12,5,9,69,-3,Mild
15,7,187,F,78,11,0,132,-55,Severe
5,7,67,M,95,12,9,153,86,Well
12,3,147,M,29,6,8,80,-67,Severe
9,11,119,F,41,7,6,90,-29,Severe
11,3,135,M,106,13,10,166,31,Well
15,7,187,M,101,13,4,160,-27,Severe
13,7,163,F,22,6,3,75,-88,Severe
5,5,65,F,110,14,3,171,106,Well
9,4,112,F,36,7,2,86,-26,Severe
5,3,63,F,57,8,10,106,43,Well
13,10,166,M,55,8,8,104,-62,Severe
9,3,111,M,31,6,9,81,-30,Severe
6,9,81,M,14,5,10,70,-11,Severe
7,5,89,F,66,9,9,117,28,Well
8,0,96,M,47,8,0,96,0,Neutral
7,5,89,M,59,9,1,109,20,Well
8,0,96,F,4,5,4,64,-32,Severe
15,6,186,F,44,7,9,93,-93,Severe
6,4,76,M,33,6,11,83,7,Well
18,2,218,F,20,6,2,74,-144,Severe
16,5,197,M,20,6,2,74,-123,Severe
15,5,185,M,38,7,4,88,-97,Severe
5,7,67,M,69,10,1,121,54,Well
16,7,199,M,22,6,3,75,-124,Severe
12,3,147,F,86,11,10,142,-5,Mild
11,6,138,M,76,10,10,130,-8,Severe
5,9,69,M,48,8,1,97,28,Well
10,3,123,F,78,11,0,132,9,Well
16,0,192,M,94,12,7,151,-41,Severe
11,6,138,F,49,8,2,98,-40,Severe
15,2,182,F,64,9,7,115,-67,Severe
5,7,67,M,78,11,0,132,65,Well
15,7,187,M,71,10,3,123,-64,Severe
12,11,155,F,31,6,9,81,-74,Severe
10,4,124,F,41,7,6,90,-34,Severe
13,9,165,M,35,7,1,85,-80,Severe
7,3,87,M,16,5,11,71,-16,Severe
14,6,174,M,78,11,0,132,-42,Severe
18,6,222,F,71,10,3,123,-99,Severe
11,7,139,F,87,11,11,143,4,Good
18,3,219,M,26,6,6,78,-141,Severe
5,3,63,M,61,9,3,111,48,Well
10,8,128,F,9,5,7,67,-61,Severe
9,7,115,F,56,8,9,105,-10,Severe
5,1,61,M,49,8,2,98,37,Well
15,4,184,F,86,11,10,142,-42,Severe
15,8,188,M,47,8,0,96,-92,Severe
14,10,178,F,42,7,7,91,-87,Severe
15,6,186,M,26,6,6,78,-108,Severe
16,0,192,F,33,6,11,83,-109,Severe
12,5,149,M,34,7,0,84,-65,Severe
5,3,63,M,13,5,9,69,6,Well
17,0,204,F,83,11,6,138,-66,Severe
15,11,191,F,15,5,11,71,-120,Severe
17,3,207,F,78,11,0,132,-75,Severe
11,11,143,M,76,10,10,130,-13,Severe
7,9,93,M,45,7,10,94,1,Good
8,10,106,M,84,11,7,139,33,Well
15,1,181,M,50,8,3,99,-82,Severe
8,11,107,M,8,5,6,66,-41,Severe
14,2,170,M,91,12,4,148,-22,Severe
7,4,88,M,76,10,10,130,42,Well
15,8,188,F,25,6,5,77,-111,Severe
8,4,100,M,15,5,11,71,-29,Severe
14,3,171,M,97,12,11,155,-16,Severe
5,10,70,M,49,8,2,98,28,Well
8,6,102,F,52,8,5,101,-1,Mild
7,11,95,M,47,8,0,96,1,Good
13,8,164,M,67,9,10,118,-46,Severe
6,3,75,M,107,13,11,167,92,Well
16,1,193,M,26,6,6,78,-115,Severe
17,8,212,F,79,11,1,133,-79,Severe
7,3,87,F,51,8,4,100,13,Well
16,9,201,F,58,9,0,108,-93,Severe
8,11,107,M,2,5,3,63,-44,Severe
7,2,86,F,38,7,4,88,2,Good
7,3,87,M,29,6,8,80,-7,Severe
7,11,95,F,49,8,2,98,3,Good
5,2,62,F,73,10,6,126,64,Well
5,5,65,F,82,11,5,137,72,Well
6,10,82,F,6,5,5,65,-17,Severe
5,0,60,F,39,7,5,89,29,Well
7,5,89,F,105,13,9,165,76,Well
14,9,177,F,62,9,4,112,-65,Severe
16,9,201,M,44,7,9,93,-108,Severe
14,11,179,M,76,10,10,130,-49,Severe
12,11,155,F,35,7,1,85,-70,Severe
16,7,199,F,63,9,6,114,-85,Severe
8,9,105,M,18,6,1,73,-32,Severe
15,3,183,F,4,5,4,64,-119,Severe
15,0,180,M,22,6,3,75,-105,Severe
12,5,149,M,20,6,2,74,-75,Severe
14,3,171,F,44,7,9,93,-78,Severe
17,10,214,M,16,5,11,71,-143,Severe
18,8,224,M,78,11,0,132,-92,Severe
11,6,138,F,26,6,6,78,-60,Severe
13,11,167,M,39,7,5,89,-78,Severe
16,8,200,M,48,8,1,97,-103,Severe
9,1,109,F,9,5,7,67,-42,Severe
11,3,135,F,87,11,11,143,8,Well
9,3,111,F,88,12,0,144,33,Well
6,3,75,F,2,5,3,63,-12,Severe
10,5,125,M,66,9,9,117,-8,Severe
11,3,135,F,29,6,8,80,-55,Severe
9,0,108,F,72,10,4,124,16,Well
8,6,102,F,32,6,10,82,-20,Severe
6,10,82,F,18,6,1,73,-9,Severe
17,4,208,M,106,13,10,166,-42,Severe
11,10,142,M,106,13,10,166,24,Well
17,11,215,F,63,9,6,114,-101,Severe
14,2,170,F,5,5,5,65,-105,Severe
7,6,90,F,25,6,5,77,-13,Severe
10,0,120,M,23,6,4,76,-44,Severe
10,8,128,F,68,10,0,120,-8,Severe
18,2,218,M,9,5,7,67,-151,Severe
16,9,201,F,108,14,0,168,-33,Severe
5,5,65,M,40,7,5,89,24,Well
10,9,129,F,62,9,4,112,-17,Severe
13,8,164,M,92,12,5,149,-15,Severe
15,7,187,F,41,7,6,90,-97,Severe
8,6,102,F,20,6,2,74,-28,Severe
18,9,225,F,43,7,8,92,-133,Severe
7,4,88,F,90,12,3,147,59,Well
16,9,201,F,75,10,9,129,-72,Severe
17,1,205,F,32,6,10,82,-123,Severe
15,3,183,M,68,10,0,120,-63,Severe
7,8,92,F,51,8,4,100,8,Well
7,7,91,F,14,5,10,70,-21,Severe
14,8,176,M,39,7,5,89,-87,Severe
8,3,99,M,43,7,8,92,-7,Severe
18,11,227,F,69,10,1,121,-106,Severe
6,1,73,F,66,9,9,117,44,Well
15,11,191,M,56,8,9,105,-86,Severe
5,9,69,M,89,12,1,145,76,Well
5,3,63,M,39,7,5,89,26,Well
5,11,71,F,102,13,6,162,91,Well
9,3,111,M,28,6,8,80,-31,Severe
11,9,141,M,33,6,11,83,-58,Severe
8,3,99,F,76,10,10,130,31,Well
17,8,212,M,80,11,3,135,-77,Severe
5,3,63,M,55,8,8,104,41,Well
8,10,106,F,60,9,2,110,4,Good
8,7,103,F,34,7,0,84,-19,Severe
14,6,174,F,97,12,11,155,-19,Severe
8,8,104,M,48,8,1,97,-7,Severe
7,11,95,M,76,10,10,130,35,Well
7,4,88,F,43,7,8,92,4,Good
10,5,125,M,25,6,5,77,-48,Severe
12,6,150,F,82,11,5,137,-13,Severe
17,6,210,F,89,12,1,145,-65,Severe
16,11,203,F,6,5,5,65,-138,Severe
12,1,145,M,3,5,3,63,-82,Severe
16,3,195,F,94,12,7,151,-44,Severe
9,2,110,M,44,7,9,93,-17,Severe
10,4,124,F,22,6,3,75,-49,Severe
14,9,177,M,70,10,2,122,-55,Severe
9,9,117,M,49,8,2,98,-19,Severe
10,7,127,M,41,7,6,90,-37,Severe
14,3,171,M,54,8,7,103,-68,Severe
15,8,188,F,3,5,3,63,-125,Severe
10,3,123,F,87,11,11,143,20,Well
16,7,199,M,11,5,8,68,-131,Severe
16,8,200,F,45,7,10,94,-106,Severe
6,0,72,M,6,5,5,65,-7,Severe
17,3,207,M,49,8,2,98,-109,Severe
11,2,134,F,9,5,7,67,-67,Severe
7,2,86,M,67,9,10,118,32,Well
15,3,183,F,20,6,2,74,-109,Severe
14,11,179,M,62,9,4,112,-67,Severe
12,6,150,M,50,8,3,99,-51,Severe
14,9,177,M,9,5,7,67,-110,Severe
5,3,63,M,49,8,2,98,35,Well
18,3,219,M,12,5,9,69,-150,Severe
15,8,188,F,22,6,3,75,-113,Severe
11,5,137,M,4,5,4,64,-73,Severe
14,11,179,F,73,10,6,126,-53,Severe
13,10,166,M,65,9,8,116,-50,Severe
18,3,219,F,87,11,11,143,-76,Severe
10,3,123,M,16,5,11,71,-52,Severe
17,11,215,F,57,8,10,106,-109,Severe
8,7,103,M,82,11,5,137,34,Well
11,5,137,M,100,13,3,159,22,Well
8,4,100,F,96,12,10,154,54,Well
16,4,196,F,15,5,11,71,-125,Severe
18,4,220,M,19,6,1,73,-147,Severe
7,0,84,M,86,11,10,142,58,Well
9,9,117,M,74,10,7,127,10,Well
5,0,60,M,95,12,9,153,93,Well
14,5,173,F,92,12,5,149,-24,Severe
16,9,201,F,27,6,7,79,-122,Severe
12,11,155,F,4,5,4,64,-91,Severe
17,2,206,M,6,5,5,65,-141,Severe
13,11,167,M,83,11,6,138,-29,Severe
15,2,182,F,44,7,9,93,-89,Severe
8,9,105,F,41,7,6,90,-15,Severe
8,3,99,F,79,11,1,133,34,Well
9,4,112,F,75,10,9,129,17,Well
11,8,140,F,70,10,2,122,-18,Severe
18,10,226,M,50,8,3,99,-127,Severe
9,11,119,F,40,7,5,89,-30,Severe
12,0,144,F,57,8,10,106,-38,Severe
11,8,140,M,31,6,9,81,-59,Severe
15,4,184,F,14,5,10,70,-114,Severe
13,11,167,F,88,12,0,144,-23,Severe
6,9,81,M,22,6,3,75,-6,Severe
15,2,182,M,32,6,10,82,-100,Severe
10,4,124,F,34,7,0,84,-40,Severe
9,3,111,M,12,5,9,69,-42,Severe
8,7,103,F,95,12,9,153,50,Well
13,7,163,M,102,13,6,162,-1,Mild
12,6,150,F,26,6,6,78,-72,Severe
9,2,110,M,93,12,6,150,40,Well
7,3,87,F,49,8,2,98,11,Well
5,6,66,M,11,5,8,68,2,Good
10,6,126,M,95,12,9,153,27,Well
6,9,81,F,106,13,10,166,85,Well
18,8,224,M,55,8,8,104,-120,Severe
8,4,100,F,49,8,2,98,-2,Mild
14,6,174,F,27,6,7,79,-95,Severe
10,2,122,M,58,9,0,108,-14,Severe
9,2,110,M,99,13,1,157,47,Well
18,8,224,F,3,5,3,63,-161,Severe
10,7,127,F,61,9,3,111,-16,Severe
14,4,172,F,7,5,6,66,-106,Severe
7,11,95,M,66,9,9,117,22,Well
14,2,170,M,15,5,11,71,-99,Severe
8,3,99,M,11,5,8,68,-31,Severe
7,7,91,M,63,9,6,114,23,Well
6,9,81,F,105,13,9,165,84,Well
18,11,227,F,25,6,5,77,-150,Severe
13,11,167,M,90,12,3,147,-20,Severe
16,9,201,F,26,6,6,78,-123,Severe
12,3,147,F,63,9,6,114,-33,Severe
8,10,106,F,29,6,8,80,-26,Severe
17,1,205,M,20,6,2,74,-131,Severe
8,9,105,M,95,12,9,153,48,Well
7,5,89,M,94,12,7,151,62,Well
8,11,107,F,57,8,10,106,-1,Mild
18,3,219,F,91,12,4,148,-71,Severe
18,9,225,F,24,6,5,77,-148,Severe
14,0,168,M,33,6,11,83,-85,Severe
13,5,161,M,76,10,10,130,-31,Severe
9,8,116,M,69,10,1,121,5,Good
18,5,221,F,33,6,11,83,-138,Severe
9,8,116,F,44,7,9,93,-23,Severe
13,7,163,F,39,7,5,89,-74,Severe
18,11,227,F,55,8,8,104,-123,Severe
13,10,166,F,57,8,10,106,-60,Severe
10,8,128,F,82,11,5,137,9,Well
9,0,108,F,41,7,6,90,-18,Severe
10,8,128,F,74,10,7,127,-1,Mild
12,8,152,M,8,5,6,66,-86,Severe
6,5,77,M,69,10,1,121,44,Well
10,3,123,F,10,5,7,67,-56,Severe
13,7,163,M,91,12,4,148,-15,Severe
6,8,80,F,82,11,5,137,57,Well
13,0,156,F,41,7,6,90,-66,Severe
15,3,183,M,38,7,4,88,-95,Severe
18,4,220,M,8,5,6,66,-154,Severe
11,4,136,M,31,6,9,81,-55,Severe
5,2,62,M,83,11,6,138,76,Well
13,7,163,M,100,13,3,159,-4,Mild
12,2,146,M,78,11,0,132,-14,Severe
9,3,111,M,37,7,3,87,-24,Severe
16,7,199,M,34,7,0,84,-115,Severe
12,0,144,F,32,6,10,82,-62,Severe
5,5,65,F,2,5,3,63,-2,Mild
18,10,226,F,63,9,6,114,-112,Severe
18,2,218,M,97,12,11,155,-63,Severe
12,10,154,M,33,6,11,83,-71,Severe
15,3,183,M,41,7,6,90,-93,Severe
12,11,155,F,16,5,11,71,-84,Severe
13,2,158,M,73,10,6,126,-32,Severe
8,5,101,M,43,7,8,92,-9,Severe
16,10,202,F,15,5,11,71,-131,Severe
7,1,85,F,76,10,10,130,45,Well
15,4,184,M,59,9,1,109,-75,Severe
6,9,81,M,105,13,9,165,84,Well
7,5,89,M,22,6,3,75,-14,Severe
5,10,70,M,11,5,8,68,-2,Mild
10,11,131,F,83,11,6,138,7,Well
10,3,123,M,50,8,3,99,-24,Severe
17,3,207,M,71,10,3,123,-84,Severe
14,3,171,F,46,7,11,95,-76,Severe
18,1,217,M,92,12,5,149,-68,Severe
9,3,111,M,13,5,9,69,-42,Severe
6,4,76,F,13,5,9,69,-7,Severe
10,0,120,M,103,13,6,162,42,Well
10,0,120,F,98,13,0,156,36,Well
11,1,133,M,11,5,8,68,-65,Severe
13,8,164,F,92,12,5,149,-15,Severe
17,6,210,F,44,7,9,93,-117,Severe
6,5,77,F,45,7,10,94,17,Well
6,3,75,F,54,8,7,103,28,Well
16,9,201,M,18,6,1,73,-128,Severe
6,3,75,M,6,5,5,65,-10,Severe
17,3,207,M,62,9,4,112,-95,Severe
16,7,199,F,101,13,4,160,-39,Severe
15,10,190,F,41,7,6,90,-100,Severe
13,11,167,F,16,5,11,71,-96,Severe
14,7,175,F,46,7,11,95,-80,Severe
14,4,172,F,12,5,9,69,-103,Severe
9,1,109,M,3,5,3,63,-46,Severe
6,9,81,F,76,10,10,130,49,Well
10,8,128,F,24,6,5,77,-51,Severe
18,0,216,M,78,11,0,132,-84,Severe
16,11,203,M,69,10,1,121,-82,Severe
17,4,208,M,64,9,7,115,-93,Severe
8,6,102,M,38,7,4,88,-14,Severe
9,6,114,M,40,7,5,89,-25,Severe
8,5,101,M,71,10,3,123,22,Well
8,10,106,F,81,11,4,136,30,Well
7,7,91,F,106,13,10,166,75,Well
6,0,72,M,68,10,0,120,48,Well
5,3,63,M,71,10,3,123,60,Well
7,0,84,M,67,9,10,118,34,Well
15,6,186,M,99,13,1,157,-29,Severe
16,0,192,F,61,9,3,111,-81,Severe
12,3,147,M,108,14,0,168,21,Well
6,1,73,F,71,10,3,123,50,Well
17,3,207,F,67,9,10,118,-89,Severe
15,3,183,M,89,12,1,145,-38,Severe
10,0,120,M,71,10,3,123,3,Good
6,8,80,M,41,7,6,90,10,Well
12,3,147,M,108,14,0,168,21,Well
15,6,186,F,57,8,10,106,-80,Severe
15,5,185,F,73,10,6,126,-59,Severe
17,1,205,M,65,9,8,116,-89,Severe
11,3,135,F,41,7,6,90,-45,Severe
6,11,83,M,60,9,2,110,27,Well
18,11,227,F,39,7,5,89,-138,Severe
17,0,204,M,25,6,5,77,-127,Severe
5,1,61,F,75,10,9,129,68,Well
16,7,199,F,62,9,4,112,-87,Severe
10,10,130,M,60,9,2,110,-20,Severe
7,1,85,F,3,5,3,63,-22,Severe
18,5,221,F,19,6,1,73,-148,Severe
5,1,61,F,2,5,3,63,2,Good
5,5,65,F,21,6,2,74,9,Well
5,4,64,F,22,6,3,75,11,Well
11,0,132,M,25,6,5,77,-55,Severe
11,11,143,M,34,7,0,84,-59,Severe
17,3,207,M,27,6,7,79,-128,Severe
16,9,201,F,39,7,5,89,-112,Severe
5,7,67,M,31,6,9,81,14,Well
10,7,127,M,73,10,6,126,-1,Mild
9,3,111,M,62,9,4,112,1,Good
11,7,139,F,75,10,9,129,-10,Severe
10,0,120,F,35,7,1,85,-35,Severe
9,0,108,F,99,13,1,157,49,Well
11,9,141,M,37,7,3,87,-54,Severe
15,11,191,M,97,12,11,155,-36,Severe
13,9,165,F,71,10,3,123,-42,Severe
13,5,161,F,38,7,4,88,-73,Severe
8,9,105,M,99,13,1,157,52,Well
13,1,157,M,49,8,2,98,-59,Severe
15,5,185,M,27,6,7,79,-106,Severe
8,3,99,M,88,12,0,144,45,Well
5,1,61,M,37,7,3,87,26,Well
14,8,176,M,6,5,5,65,-111,Severe
11,8,140,F,95,12,9,153,13,Well
8,6,102,F,81,11,4,136,34,Well
12,1,145,M,2,5,3,63,-82,Severe
17,3,207,M,62,9,4,112,-95,Severe
10,8,128,F,110,14,3,171,43,Well
15,6,186,M,100,13,3,159,-27,Severe
17,1,205,F,56,8,9,105,-100,Severe
18,9,225,M,14,5,10,70,-155,Severe
14,5,173,M,10,5,7,67,-106,Severe
11,3,135,M,37,7,3,87,-48,Severe
7,10,94,F,86,11,10,142,48,Well
17,2,206,M,46,7,11,95,-111,Severe
6,3,75,M,51,8,4,100,25,Well
12,7,151,F,69,10,1,121,-30,Severe
11,1,133,M,61,9,3,111,-22,Severe
14,11,179,M,73,10,6,126,-53,Severe
5,0,60,M,59,9,1,109,49,Well
14,3,171,F,70,10,2,122,-49,Severe
11,3,135,M,17,6,0,72,-63,Severe
14,7,175,F,83,11,6,138,-37,Severe
11,2,134,F,60,9,2,110,-24,Severe
15,8,188,M,105,13,9,165,-23,Severe
17,4,208,M,71,10,3,123,-85,Severe
10,7,127,F,81,11,4,136,9,Well
6,0,72,M,64,9,7,115,43,Well
16,0,192,F,41,7,6,90,-102,Severe
18,9,225,F,54,8,7,103,-122,Severe
18,1,217,M,110,14,3,171,-46,Severe
6,8,80,M,28,6,8,80,0,Neutral
6,10,82,F,90,12,3,147,65,Well
11,11,143,F,44,7,9,93,-50,Severe
9,3,111,F,19,6,1,73,-38,Severe
5,5,65,M,2,5,3,63,-2,Mild
9,5,113,M,29,6,8,80,-33,Severe
10,6,126,F,53,8,6,102,-24,Severe
10,7,127,M,18,6,1,73,-54,Severe
14,11,179,F,104,13,7,163,-16,Severe
6,1,73,M,91,12,4,148,75,Well
13,9,165,F,95,12,9,153,-12,Severe
9,7,115,M,21,6,2,74,-41,Severe
10,7,127,F,98,13,0,156,29,Well
18,1,217,M,88,12,0,144,-73,Severe
5,5,65,M,73,10,6,126,61,Well
6,8,80,F,101,13,4,160,80,Well
18,0,216,F,90,12,3,147,-69,Severe
7,9,93,M,93,12,6,150,57,Well
5,0,60,M,99,13,1,157,97,Well
9,11,119,M,32,6,10,82,-37,Severe
5,4,64,F,54,8,7,103,39,Well
17,4,208,F,8,5,6,66,-142,Severe
15,6,186,M,70,10,2,122,-64,Severe
6,1,73,M,98,13,0,156,83,Well
18,4,220,M,61,9,3,111,-109,Severe
13,0,156,M,96,12,10,154,-2,Mild
5,5,65,F,30,6,9,81,16,Well
17,11,215,F,89,12,1,145,-70,Severe
10,10,130,F,71,10,3,123,-7,Severe
15,2,182,F,62,9,4,112,-70,Severe
9,4,112,F,53,8,6,102,-10,Severe
10,3,123,F,50,8,3,99,-24,Severe
6,10,82,F,29,6,8,80,-2,Mild
8,6,102,F,102,13,6,162,60,Well
10,2,122,M,66,9,9,117,-5,Mild
12,6,150,M,79,11,1,133,-17,Severe
6,8,80,F,38,7,4,88,8,Well
15,3,183,M,59,9,1,109,-74,Severe
16,6,198,F,68,10,0,120,-78,Severe
15,0,180,F,27,6,7,79,-101,Severe
15,3,183,M,31,6,9,81,-102,Severe
5,7,67,M,7,5,6,66,-1,Mild
9,1,109,M,69,10,1,121,12,Well
15,9,189,F,100,13,3,159,-30,Severe
9,0,108,F,77,10,11,131,23,Well
11,10,142,M,102,13,6,162,20,Well
17,5,209,M,25,6,5,77,-132,Severe
11,1,133,F,46,7,11,95,-38,Severe
15,10,190,M,73,10,6,126,-64,Severe
17,3,207,M,96,12,10,154,-53,Severe
7,6,90,M,100,13,3,159,69,Well
11,7,139,M,83,11,6,138,-1,Mild
5,4,64,M,104,13,7,163,99,Well
5,7,67,M,79,11,1,133,66,Well
18,2,218,F,33,6,11,83,-135,Severe
18,9,225,M,31,6,9,81,-144,Severe
12,6,150,F,91,12,4,148,-2,Mild
11,5,137,M,54,8,7,103,-34,Severe
17,4,208,M,107,13,11,167,-41,Severe
13,10,166,F,53,8,6,102,-64,Severe
6,10,82,F,32,6,10,82,0,Neutral
5,0,60,M,85,11,9,141,81,Well
6,3,75,F,4,5,4,64,-11,Severe
5,1,61,M,80,11,3,135,74,Well
10,5,125,M,96,12,10,154,29,Well
6,3,75,M,91,12,4,148,73,Well
12,1,145,F,73,10,6,126,-19,Severe
17,6,210,F,4,5,4,64,-146,Severe
14,11,179,M,46,7,11,95,-84,Severe
17,11,215,M,53,8,6,102,-113,Severe
9,4,112,F,74,10,7,127,15,Well
11,1,133,F,54,8,7,103,-30,Severe
9,3,111,F,67,9,10,118,7,Well
7,11,95,F,51,8,4,100,5,Good
18,11,227,F,92,12,5,149,-78,Severe
11,11,143,F,56,8,9,105,-38,Severe
5,3,63,M,87,11,11,143,80,Well
15,4,184,F,77,10,11,131,-53,Severe
12,2,146,F,21,6,2,74,-72,Severe
5,0,60,F,110,14,3,171,111,Well
10,1,121,M,102,13,6,162,41,Well
16,3,195,M,91,12,4,148,-47,Severe
8,2,98,F,54,8,7,103,5,Good
9,2,110,F,67,9,10,118,8,Well
18,8,224,F,91,12,4,148,-76,Severe
16,3,195,M,10,5,7,67,-128,Severe
13,11,167,F,14,5,10,70,-97,Severe
12,10,154,M,23,6,4,76,-78,Severe
8,7,103,M,65,9,8,116,13,Well
6,9,81,M,72,10,4,124,43,Well
9,4,112,M,52,8,5,101,-11,Severe
11,5,137,F,94,12,7,151,14,Well
15,2,182,F,41,7,6,90,-92,Severe
6,0,72,F,89,12,1,145,73,Well
6,1,73,F,25,6,5,77,4,Good
8,2,98,F,59,9,1,109,11,Well
8,8,104,M,53,8,6,102,-2,Mild
12,4,148,M,77,10,11,131,-17,Severe
6,8,80,F,105,13,9,165,85,Well
5,3,63,M,37,7,3,87,24,Well
9,2,110,F,89,12,1,145,35,Well
7,4,88,M,93,12,6,150,62,Well
17,11,215,M,25,6,5,77,-138,Severe
15,8,188,F,11,5,8,68,-120,Severe
7,9,93,F,51,8,4,100,7,Well
14,2,170,F,100,13,3,159,-11,Severe
12,8,152,M,12,5,9,69,-83,Severe
10,3,123,F,40,7,5,89,-34,Severe
11,3,135,M,75,10,9,129,-6,Severe
5,4,64,F,32,6,10,82,18,Well
10,4,124,M,77,10,11,131,7,Well
9,1,109,M,82,11,5,137,28,Well
15,1,181,M,64,9,7,115,-66,Severe
11,7,139,F,101,13,4,160,21,Well
10,10,130,M,6,5,5,65,-65,Severe
10,1,121,F,106,13,10,166,45,Well
5,3,63,M,94,12,7,151,88,Well
15,7,187,F,55,8,8,104,-83,Severe
7,2,86,F,78,11,0,132,46,Well
17,2,206,M,23,6,4,76,-130,Severe
9,10,118,F,47,8,0,96,-22,Severe
16,11,203,F,26,6,6,78,-125,Severe
12,6,150,F,60,9,2,110,-40,Severe
12,5,149,M,11,5,8,68,-81,Severe
7,8,92,M,43,7,8,92,0,Neutral
15,5,185,F,63,9,6,114,-71,Severe
12,3,147,F,16,5,11,71,-76,Severe
16,11,203,F,30,6,9,81,-122,Severe
10,4,124,F,84,11,7,139,15,Well
16,8,200,M,50,8,3,99,-101,Severe
10,3,123,F,69,10,1,121,-2,Mild
5,5,65,M,48,8,1,97,32,Well
7,8,92,F,29,6,8,80,-12,Severe
9,7,115,M,83,11,6,138,23,Well
11,8,140,F,103,13,6,162,22,Well
12,9,153,F,62,9,4,112,-41,Severe
6,2,74,M,27,6,7,79,5,Good
18,4,220,M,92,12,5,149,-71,Severe
14,3,171,M,45,7,10,94,-77,Severe
14,2,170,F,80,11,3,135,-35,Severe
18,0,216,F,89,12,1,145,-71,Severe
18,9,225,M,94,12,7,151,-74,Severe
11,8,140,F,28,6,8,80,-60,Severe
11,4,136,M,90,12,3,147,11,Well
10,9,129,M,69,10,1,121,-8,Severe
12,6,150,F,81,11,4,136,-14,Severe
16,11,203,M,71,10,3,123,-80,Severe
13,8,164,F,22,6,3,75,-89,Severe
15,8,188,M,28,6,8,80,-108,Severe
9,2,110,F,58,9,0,108,-2,Mild
13,9,165,F,78,11,0,132,-33,Severe
11,4,136,M,32,6,10,82,-54,Severe
6,6,78,M,43,7,8,92,14,Well
15,3,183,F,35,7,1,85,-98,Severe
5,0,60,M,26,6,6,78,18,Well
16,8,200,F,50,8,3,99,-101,Severe
13,3,159,M,79,11,1,133,-26,Severe
14,8,176,F,91,12,4,148,-28,Severe
15,1,181,F,43,7,8,92,-89,Severe
6,10,82,F,14,5,10,70,-12,Severe
7,3,87,F,23,6,4,76,-11,Severe
8,11,107,M,53,8,6,102,-5,Mild
5,3,63,M,45,7,10,94,31,Well
16,1,193,M,3,5,3,63,-130,Severe
6,1,73,F,85,11,9,141,68,Well
18,10,226,F,42,7,7,91,-135,Severe
9,4,112,F,52,8,5,101,-11,Severe
13,9,165,M,58,9,0,108,-57,Severe
6,11,83,F,24,6,5,77,-6,Severe
17,9,213,M,100,13,3,159,-54,Severe
13,4,160,M,47,8,0,96,-64,Severe
16,7,199,M,7,5,6,66,-133,Severe
5,8,68,F,38,7,4,88,20,Well
14,3,171,F,63,9,6,114,-57,Severe
8,6,102,M,43,7,8,92,-10,Severe
18,6,222,M,3,5,3,63,-159,Severe
18,7,223,F,10,5,7,67,-156,Severe
9,9,117,F,76,10,10,130,13,Well
9,1,109,M,47,8,0,96,-13,Severe
10,0,120,M,72,10,4,124,4,Good
18,3,219,F,89,12,1,145,-74,Severe
15,3,183,F,51,8,4,100,-83,Severe
11,1,133,F,31,6,9,81,-52,Severe
17,7,211,M,5,5,5,65,-146,Severe
14,5,173,F,107,13,11,167,-6,Severe
12,3,147,F,41,7,6,90,-57,Severe
14,2,170,M,34,7,0,84,-86,Severe
12,1,145,M,33,6,11,83,-62,Severe
14,0,168,M,23,6,4,76,-92,Severe
12,5,149,M,32,6,10,82,-67,Severe
12,11,155,M,33,6,11,83,-72,Severe
12,3,147,M,54,8,7,103,-44,Severe
13,11,167,F,59,9,1,109,-58,Severe
15,2,182,M,88,12,0,144,-38,Severe
12,10,154,M,29,6,8,80,-74,Severe
17,11,215,F,39,7,5,89,-126,Severe
17,6,210,F,34,7,0,84,-126,Severe
15,3,183,M,16,5,11,71,-112,Severe
14,7,175,M,20,6,2,74,-101,Severe
13,5,161,F,5,5,5,65,-96,Severe
9,3,111,M,40,7,5,89,-22,Severe
18,2,218,M,56,8,9,105,-113,Severe
16,3,195,F,87,11,11,143,-52,Severe
6,3,75,F,74,10,7,127,52,Well
10,3,123,F,7,5,6,66,-57,Severe
7,0,84,M,108,14,0,168,84,Well
10,8,128,M,7,5,6,66,-62,Severe
17,3,207,M,70,10,2,122,-85,Severe
17,3,207,F,36,7,2,86,-121,Severe
6,1,73,M,32,6,10,82,9,Well
10,10,130,F,59,9,1,109,-21,Severe
16,3,195,F,19,6,1,73,-122,Severe
6,7,79,F,61,9,3,111,32,Well
6,10,82,F,80,11,3,135,53,Well
12,1,145,M,69,10,1,121,-24,Severe
17,1,205,F,57,8,10,106,-99,Severe
15,2,182,F,93,12,6,150,-32,Severe
7,2,86,M,99,13,1,157,71,Well
16,0,192,F,17,6,0,72,-120,Severe
7,5,89,M,92,12,5,149,60,Well
10,10,130,F,104,13,7,163,33,Well
5,10,70,F,43,7,8,92,22,Well
10,8,128,M,5,5,5,65,-63,Severe
8,0,96,M,67,9,10,118,22,Well
8,6,102,F,34,7,0,84,-18,Severe
7,4,88,M,66,9,9,117,29,Well
13,0,156,F,12,5,9,69,-87,Severe
7,8,92,M,81,11,4,136,44,Well
17,4,208,M,41,7,6,90,-118,Severe
9,11,119,M,7,5,6,66,-53,Severe
10,0,120,F,15,5,11,71,-49,Severe
7,6,90,F,92,12,5,149,59,Well
14,3,171,F,14,5,10,70,-101,Severe
10,7,127,M,56,8,9,105,-22,Severe
11,2,134,F,2,5,3,63,-71,Severe
12,3,147,F,76,10,10,130,-17,Severe
15,1,181,F,21,6,2,74,-107,Severe
16,8,200,F,103,13,6,162,-38,Severe
6,3,75,F,86,11,10,142,67,Well
6,9,81,F,88,12,0,144,63,Well
8,11,107,F,79,11,1,133,26,Well
16,9,201,M,33,6,11,83,-118,Severe
9,1,109,M,84,11,7,139,30,Well
16,0,192,F,18,6,1,73,-119,Severe
18,7,223,F,30,6,9,81,-142,Severe
9,9,117,F,4,5,4,64,-53,Severe
15,3,183,M,55,8,8,104,-79,Severe
6,10,82,M,106,13,10,166,84,Well
14,9,177,M,77,10,11,131,-46,Severe
5,3,63,F,55,8,8,104,41,Well
9,9,117,M,56,8,9,105,-12,Severe
17,11,215,F,27,6,7,79,-136,Severe
13,8,164,M,38,7,4,88,-76,Severe
14,0,168,F,96,12,10,154,-14,Severe
5,4,64,F,46,7,11,95,31,Well
7,11,95,M,52,8,5,101,6,Well
17,4,208,M,80,11,3,135,-73,Severe
11,8,140,M,89,12,1,145,5,Good
8,5,101,F,34,7,0,84,-17,Severe
13,1,157,M,84,11,7,139,-18,Severe
12,7,151,F,55,8,8,104,-47,Severe
10,1,121,M,98,13,0,156,35,Well
10,1,121,F,27,6,7,79,-42,Severe
15,0,180,M,58,9,0,108,-72,Severe
11,0,132,F,56,8,9,105,-27,Severe
10,5,125,M,18,6,1,73,-52,Severe
12,8,152,M,41,7,6,90,-62,Severe
9,6,114,F,11,5,8,68,-46,Severe
18,8,224,F,59,9,1,109,-115,Severe
11,6,138,F,62,9,4,112,-26,Severe
7,4,88,F,92,12,5,149,61,Well
6,4,76,F,83,11,6,138,62,Well
5,11,71,F,34,7,0,84,13,Well
18,3,219,F,100,13,3,159,-60,Severe
10,11,131,M,23,6,4,76,-55,Severe
13,4,160,F,54,8,7,103,-57,Severe
9,8,116,F,105,13,9,165,49,Well
14,11,179,M,90,12,3,147,-32,Severe
6,0,72,F,13,5,9,69,-3,Mild
9,9,117,M,34,7,0,84,-33,Severe
17,4,208,F,19,6,1,73,-135,Severe
9,3,111,F,25,6,5,77,-34,Severe
6,1,73,M,67,9,10,118,45,Well
9,3,111,F,62,9,4,112,1,Good
12,1,145,M,25,6,5,77,-68,Severe
17,9,213,M,107,13,11,167,-46,Severe
12,8,152,F,9,5,7,67,-85,Severe
14,10,178,M,87,11,11,143,-35,Severe
17,9,213,M,12,5,9,69,-144,Severe
16,10,202,F,63,9,6,114,-88,Severe
18,4,220,M,40,7,5,89,-131,Severe
5,2,62,F,74,10,7,127,65,Well
11,3,135,M,110,14,3,171,36,Well
6,3,75,F,14,5,10,70,-5,Mild
12,10,154,F,71,10,3,123,-31,Severe
18,3,219,M,91,12,4,148,-71,Severe
18,1,217,M,73,10,6,126,-91,Severe
13,11,167,F,49,8,2,98,-69,Severe
13,3,159,F,27,6,7,79,-80,Severe
5,3,63,M,81,11,4,136,73,Well
13,3,159,M,27,6,7,79,-80,Severe
17,11,215,F,16,5,11,71,-144,Severe
6,5,77,M,5,5,5,65,-12,Severe
8,3,99,M,99,13,1,157,58,Well
15,4,184,F,52,8,5,101,-83,Severe
17,9,213,M,56,8,9,105,-108,Severe
18,11,227,M,7,5,6,66,-161,Severe
15,9,189,M,40,7,5,89,-100,Severe
7,0,84,M,64,9,7,115,31,Well
16,3,195,F,44,7,9,93,-102,Severe
8,6,102,M,33,6,11,83,-19,Severe
13,2,158,M,54,8,7,103,-55,Severe
5,7,67,F,2,5,3,63,-4,Mild
6,0,72,M,27,6,7,79,7,Well
6,6,78,F,98,13,0,156,78,Well
11,11,143,M,75,10,9,129,-14,Severe
8,10,106,M,5,5,5,65,-41,Severe
10,7,127,F,73,10,6,126,-1,Mild
12,6,150,F,102,13,6,162,12,Well
16,7,199,M,109,14,1,169,-30,Severe
6,4,76,F,67,9,10,118,42,Well
6,2,74,M,107,13,11,167,93,Well
7,2,86,M,39,7,5,89,3,Good
18,0,216,M,5,5,5,65,-151,Severe
13,3,159,F,109,14,1,169,10,Well
14,7,175,F,12,5,9,69,-106,Severe
9,11,119,F,8,5,6,66,-53,Severe
7,1,85,F,40,7,5,89,4,Good
13,8,164,M,34,7,0,84,-80,Severe
15,11,191,F,27,6,7,79,-112,Severe
16,6,198,M,32,6,10,82,-116,Severe
10,7,127,F,20,6,2,74,-53,Severe
14,3,171,M,73,10,6,126,-45,Severe
18,2,218,M,54,8,7,103,-115,Severe
6,5,77,F,11,5,8,68,-9,Severe
11,5,137,F,27,6,7,79,-58,Severe
18,8,224,M,62,9,4,112,-112,Severe
16,5,197,F,7,5,6,66,-131,Severe
12,3,147,M,42,7,7,91,-56,Severe
13,0,156,M,36,7,2,86,-70,Severe
15,3,183,F,79,11,1,133,-50,Severe
18,10,226,F,91,12,4,148,-78,Severe
12,11,155,F,6,5,5,65,-90,Severe
6,4,76,F,70,10,2,122,46,Well
8,3,99,M,102,13,6,162,63,Well
12,9,153,F,14,5,10,70,-83,Severe
9,1,109,F,53,8,6,102,-7,Severe
13,11,167,M,12,5,9,69,-98,Severe
8,0,96,M,23,6,4,76,-20,Severe
18,10,226,F,29,6,8,80,-146,Severe
9,1,109,M,97,12,11,155,46,Well
14,4,172,M,72,10,4,124,-48,Severe
10,9,129,F,91,12,4,148,19,Well
6,3,75,F,88,12,0,144,69,Well
6,3,75,F,36,7,2,86,11,Well
12,8,152,M,78,11,0,132,-20,Severe
14,8,176,F,53,8,6,102,-74,Severe
7,1,85,F,33,6,11,83,-2,Mild
9,1,109,M,5,5,5,65,-44,Severe
9,0,108,M,99,13,1,157,49,Well
16,5,197,M,3,5,3,63,-134,Severe
5,3,63,F,39,7,5,89,26,Well
7,11,95,M,104,13,7,163,68,Well
6,0,72,M,88,12,0,144,72,Well
14,10,178,M,47,8,0,96,-82,Severe
18,1,217,F,109,14,1,169,-48,Severe
11,5,137,M,50,8,3,99,-38,Severe
17,1,205,M,10,5,7,67,-138,Severe
6,1,73,M,19,6,1,73,0,Neutral
15,3,183,F,98,13,0,156,-27,Severe
15,10,190,F,35,7,1,85,-105,Severe
8,3,99,M,42,7,7,91,-8,Severe
16,6,198,F,82,11,5,137,-61,Severe
7,7,91,M,59,9,1,109,18,Well
15,8,188,F,94,12,7,151,-37,Severe
16,0,192,F,30,6,9,81,-111,Severe
10,3,123,M,37,7,3,87,-36,Severe
11,11,143,F,49,8,2,98,-45,Severe
14,1,169,M,70,10,2,122,-47,Severe
17,3,207,M,4,5,4,64,-143,Severe
15,7,187,F,107,13,11,167,-20,Severe
7,7,91,M,76,10,10,130,39,Well
10,6,126,F,75,10,9,129,3,Good
14,5,173,M,64,9,7,115,-58,Severe
14,1,169,M,49,8,2,98,-71,Severe
7,3,87,M,39,7,5,89,2,Good
16,4,196,M,18,6,1,73,-123,Severe
12,1,145,F,106,13,10,166,21,Well
17,5,209,F,107,13,11,167,-42,Severe
5,8,68,F,86,11,10,142,74,Well
5,10,70,M,50,8,3,99,29,Well
10,6,126,M,5,5,5,65,-61,Severe
18,6,222,M,20,6,2,74,-148,Severe
16,10,202,F,37,7,3,87,-115,Severe
6,8,80,F,56,8,9,105,25,Well
14,1,169,F,66,9,9,117,-52,Severe
17,7,211,F,96,12,10,154,-57,Severe
18,0,216,M,54,8,7,103,-113,Severe
13,10,166,F,76,10,10,130,-36,Severe
5,3,63,F,59,9,1,109,46,Well
18,7,223,M,14,5,10,70,-153,Severe
9,3,111,F,84,11,7,139,28,Well
18,11,227,F,89,12,1,145,-82,Severe
8,6,102,M,92,12,5,149,47,Well
6,10,82,M,81,11,4,136,54,Well
6,8,80,F,51,8,4,100,20,Well
16,0,192,M,3,5,3,63,-129,Severe
18,3,219,M,2,5,3,63,-156,Severe
9,1,109,M,12,5,9,69,-40,Severe
9,3,111,F,102,13,6,162,51,Well
6,5,77,M,6,5,5,65,-12,Severe
7,5,89,M,86,11,10,142,53,Well
8,9,105,F,94,12,7,151,46,Well
7,7,91,F,12,5,9,69,-22,Severe
6,8,80,M,87,11,11,143,63,Well
6,3,75,F,85,11,9,141,66,Well
11,8,140,M,65,9,8,116,-24,Severe
10,3,123,M,108,14,0,168,45,Well
6,8,80,F,23,6,4,76,-4,Mild
10,3,123,F,8,5,6,66,-57,Severe
9,10,118,F,99,13,1,157,39,Well
12,6,150,M,16,5,11,71,-79,Severe
5,7,67,F,98,13,0,156,89,Well
10,3,123,F,94,12,7,151,28,Well
7,3,87,F,20,6,2,74,-13,Severe
7,2,86,M,103,13,6,162,76,Well
15,4,184,F,105,13,9,165,-19,Severe
9,6,114,M,15,5,11,71,-43,Severe
13,7,163,M,20,6,2,74,-89,Severe
12,0,144,F,78,11,0,132,-12,Severe
17,1,205,M,34,7,0,84,-121,Severe
17,2,206,M,61,9,3,111,-95,Severe
10,7,127,F,29,6,8,80,-47,Severe
17,11,215,M,15,5,11,71,-144,Severe
10,6,126,M,104,13,7,163,37,Well
13,7,163,F,55,8,8,104,-59,Severe
6,4,76,M,42,7,7,91,15,Well
9,2,110,F,37,7,3,87,-23,Severe
6,6,78,M,94,12,7,151,73,Well
8,2,98,M,75,10,9,129,31,Well
7,3,87,M,103,13,6,162,75,Well
15,0,180,M,88,12,0,144,-36,Severe
8,2,98,M,89,12,1,145,47,Well
16,7,199,M,26,6,6,78,-121,Severe
18,8,224,M,75,10,9,129,-95,Severe
13,5,161,F,33,6,11,83,-78,Severe
6,10,82,M,79,11,1,133,51,Well
9,6,114,M,105,13,9,165,51,Well
11,9,141,M,99,13,1,157,16,Well
17,3,207,M,5,5,5,65,-142,Severe
13,3,159,M,79,11,1,133,-26,Severe
16,8,200,M,61,9,3,111,-89,Severe
7,1,85,F,13,5,9,69,-16,Severe
11,7,139,M,90,12,3,147,8,Well
18,3,219,F,18,6,1,73,-146,Severe
13,4,160,M,30,6,9,81,-79,Severe
8,11,107,F,90,12,3,147,40,Well
15,10,190,M,90,12,3,147,-43,Severe
12,8,152,F,72,10,4,124,-28,Severe
16,0,192,M,15,5,11,71,-121,Severe
11,2,134,M,85,11,9,141,7,Well
13,1,157,F,104,13,7,163,6,Well
15,11,191,M,60,9,2,110,-81,Severe
10,10,130,M,97,12,11,155,25,Well
18,5,221,F,81,11,4,136,-85,Severe
13,5,161,F,89,12,1,145,-16,Severe
14,10,178,F,68,10,0,120,-58,Severe
9,3,111,F,37,7,3,87,-24,Severe
12,11,155,F,94,12,7,151,-4,Mild
8,10,106,F,79,11,1,133,27,Well
5,10,70,F,100,13,3,159,89,Well
10,2,122,F,17,6,0,72,-50,Severe
18,10,226,M,56,8,9,105,-121,Severe
10,1,121,M,105,13,9,165,44,Well
8,3,99,M,57,8,10,106,7,Well
7,2,86,F,28,6,8,80,-6,Severe
8,3,99,F,81,11,4,136,37,Well
13,9,165,F,62,9,4,112,-53,Severe
11,1,133,M,81,11,4,136,3,Good
16,3,195,F,47,8,0,96,-99,Severe
12,2,146,M,4,5,4,64,-82,Severe
5,2,62,M,15,5,11,71,9,Well
7,6,90,M,77,10,11,131,41,Well
12,0,144,F,27,6,7,79,-65,Severe
8,11,107,F,98,13,0,156,49,Well
11,8,140,F,12,5,9,69,-71,Severe
6,4,76,F,74,10,7,127,51,Well
16,11,203,M,100,13,3,159,-44,Severe
7,11,95,M,4,5,4,64,-31,Severe
15,3,183,F,103,13,6,162,-21,Severe
12,4,148,M,106,13,10,166,18,Well
14,6,174,F,57,8,10,106,-68,Severe
15,11,191,F,77,10,11,131,-60,Severe
13,3,159,M,82,11,5,137,-22,Severe
9,4,112,M,20,6,2,74,-38,Severe
8,9,105,F,82,11,5,137,32,Well
5,3,63,M,76,10,10,130,67,Well
10,2,122,F,109,14,1,169,47,Well
16,1,193,M,82,11,5,137,-56,Severe
18,7,223,F,81,11,4,136,-87,Severe
13,6,162,F,8,5,6,66,-96,Severe
5,3,63,M,26,6,6,78,15,Well
8,4,100,M,8,5,6,66,-34,Severe
6,10,82,M,11,5,8,68,-14,Severe
12,5,149,M,83,11,6,138,-11,Severe
16,5,197,M,81,11,4,136,-61,Severe
9,7,115,F,67,9,10,118,3,Good
15,9,189,M,37,7,3,87,-102,Severe
15,9,189,F,96,12,10,154,-35,Severe
8,11,107,M,46,7,11,95,-12,Severe
16,10,202,M,39,7,5,89,-113,Severe
15,6,186,F,23,6,4,76,-110,Severe
18,5,221,F,68,10,0,120,-101,Severe
10,4,124,F,18,6,1,73,-51,Severe
12,9,153,M,53,8,6,102,-51,Severe
9,4,112,M,43,7,8,92,-20,Severe
10,7,127,M,5,5,5,65,-62,Severe
17,1,205,M,11,5,8,68,-137,Severe
18,6,222,F,44,7,9,93,-129,Severe
12,8,152,F,23,6,4,76,-76,Severe
8,1,97,F,73,10,6,126,29,Well
9,0,108,F,32,6,10,82,-26,Severe
5,6,66,M,55,8,8,104,38,Well
18,5,221,M,12,5,9,69,-152,Severe
8,0,96,M,13,5,9,69,-27,Severe
18,11,227,F,52,8,5,101,-126,Severe
7,2,86,M,40,7,5,89,3,Good
16,8,200,M,3,5,3,63,-137,Severe
15,2,182,M,38,7,4,88,-94,Severe
15,8,188,F,75,10,9,129,-59,Severe
15,9,189,F,64,9,7,115,-74,Severe
16,0,192,M,75,10,9,129,-63,Severe
12,5,149,M,107,13,11,167,18,Well
15,8,188,F,72,10,4,124,-64,Severe
18,2,218,M,89,12,1,145,-73,Severe
10,9,129,F,74,10,7,127,-2,Mild
13,5,161,F,50,8,3,99,-62,Severe
17,8,212,M,62,9,4,112,-100,Severe
10,10,130,F,65,9,8,116,-14,Severe
5,2,62,M,25,6,5,77,15,Well
13,3,159,F,66,9,9,117,-42,Severe
7,1,85,F,8,5,6,66,-19,Severe
6,3,75,M,27,6,7,79,4,Good
15,0,180,F,106,13,10,166,-14,Severe
14,6,174,M,94,12,7,151,-23,Severe
12,8,152,F,15,5,11,71,-81,Severe
6,11,83,F,23,6,4,76,-7,Severe
9,8,116,F,75,10,9,129,13,Well
7,0,84,M,101,13,4,160,76,Well
11,9,141,F,63,9,6,114,-27,Severe
17,4,208,F,27,6,7,79,-129,Severe
8,10,106,F,41,7,6,90,-16,Severe
17,10,214,M,34,7,0,84,-130,Severe
17,6,210,F,10,5,7,67,-143,Severe
8,1,97,F,56,8,9,105,8,Well
11,6,138,F,67,9,10,118,-20,Severe
9,10,118,M,87,11,11,143,25,Well
12,6,150,M,86,11,10,142,-8,Severe
9,11,119,M,20,6,2,74,-45,Severe
9,8,116,F,85,11,9,141,25,Well
9,5,113,F,57,8,10,106,-7,Severe
14,5,173,M,66,9,9,117,-56,Severe
15,9,189,F,22,6,3,75,-114,Severe
10,0,120,M,62,9,4,112,-8,Severe
9,4,112,F,65,9,8,116,4,Good
12,10,154,F,88,12,0,144,-10,Severe
12,1,145,M,78,11,0,132,-13,Severe
8,2,98,M,107,13,11,167,69,Well
13,5,161,F,35,7,1,85,-76,Severe
15,0,180,F,48,8,1,97,-83,Severe
7,6,90,M,107,13,11,167,77,Well
15,6,186,F,96,12,10,154,-32,Severe
17,3,207,M,2,5,3,63,-144,Severe
13,10,166,F,28,6,8,80,-86,Severe
13,9,165,M,96,12,10,154,-11,Severe
7,10,94,F,11,5,8,68,-26,Severe
6,11,83,F,62,9,4,112,29,Well
16,4,196,F,92,12,5,149,-47,Severe
5,0,60,F,17,6,0,72,12,Well
17,3,207,F,91,12,4,148,-59,Severe
5,2,62,M,27,6,7,79,17,Well
10,4,124,M,54,8,7,103,-21,Severe
17,5,209,F,87,11,11,143,-66,Severe
9,8,116,F,97,12,11,155,39,Well
16,2,194,F,29,6,8,80,-114,Severe
14,10,178,M,106,13,10,166,-12,Severe
9,1,109,F,13,5,9,69,-40,Severe
11,0,132,M,49,8,2,98,-34,Severe
6,10,82,F,72,10,4,124,42,Well
11,4,136,F,74,10,7,127,-9,Severe
6,2,74,M,26,6,6,78,4,Good
10,8,128,F,33,6,11,83,-45,Severe
8,6,102,F,2,5,3,63,-39,Severe
16,9,201,F,96,12,10,154,-47,Severe
10,3,123,F,2,5,3,63,-60,Severe
7,3,87,M,105,13,9,165,78,Well
16,2,194,F,39,7,5,89,-105,Severe
14,4,172,F,65,9,8,116,-56,Severe
10,3,123,M,39,7,5,89,-34,Severe
13,2,158,F,20,6,2,74,-84,Severe
6,4,76,F,7,5,6,66,-10,Severe
5,8,68,F,82,11,5,137,69,Well
13,0,156,F,77,10,11,131,-25,Severe
6,3,75,F,68,10,0,120,45,Well
17,10,214,M,43,7,8,92,-122,Severe
17,3,207,F,108,14,0,168,-39,Severe
18,5,221,M,93,12,6,150,-71,Severe
8,4,100,M,109,14,1,169,69,Well
15,3,183,M,76,10,10,130,-53,Severe
7,3,87,F,85,11,9,141,54,Well
16,3,195,F,29,6,8,80,-115,Severe
12,0,144,M,17,6,0,72,-72,Severe
11,10,142,M,78,11,0,132,-10,Severe
6,5,77,M,17,6,0,72,-5,Mild
6,2,74,M,97,12,11,155,81,Well
5,4,64,F,41,7,6,90,26,Well
8,1,97,F,27,6,7,79,-18,Severe
8,9,105,M,73,10,6,126,21,Well
14,4,172,F,82,11,5,137,-35,Severe
15,5,185,F,25,6,5,77,-108,Severe
8,9,105,F,77,10,11,131,26,Well
6,7,79,M,55,8,8,104,25,Well
13,0,156,M,41,7,6,90,-66,Severe
16,6,198,M,34,7,0,84,-114,Severe
14,0,168,M,94,12,7,151,-17,Severe
7,4,88,M,50,8,3,99,11,Well
11,4,136,F,8,5,6,66,-70,Severe
17,8,212,F,56,8,9,105,-107,Severe
14,2,170,M,13,5,9,69,-101,Severe
10,6,126,M,3,5,3,63,-63,Severe
18,7,223,M,47,8,0,96,-127,Severe
7,0,84,F,107,13,11,167,83,Well
17,8,212,F,47,8,0,96,-116,Severe
10,0,120,M,60,9,2,110,-10,Severe
14,7,175,M,73,10,6,126,-49,Severe
8,3,99,M,103,13,6,162,63,Well
8,7,103,M,81,11,4,136,33,Well
12,6,150,M,102,13,6,162,12,Well
15,5,185,M,55,8,8,104,-81,Severe
14,8,176,M,109,14,1,169,-7,Severe
16,5,197,M,79,11,1,133,-64,Severe
11,3,135,M,90,12,3,147,12,Well
13,9,165,M,94,12,7,151,-14,Severe
5,4,64,M,58,9,0,108,44,Well
16,3,195,M,25,6,5,77,-118,Severe
5,3,63,F,81,11,4,136,73,Well
17,11,215,F,102,13,6,162,-53,Severe
11,0,132,F,85,11,9,141,9,Well
15,6,186,F,36,7,2,86,-100,Severe
6,4,76,M,67,9,10,118,42,Well
12,11,155,M,4,5,4,64,-91,Severe
6,7,79,F,18,6,1,73,-6,Severe
12,8,152,M,56,8,9,105,-47,Severe
11,6,138,M,82,11,5,137,-1,Mild
17,7,211,F,107,13,11,167,-44,Severe
17,11,215,M,35,7,1,85,-130,Severe
17,1,205,M,31,6,9,81,-124,Severe
13,7,163,M,38,7,4,88,-75,Severe
13,1,157,F,87,11,11,143,-14,Severe
7,7,91,M,95,12,9,153,62,Well
7,7,91,F,103,13,6,162,71,Well
6,11,83,M,33,6,11,83,0,Neutral
15,4,184,F,94,12,7,151,-33,Severe
16,6,198,M,40,7,5,89,-109,Severe
15,2,182,F,109,14,1,169,-13,Severe
12,6,150,M,10,5,7,67,-83,Severe
10,8,128,F,48,8,1,97,-31,Severe
15,7,187,M,52,8,5,101,-86,Severe
12,5,149,M,45,7,10,94,-55,Severe
12,1,145,F,45,7,10,94,-51,Severe
10,11,131,F,46,7,11,95,-36,Severe
6,8,80,F,77,10,11,131,51,Well
9,3,111,M,30,6,9,81,-30,Severe
13,1,157,M,45,7,10,94,-63,Severe
15,11,191,M,99,13,1,157,-34,Severe
16,9,201,M,101,13,4,160,-41,Severe
10,1,121,F,4,5,4,64,-57,Severe
9,5,113,F,70,10,2,122,9,Well
9,3,111,M,52,8,5,101,-10,Severe
9,5,113,M,82,11,5,137,24,Well
6,2,74,F,12,5,9,69,-5,Mild
17,7,211,F,44,7,9,93,-118,Severe
16,10,202,F,87,11,11,143,-59,Severe
12,6,150,F,22,6,3,75,-75,Severe
5,9,69,M,102,13,6,162,93,Well
5,9,69,F,46,7,11,95,26,Well
6,7,79,F,90,12,3,147,68,Well
13,6,162,M,55,8,8,104,-58,Severe
8,8,104,F,10,5,7,67,-37,Severe
9,8,116,F,71,10,3,123,7,Well
12,3,147,M,12,5,9,69,-78,Severe
14,3,171,F,68,10,0,120,-51,Severe
7,1,85,M,95,12,9,153,68,Well
5,8,68,F,88,12,0,144,76,Well
14,1,169,F,42,7,7,91,-78,Severe
5,1,61,F,33,6,11,83,22,Well
16,4,196,M,95,12,9,153,-43,Severe
9,2,110,M,29,6,8,80,-30,Severe
16,6,198,F,110,14,3,171,-27,Severe
7,1,85,F,54,8,7,103,18,Well
12,6,150,F,7,5,6,66,-84,Severe
10,10,130,M,13,5,9,69,-61,Severe
11,8,140,F,89,12,1,145,5,Good
12,9,153,F,70,10,2,122,-31,Severe
12,6,150,M,96,12,10,154,4,Good
11,3,135,F,30,6,9,81,-54,Severe
12,0,144,F,38,7,4,88,-56,Severe
8,0,96,F,69,10,1,121,25,Well
15,11,191,M,106,13,10,166,-25,Severe
18,4,220,M,32,6,10,82,-138,Severe
5,0,60,F,11,5,8,68,8,Well
18,5,221,F,24,6,5,77,-144,Severe
5,7,67,F,42,7,7,91,24,Well
13,5,161,M,91,12,4,148,-13,Severe
16,2,194,M,93,12,6,150,-44,Severe
11,11,143,M,59,9,1,109,-34,Severe
5,3,63,F,17,6,0,72,9,Well
13,6,162,M,42,7,7,91,-71,Severe
18,9,225,M,3,5,3,63,-162,Severe
12,7,151,M,81,11,4,136,-15,Severe
16,4,196,F,90,12,3,147,-49,Severe
11,1,133,M,54,8,7,103,-30,Severe
15,4,184,M,72,10,4,124,-60,Severe
5,11,71,F,55,8,8,104,33,Well
11,3,135,M,19,6,1,73,-62,Severe
18,1,217,F,36,7,2,86,-131,Severe
5,3,63,M,77,10,11,131,68,Well
10,5,125,M,45,7,10,94,-31,Severe
5,10,70,M,99,13,1,157,87,Well
16,7,199,M,8,5,6,66,-133,Severe
11,4,136,M,78,11,0,132,-4,Mild
11,5,137,F,41,7,6,90,-47,Severe
16,0,192,F,55,8,8,104,-88,Severe
12,10,154,M,19,6,1,73,-81,Severe
11,3,135,F,50,8,3,99,-36,Severe
15,2,182,M,77,10,11,131,-51,Severe
14,1,169,M,74,10,7,127,-42,Severe
11,8,140,M,46,7,11,95,-45,Severe
15,11,191,M,31,6,9,81,-110,Severe
11,1,133,M,3,5,3,63,-70,Severe
12,6,150,F,48,8,1,97,-53,Severe
14,3,171,F,32,6,10,82,-89,Severe
14,11,179,M,6,5,5,65,-114,Severe
10,10,130,M,41,7,6,90,-40,Severe
6,3,75,F,76,10,10,130,55,Well
10,1,121,F,66,9,9,117,-4,Mild
15,8,188,F,31,6,9,81,-107,Severe
14,7,175,F,49,8,2,98,-77,Severe
9,4,112,M,15,5,11,71,-41,Severe
8,5,101,M,7,5,6,66,-35,Severe
15,5,185,F,99,13,1,157,-28,Severe
10,4,124,M,53,8,6,102,-22,Severe
10,0,120,F,11,5,8,68,-52,Severe
7,2,86,F,24,6,5,77,-9,Severe
5,4,64,M,97,12,11,155,91,Well
6,11,83,F,102,13,6,162,79,Well
13,5,161,F,84,11,7,139,-22,Severe
13,8,164,M,44,7,9,93,-71,Severe
8,0,96,M,106,13,10,166,70,Well
6,4,76,F,96,12,10,154,78,Well
15,4,184,F,21,6,2,74,-110,Severe
8,8,104,M,107,13,11,167,63,Well
13,2,158,M,67,9,10,118,-40,Severe
13,9,165,F,72,10,4,124,-41,Severe
16,6,198,M,74,10,7,127,-71,Severe
17,9,213,M,106,13,10,166,-47,Severe
10,0,120,F,36,7,2,86,-34,Severe
14,9,177,M,16,5,11,71,-106,Severe
7,3,87,M,27,6,7,79,-8,Severe
7,1,85,M,57,8,10,106,21,Well
11,9,141,M,28,6,8,80,-61,Severe
5,0,60,M,13,5,9,69,9,Well
8,11,107,F,67,9,10,118,11,Well
13,1,157,M,79,11,1,133,-24,Severe
10,6,126,M,76,10,10,130,4,Good
9,6,114,F,103,13,6,162,48,Well
13,9,165,M,80,11,3,135,-30,Severe
9,5,113,F,82,11,5,137,24,Well
9,8,116,M,54,8,7,103,-13,Severe
16,11,203,F,61,9,3,111,-92,Severe
17,7,211,F,33,6,11,83,-128,Severe
6,6,78,F,81,11,4,136,58,Well
18,6,222,M,101,13,4,160,-62,Severe
12,2,146,F,71,10,3,123,-23,Severe
7,5,89,M,15,5,11,71,-18,Severe
11,11,143,F,11,5,8,68,-75,Severe
17,5,209,F,28,6,8,80,-129,Severe
15,9,189,M,74,10,7,127,-62,Severe
15,5,185,F,8,5,6,66,-119,Severe
8,5,101,M,55,8,8,104,3,Good
8,4,100,F,93,12,6,150,50,Well
13,2,158,F,34,7,0,84,-74,Severe
17,5,209,M,54,8,7,103,-106,Severe
11,3,135,M,61,9,3,111,-24,Severe
5,3,63,F,52,8,5,101,38,Well
17,1,205,M,98,13,0,156,-49,Severe
8,3,99,M,46,7,11,95,-4,Mild
12,1,145,M,46,7,11,95,-50,Severe
17,10,214,M,87,11,11,143,-71,Severe
13,7,163,F,62,9,4,112,-51,Severe
5,1,61,F,32,6,10,82,21,Well
10,0,120,M,107,13,11,167,47,Well
14,2,170,M,4,5,4,64,-106,Severe
13,2,158,M,62,9,4,112,-46,Severe
13,0,156,F,67,9,10,118,-38,Severe
7,8,92,F,85,11,9,141,49,Well
9,5,113,M,47,8,0,96,-17,Severe
14,2,170,M,36,7,2,86,-84,Severe
12,8,152,F,87,11,11,143,-9,Severe
18,6,222,M,11,5,8,68,-154,Severe
13,7,163,M,101,13,4,160,-3,Mild
10,7,127,M,79,11,1,133,6,Well
14,3,171,F,23,6,4,76,-95,Severe
16,3,195,M,16,5,11,71,-124,Severe
15,3,183,F,22,6,3,75,-108,Severe
11,3,135,F,36,7,2,86,-49,Severe
15,3,183,F,42,7,7,91,-92,Severe
9,5,113,F,40,7,5,89,-24,Severe
12,3,147,F,54,8,7,103,-44,Severe
7,4,88,M,26,6,6,78,-10,Severe
13,11,167,M,24,6,5,77,-90,Severe
9,4,112,M,106,13,10,166,54,Well
10,11,131,M,34,7,0,84,-47,Severe
5,3,63,M,52,8,5,101,38,Well
12,9,153,F,9,5,7,67,-86,Severe
10,10,130,F,30,6,9,81,-49,Severe
16,5,197,F,89,12,1,145,-52,Severe
17,1,205,M,104,13,7,163,-42,Severe
16,3,195,F,101,13,4,160,-35,Severe
8,2,98,M,106,13,10,166,68,Well
15,11,191,F,65,9,8,116,-75,Severe
14,8,176,F,17,6,0,72,-104,Severe
10,6,126,F,47,8,0,96,-30,Severe
14,4,172,F,68,10,0,120,-52,Severe
11,6,138,M,11,5,8,68,-70,Severe
17,8,212,F,50,8,3,99,-113,Severe
7,11,95,M,62,9,4,112,17,Well
12,4,148,F,27,6,7,79,-69,Severe
5,6,66,M,76,10,10,130,64,Well
13,9,165,F,93,12,6,150,-15,Severe
14,7,175,M,77,10,11,131,-44,Severe
9,1,109,F,49,8,2,98,-11,Severe
10,11,131,M,62,9,4,112,-19,Severe
16,1,193,F,57,8,10,106,-87,Severe
10,7,127,F,97,12,11,155,28,Well
17,3,207,M,94,12,7,151,-56,Severe
12,1,145,M,4,5,4,64,-81,Severe
15,2,182,M,36,7,2,86,-96,Severe
12,11,155,F,11,5,8,68,-87,Severe
8,0,96,F,67,9,10,118,22,Well
8,8,104,M,43,7,8,92,-12,Severe
8,5,101,M,36,7,2,86,-15,Severe
6,11,83,F,43,7,8,92,9,Well
14,6,174,F,86,11,10,142,-32,Severe
12,3,147,F,99,13,1,157,10,Well
17,2,206,M,68,10,0,120,-86,Severe
18,9,225,F,86,11,10,142,-83,Severe
7,7,91,F,58,9,0,108,17,Well
11,6,138,F,81,11,4,136,-2,Mild
18,7,223,F,31,6,9,81,-142,Severe
9,4,112,M,100,13,3,159,47,Well
9,3,111,F,58,9,0,108,-3,Mild
12,4,148,M,110,14,3,171,23,Well
14,3,171,F,17,6,0,72,-99,Severe
17,8,212,F,53,8,6,102,-110,Severe
9,5,113,M,83,11,6,138,25,Well
5,11,71,M,87,11,11,143,72,Well
5,11,71,F,77,10,11,131,60,Well
6,2,74,M,77,10,11,131,57,Well
6,3,75,F,4,5,4,64,-11,Severe
18,2,218,M,11,5,8,68,-150,Severe
7,2,86,M,29,6,8,80,-6,Severe
9,2,110,F,31,6,9,81,-29,Severe
8,0,96,F,46,7,11,95,-1,Mild
7,3,87,F,35,7,1,85,-2,Mild
13,10,166,M,19,6,1,73,-93,Severe
7,3,87,F,15,5,11,71,-16,Severe
13,11,167,F,72,10,4,124,-43,Severe
14,10,178,M,37,7,3,87,-91,Severe
16,6,198,M,28,6,8,80,-118,Severe
14,1,169,M,7,5,6,66,-103,Severe
16,0,192,M,110,14,3,171,-21,Severe
9,3,111,M,106,13,10,166,55,Well
13,7,163,F,92,12,5,149,-14,Severe
7,3,87,F,100,13,3,159,72,Well
11,1,133,M,94,12,7,151,18,Well
17,1,205,F,109,14,1,169,-36,Severe
15,8,188,M,85,11,9,141,-47,Severe
10,9,129,M,47,8,0,96,-33,Severe
9,11,119,F,102,13,6,162,43,Well
14,3,171,M,110,14,3,171,0,Neutral
18,4,220,M,106,13,10,166,-54,Severe
16,4,196,M,81,11,4,136,-60,Severe
18,4,220,F,72,10,4,124,-96,Severe
15,11,191,M,55,8,8,104,-87,Severe
15,10,190,F,95,12,9,153,-37,Severe
18,5,221,F,42,7,7,91,-130,Severe
6,11,83,M,31,6,9,81,-2,Mild
11,0,132,M,86,11,10,142,10,Well
6,11,83,M,27,6,7,79,-4,Mild
14,3,171,F,26,6,6,78,-93,Severe
8,7,103,M,46,7,11,95,-8,Severe
5,6,66,M,54,8,7,103,37,Well
8,6,102,F,11,5,8,68,-34,Severe
16,3,195,F,32,6,10,82,-113,Severe
7,0,84,M,28,6,8,80,-4,Mild
9,8,116,F,9,5,7,67,-49,Severe
14,11,179,F,102,13,6,162,-17,Severe
14,2,170,F,51,8,4,100,-70,Severe
7,10,94,F,54,8,7,103,9,Well
16,10,202,M,50,8,3,99,-103,Severe
11,10,142,M,25,6,5,77,-65,Severe
7,3,87,M,67,9,10,118,31,Well
9,2,110,F,70,10,2,122,12,Well
16,11,203,F,11,5,8,68,-135,Severe
13,8,164,F,87,11,11,143,-21,Severe
7,7,91,M,94,12,7,151,60,Well
5,5,65,F,55,8,8,104,39,Well
17,7,211,M,22,6,3,75,-136,Severe
8,5,101,F,109,14,1,169,68,Well
9,6,114,F,73,10,6,126,12,Well
8,8,104,M,12,5,9,69,-35,Severe
12,1,145,F,110,14,3,171,26,Well
6,7,79,F,110,14,3,171,92,Well
7,3,87,M,63,9,6,114,27,Well
16,3,195,F,79,11,1,133,-62,Severe
13,10,166,M,3,5,3,63,-103,Severe
13,1,157,F,107,13,11,167,10,Well
18,10,226,F,44,7,9,93,-133,Severe
6,2,74,F,100,13,3,159,85,Well
8,5,101,M,104,13,7,163,62,Well
8,9,105,M,82,11,5,137,32,Well
5,3,63,F,47,8,0,96,33,Well
7,9,93,M,108,14,0,168,75,Well
13,3,159,M,51,8,4,100,-59,Severe
11,8,140,F,27,6,7,79,-61,Severe
14,7,175,F,77,10,11,131,-44,Severe
12,11,155,F,24,6,5,77,-78,Severe
10,0,120,F,27,6,7,79,-41,Severe
6,0,72,M,13,5,9,69,-3,Mild
8,4,100,M,82,11,5,137,37,Well
10,3,123,F,26,6,6,78,-45,Severe
15,2,182,F,72,10,4,124,-58,Severe
5,8,68,M,90,12,3,147,79,Well
15,10,190,M,40,7,5,89,-101,Severe
6,5,77,F,20,6,2,74,-3,Mild
13,7,163,M,73,10,6,126,-37,Severe
12,0,144,F,10,5,7,67,-77,Severe
14,4,172,F,18,6,1,73,-99,Severe
14,10,178,F,20,6,2,74,-104,Severe
7,8,92,M,96,12,10,154,62,Well
10,11,131,M,66,9,9,117,-14,Severe
8,5,101,F,24,6,5,77,-24,Severe
13,3,159,M,41,7,6,90,-69,Severe
9,2,110,M,3,5,3,63,-47,Severe
10,4,124,M,108,14,0,168,44,Well
9,4,112,M,13,5,9,69,-43,Severe
16,10,202,M,7,5,6,66,-136,Severe
13,11,167,F,39,7,5,89,-78,Severe
5,7,67,M,30,6,9,81,14,Well
9,8,116,M,101,13,4,160,44,Well
9,10,118,F,87,11,11,143,25,Well
11,3,135,F,75,10,9,129,-6,Severe
8,10,106,F,88,12,0,144,38,Well
17,7,211,F,23,6,4,76,-135,Severe
13,9,165,F,102,13,6,162,-3,Mild
5,8,68,M,27,6,7,79,11,Well
18,5,221,M,55,8,8,104,-117,Severe
10,5,125,M,95,12,9,153,28,Well
14,6,174,M,95,12,9,153,-21,Severe
9,9,117,F,98,13,0,156,39,Well
16,11,203,F,93,12,6,150,-53,Severe
14,8,176,F,32,6,10,82,-94,Severe
16,10,202,F,108,14,0,168,-34,Severe
7,10,94,M,27,6,7,79,-15,Severe
7,7,91,M,46,7,11,95,4,Good
13,10,166,F,35,7,1,85,-81,Severe
15,11,191,F,30,6,9,81,-110,Severe
12,9,153,F,11,5,8,68,-85,Severe
12,7,151,F,74,10,7,127,-24,Severe
17,10,214,M,80,11,3,135,-79,Severe
8,10,106,M,14,5,10,70,-36,Severe
5,5,65,F,57,8,10,106,41,Well
15,2,182,M,61,9,3,111,-71,Severe
11,2,134,F,82,11,5,137,3,Good
5,11,71,F,16,5,11,71,0,Neutral
12,1,145,M,99,13,1,157,12,Well
12,5,149,M,7,5,6,66,-83,Severe
7,2,86,F,34,7,0,84,-2,Mild
12,3,147,M,103,13,6,162,15,Well
17,0,204,M,74,10,7,127,-77,Severe
6,5,77,M,36,7,2,86,9,Well
13,3,159,M,49,8,2,98,-61,Severe
6,8,80,M,106,13,10,166,86,Well
7,4,88,M,106,13,10,166,78,Well
14,5,173,M,109,14,1,169,-4,Mild
9,3,111,F,86,11,10,142,31,Well
9,6,114,M,18,6,1,73,-41,Severe
7,6,90,F,37,7,3,87,-3,Mild
16,6,198,M,30,6,9,81,-117,Severe
7,8,92,F,98,13,0,156,64,Well
8,4,100,M,38,7,4,88,-12,Severe
5,8,68,F,5,5,5,65,-3,Mild
13,11,167,F,26,6,6,78,-89,Severe
14,3,171,M,76,10,10,130,-41,Severe
12,2,146,M,82,11,5,137,-9,Severe
15,11,191,F,16,5,11,71,-120,Severe
12,7,151,M,107,13,11,167,16,Well
11,9,141,M,58,9,0,108,-33,Severe
10,11,131,M,71,10,3,123,-8,Severe
11,8,140,F,46,7,11,95,-45,Severe
11,8,140,F,108,14,0,168,28,Well
14,3,171,M,8,5,6,66,-105,Severe
16,5,197,F,35,7,1,85,-112,Severe
11,5,137,M,108,14,0,168,31,Well
13,11,167,F,27,6,7,79,-88,Severe
7,5,89,M,89,12,1,145,56,Well
11,5,137,F,34,7,0,84,-53,Severe
15,0,180,F,80,11,3,135,-45,Severe
18,6,222,M,39,7,5,89,-133,Severe
8,7,103,F,52,8,5,101,-2,Mild
13,11,167,M,106,13,10,166,-1,Mild
9,3,111,M,35,7,1,85,-26,Severe
5,5,65,F,63,9,6,114,49,Well
5,1,61,M,64,9,7,115,54,Well
16,1,193,M,52,8,5,101,-92,Severe
12,9,153,F,93,12,6,150,-3,Mild
8,9,105,F,59,9,1,109,4,Good
9,7,115,F,62,9,4,112,-3,Mild
6,10,82,F,71,10,3,123,41,Well
5,10,70,M,57,8,10,106,36,Well
16,0,192,M,89,12,1,145,-47,Severe
12,11,155,M,90,12,3,147,-8,Severe
8,2,98,M,27,6,7,79,-19,Severe
13,4,160,F,41,7,6,90,-70,Severe
8,1,97,M,11,5,8,68,-29,Severe
5,9,69,F,70,10,2,122,53,Well
17,4,208,M,18,6,1,73,-135,Severe
13,7,163,M,7,5,6,66,-97,Severe
7,7,91,M,10,5,7,67,-24,Severe
10,3,123,M,6,5,5,65,-58,Severe
16,3,195,M,40,7,5,89,-106,Severe
7,3,87,M,83,11,6,138,51,Well
7,3,87,F,105,13,9,165,78,Well
16,9,201,F,81,11,4,136,-65,Severe
17,5,209,M,88,12,0,144,-65,Severe
8,2,98,F,36,7,2,86,-12,Severe
11,4,136,M,49,8,2,98,-38,Severe
11,3,135,F,45,7,10,94,-41,Severe
12,0,144,M,28,6,8,80,-64,Severe
15,11,191,M,20,6,2,74,-117,Severe
9,4,112,M,47,8,0,96,-16,Severe
8,9,105,M,3,5,3,63,-42,Severe
5,11,71,F,10,5,7,67,-4,Mild
11,4,136,F,34,7,0,84,-52,Severe
7,2,86,M,107,13,11,167,81,Well
6,1,73,F,59,9,1,109,36,Well
7,3,87,F,5,5,5,65,-22,Severe
17,2,206,M,92,12,5,149,-57,Severe
10,9,129,F,26,6,6,78,-51,Severe
5,1,61,M,10,5,7,67,6,Well
16,11,203,M,7,5,6,66,-137,Severe
10,2,122,F,50,8,3,99,-23,Severe
11,9,141,M,71,10,3,123,-18,Severe
12,6,150,F,34,7,0,84,-66,Severe
16,3,195,M,12,5,9,69,-126,Severe
17,10,214,M,97,12,11,155,-59,Severe
12,9,153,M,91,12,4,148,-5,Mild
7,3,87,F,4,5,4,64,-23,Severe
11,0,132,M,79,11,1,133,1,Good
7,6,90,M,16,5,11,71,-19,Severe
17,2,206,F,51,8,4,100,-106,Severe
9,6,114,F,83,11,6,138,24,Well
13,2,158,F,22,6,3,75,-83,Severe
6,3,75,F,89,12,1,145,70,Well
18,1,217,F,22,6,3,75,-142,Severe
10,0,120,M,21,6,2,74,-46,Severe
17,6,210,M,5,5,5,65,-145,Severe
8,11,107,M,27,6,7,79,-28,Severe
7,9,93,F,41,7,6,90,-3,Mild
12,1,145,F,65,9,8,116,-29,Severe
18,9,225,F,90,12,3,147,-78,Severe
13,10,166,F,11,5,8,68,-98,Severe
10,2,122,F,92,12,5,149,27,Well
10,10,130,F,42,7,7,91,-39,Severe
16,4,196,M,102,13,6,162,-34,Severe
7,6,90,F,4,5,4,64,-26,Severe
12,1,145,M,45,7,10,94,-51,Severe
5,9,69,F,91,12,4,148,79,Well
13,3,159,M,37,7,3,87,-72,Severe
10,4,124,M,39,7,5,89,-35,Severe
5,3,63,M,38,7,4,88,25,Well
15,7,187,M,26,6,6,78,-109,Severe
14,10,178,F,63,9,6,114,-64,Severe
13,3,159,M,52,8,5,101,-58,Severe
14,7,175,M,87,11,11,143,-32,Severe
17,10,214,F,52,8,5,101,-113,Severe
8,2,98,F,73,10,6,126,28,Well
5,3,63,F,44,7,9,93,30,Well
7,7,91,F,7,5,6,66,-25,Severe
16,4,196,F,74,10,7,127,-69,Severe
18,1,217,F,83,11,6,138,-79,Severe
11,4,136,F,93,12,6,150,14,Well
6,3,75,F,40,7,5,89,14,Well
13,9,165,M,90,12,3,147,-18,Severe
7,5,89,M,11,5,8,68,-21,Severe
10,10,130,F,18,6,1,73,-57,Severe
9,1,109,M,13,5,9,69,-40,Severe
18,7,223,M,28,6,8,80,-143,Severe
11,11,143,M,91,12,4,148,5,Good
6,11,83,M,37,7,3,87,4,Good
17,6,210,F,77,10,11,131,-79,Severe
6,8,80,F,31,6,9,81,1,Good
17,7,211,F,21,6,2,74,-137,Severe
18,11,227,M,49,8,2,98,-129,Severe
17,3,207,F,22,6,3,75,-132,Severe
12,10,154,M,106,13,10,166,12,Well
7,0,84,M,37,7,3,87,3,Good
14,11,179,F,87,11,11,143,-36,Severe
14,6,174,M,44,7,9,93,-81,Severe
6,5,77,M,42,7,7,91,14,Well
6,10,82,F,77,10,11,131,49,Well
5,6,66,F,49,8,2,98,32,Well
14,5,173,F,22,6,3,75,-98,Severe
5,3,63,F,28,6,8,80,17,Well
10,5,125,M,92,12,5,149,24,Well
6,6,78,M,89,12,1,145,67,Well
7,2,86,M,44,7,9,93,7,Well
17,9,213,F,91,12,4,148,-65,Severe
7,6,90,F,11,5,8,68,-22,Severe
14,6,174,F,66,9,9,117,-57,Severe
11,2,134,F,74,10,7,127,-7,Severe
12,1,145,M,67,9,10,118,-27,Severe
5,5,65,M,105,13,9,165,100,Well
8,6,102,M,102,13,6,162,60,Well
13,9,165,M,26,6,6,78,-87,Severe
14,5,173,M,43,7,8,92,-81,Severe
17,3,207,M,87,11,11,143,-64,Severe
6,4,76,M,14,5,10,70,-6,Severe
5,1,61,F,46,7,11,95,34,Well
15,3,183,M,84,11,7,139,-44,Severe
17,6,210,M,59,9,1,109,-101,Severe
12,7,151,F,82,11,5,137,-14,Severe
17,3,207,F,95,12,9,153,-54,Severe
12,7,151,F,12,5,9,69,-82,Severe
17,5,209,F,42,7,7,91,-118,Severe
9,10,118,M,96,12,10,154,36,Well
16,4,196,F,77,10,11,131,-65,Severe
15,7,187,F,94,12,7,151,-36,Severe
9,6,114,M,101,13,4,160,46,Well
18,7,223,M,75,10,9,129,-94,Severe
11,6,138,M,60,9,2,110,-28,Severe
18,6,222,M,6,5,5,65,-157,Severe
18,4,220,M,65,9,8,116,-104,Severe
5,5,65,M,16,5,11,71,6,Well
15,2,182,F,79,11,1,133,-49,Severe
13,11,167,M,70,10,2,122,-45,Severe
16,6,198,F,5,5,5,65,-133,Severe
6,3,75,F,91,12,4,148,73,Well
8,8,104,M,68,10,0,120,16,Well
12,1,145,F,47,8,0,96,-49,Severe
9,8,116,F,64,9,7,115,-1,Mild
8,8,104,F,63,9,6,114,10,Well
17,2,206,F,87,11,11,143,-63,Severe
6,3,75,M,26,6,6,78,3,Good
7,10,94,F,64,9,7,115,21,Well
7,4,88,F,4,5,4,64,-24,Severe
5,8,68,F,63,9,6,114,46,Well
15,4,184,M,65,9,8,116,-68,Severe
12,3,147,F,77,10,11,131,-16,Severe
18,10,226,M,88,12,0,144,-82,Severe
5,5,65,M,11,5,8,68,3,Good
5,6,66,F,86,11,10,142,76,Well
5,0,60,F,84,11,7,139,79,Well
10,10,130,F,73,10,6,126,-4,Mild
5,11,71,M,89,12,1,145,74,Well
11,5,137,F,62,9,4,112,-25,Severe
9,5,113,F,27,6,7,79,-34,Severe
11,3,135,F,101,13,4,160,25,Well
12,4,148,F,43,7,8,92,-56,Severe
16,7,199,F,55,8,8,104,-95,Severe
16,9,201,M,96,12,10,154,-47,Severe
11,7,139,M,75,10,9,129,-10,Severe
16,11,203,M,24,6,5,77,-126,Severe
7,6,90,F,56,8,9,105,15,Well
7,5,89,M,69,10,1,121,32,Well
12,10,154,F,73,10,6,126,-28,Severe
11,11,143,M,7,5,6,66,-77,Severe
11,5,137,F,16,5,11,71,-66,Severe
13,5,161,M,72,10,4,124,-37,Severe
9,3,111,M,24,6,5,77,-34,Severe
12,0,144,F,65,9,8,116,-28,Severe
7,3,87,M,36,7,2,86,-1,Mild
11,7,139,M,20,6,2,74,-65,Severe
14,9,177,M,72,10,4,124,-53,Severe
13,0,156,F,71,10,3,123,-33,Severe
14,6,174,F,43,7,8,92,-82,Severe
8,3,99,F,64,9,7,115,16,Well
7,6,90,M,28,6,8,80,-10,Severe
14,1,169,F,22,6,3,75,-94,Severe
16,9,201,F,29,6,8,80,-121,Severe
14,9,177,F,85,11,9,141,-36,Severe
17,11,215,M,86,11,10,142,-73,Severe
17,6,210,F,104,13,7,163,-47,Severe
15,3,183,M,71,10,3,123,-60,Severe
5,6,66,M,95,12,9,153,87,Well
9,0,108,M,95,12,9,153,45,Well
5,10,70,M,14,5,10,70,0,Neutral
14,1,169,F,68,10,0,120,-49,Severe
18,10,226,F,39,7,5,89,-137,Severe
12,8,152,M,65,9,8,116,-36,Severe
14,3,171,M,11,5,8,68,-103,Severe
13,4,160,F,55,8,8,104,-56,Severe
15,3,183,F,72,10,4,124,-59,Severe
9,11,119,F,56,8,9,105,-14,Severe
16,1,193,M,39,7,5,89,-104,Severe
9,0,108,F,40,7,5,89,-19,Severe
10,3,123,F,43,7,8,92,-31,Severe
10,0,120,M,42,7,7,91,-29,Severe
18,8,224,M,76,10,10,130,-94,Severe
8,7,103,M,41,7,6,90,-13,Severe
9,9,117,M,50,8,3,99,-18,Severe
11,11,143,M,35,7,1,85,-58,Severe
5,1,61,M,81,11,4,136,75,Well
8,2,98,F,13,5,9,69,-29,Severe
14,6,174,F,3,5,3,63,-111,Severe
14,0,168,F,90,12,3,147,-21,Severe
16,7,199,M,72,10,4,124,-75,Severe
7,10,94,M,4,5,4,64,-30,Severe
13,3,159,F,73,10,6,126,-33,Severe
17,5,209,M,10,5,7,67,-142,Severe
16,9,201,M,103,13,6,162,-39,Severe
9,5,113,M,39,7,5,89,-24,Severe
9,9,117,M,100,13,3,159,42,Well
12,3,147,M,105,13,9,165,18,Well
14,6,174,F,50,8,3,99,-75,Severe
8,8,104,F,52,8,5,101,-3,Mild
8,4,100,F,28,6,8,80,-20,Severe
12,8,152,M,48,8,1,97,-55,Severe
18,2,218,M,100,13,3,159,-59,Severe
17,10,214,F,32,6,10,82,-132,Severe
8,10,106,F,73,10,6,126,20,Well
14,6,174,M,47,8,0,96,-78,Severe
13,7,163,M,68,10,0,120,-43,Severe
13,3,159,M,64,9,7,115,-44,Severe
11,10,142,M,8,5,6,66,-76,Severe
10,1,121,M,54,8,7,103,-18,Severe
10,6,126,F,63,9,6,114,-12,Severe
18,3,219,F,56,8,9,105,-114,Severe
10,3,123,F,46,7,11,95,-28,Severe
10,2,122,M,48,8,1,97,-25,Severe
9,4,112,M,55,8,8,104,-8,Severe
5,9,69,F,42,7,7,91,22,Well
7,0,84,M,3,5,3,63,-21,Severe
6,4,76,M,99,13,1,157,81,Well
13,10,166,F,101,13,4,160,-6,Severe
14,8,176,F,5,5,5,65,-111,Severe
15,9,189,F,30,6,9,81,-108,Severe
7,11,95,M,49,8,2,98,3,Good
10,4,124,F,63,9,6,114,-10,Severe
9,6,114,M,85,11,9,141,27,Well
13,6,162,M,43,7,8,92,-70,Severe
11,3,135,F,91,12,4,148,13,Well
9,8,116,F,94,12,7,151,35,Well
6,8,80,M,54,8,7,103,23,Well
13,10,166,M,80,11,3,135,-31,Severe
17,7,211,F,110,14,3,171,-40,Severe
5,11,71,M,50,8,3,99,28,Well
16,3,195,F,14,5,10,70,-125,Severe
15,2,182,M,27,6,7,79,-103,Severe
15,5,185,F,69,10,1,121,-64,Severe
11,0,132,M,94,12,7,151,19,Well
8,7,103,F,16,5,11,71,-32,Severe
16,8,200,F,21,6,2,74,-126,Severe
14,3,171,F,93,12,6,150,-21,Severe
8,8,104,M,108,14,0,168,64,Well
11,5,137,F,55,8,8,104,-33,Severe
13,2,158,F,27,6,7,79,-79,Severe
11,4,136,M,16,5,11,71,-65,Severe
9,0,108,M,16,5,11,71,-37,Severe
18,11,227,M,52,8,5,101,-126,Severe
15,3,183,M,81,11,4,136,-47,Severe
12,4,148,M,85,11,9,141,-7,Severe
11,7,139,F,110,14,3,171,32,Well
12,3,147,F,94,12,7,151,4,Good
10,3,123,M,107,13,11,167,44,Well
5,0,60,M,109,14,1,169,109,Well
8,5,101,F,102,13,6,162,61,Well
17,1,205,M,21,6,2,74,-131,Severe
6,5,77,M,79,11,1,133,56,Well
6,10,82,F,109,14,1,169,87,Well
11,6,138,M,65,9,8,116,-22,Severe
6,3,75,F,110,14,3,171,96,Well
11,7,139,M,44,7,9,93,-46,Severe
16,5,197,F,6,5,5,65,-132,Severe
17,3,207,M,18,6,1,73,-134,Severe
12,7,151,M,20,6,2,74,-77,Severe
7,11,95,M,90,12,3,147,52,Well
18,10,226,F,93,12,6,150,-76,Severe
8,3,99,F,50,8,3,99,0,Neutral
16,9,201,M,74,10,7,127,-74,Severe
7,11,95,F,103,13,6,162,67,Well
10,9,129,M,24,6,5,77,-52,Severe
12,8,152,F,97,12,11,155,3,Good
7,1,85,M,10,5,7,67,-18,Severe
12,7,151,M,50,8,3,99,-52,Severe
10,7,127,M,39,7,5,89,-38,Severe
13,5,161,F,15,5,11,71,-90,Severe
17,4,208,F,5,5,5,65,-143,Severe
17,7,211,F,48,8,1,97,-114,Severe
6,11,83,M,40,7,5,89,6,Well
13,3,159,M,38,7,4,88,-71,Severe
6,0,72,F,110,14,3,171,99,Well
18,6,222,F,91,12,4,148,-74,Severe
15,3,183,F,108,14,0,168,-15,Severe
6,5,77,M,31,6,9,81,4,Good
13,4,160,M,48,8,1,97,-63,Severe
9,1,109,M,100,13,3,159,50,Well
15,0,180,F,15,5,11,71,-109,Severe
17,6,210,F,28,6,8,80,-130,Severe
7,4,88,M,86,11,10,142,54,Well
10,5,125,M,110,14,3,171,46,Well
14,0,168,F,100,13,3,159,-9,Severe
17,1,205,F,38,7,4,88,-117,Severe
11,11,143,F,80,11,3,135,-8,Severe
16,11,203,M,64,9,7,115,-88,Severe
7,5,89,F,45,7,10,94,5,Good
17,2,206,M,108,14,0,168,-38,Severe
8,1,97,M,57,8,10,106,9,Well
7,5,89,M,9,5,7,67,-22,Severe
5,9,69,M,109,14,1,169,100,Well
10,11,131,F,103,13,6,162,31,Well
16,7,199,M,28,6,8,80,-119,Severe
18,4,220,F,86,11,10,142,-78,Severe
12,5,149,F,61,9,3,111,-38,Severe
17,3,207,F,72,10,4,124,-83,Severe
16,5,197,M,47,8,0,96,-101,Severe
12,4,148,F,53,8,6,102,-46,Severe
14,3,171,F,77,10,11,131,-40,Severe
12,4,148,M,23,6,4,76,-72,Severe
16,3,195,F,27,6,7,79,-116,Severe
9,11,119,M,78,11,0,132,13,Well
7,10,94,M,24,6,5,77,-17,Severe
5,4,64,M,56,8,9,105,41,Well
13,3,159,F,48,8,1,97,-62,Severe
6,3,75,M,39,7,5,89,14,Well
13,1,157,M,23,6,4,76,-81,Severe
12,5,149,F,60,9,2,110,-39,Severe
6,11,83,F,18,6,1,73,-10,Severe
6,3,75,F,80,11,3,135,60,Well
13,3,159,F,32,6,10,82,-77,Severe
9,5,113,M,11,5,8,68,-45,Severe
15,4,184,M,26,6,6,78,-106,Severe
11,6,138,M,67,9,10,118,-20,Severe
7,10,94,M,23,6,4,76,-18,Severe
9,4,112,M,75,10,9,129,17,Well
15,8,188,F,70,10,2,122,-66,Severe
8,7,103,M,35,7,1,85,-18,Severe
12,3,147,M,95,12,9,153,6,Well
12,9,153,F,83,11,6,138,-15,Severe
12,10,154,F,110,14,3,171,17,Well
5,3,63,F,38,7,4,88,25,Well
6,8,80,F,55,8,8,104,24,Well
15,5,185,M,22,6,3,75,-110,Severe
15,1,181,F,44,7,9,93,-88,Severe
14,5,173,M,78,11,0,132,-41,Severe
17,11,215,F,12,5,9,69,-146,Severe
5,11,71,M,51,8,4,100,29,Well
9,10,118,F,11,5,8,68,-50,Severe
9,4,112,F,103,13,6,162,50,Well
14,7,175,F,37,7,3,87,-88,Severe
14,10,178,M,105,13,9,165,-13,Severe
8,11,107,F,20,6,2,74,-33,Severe
13,9,165,M,70,10,2,122,-43,Severe
7,2,86,F,108,14,0,168,82,Well
5,6,66,M,93,12,6,150,84,Well
6,9,81,F,65,9,8,116,35,Well
18,3,219,M,95,12,9,153,-66,Severe
9,7,115,F,5,5,5,65,-50,Severe
18,11,227,M,46,7,11,95,-132,Severe
9,11,119,M,71,10,3,123,4,Good
17,6,210,M,79,11,1,133,-77,Severe
13,10,166,F,31,6,9,81,-85,Severe
6,5,77,M,44,7,9,93,16,Well
5,4,64,M,65,9,8,116,52,Well
16,5,197,F,66,9,9,117,-80,Severe
18,10,226,M,51,8,4,100,-126,Severe
16,10,202,M,90,12,3,147,-55,Severe
12,3,147,M,81,11,4,136,-11,Severe
9,2,110,M,35,7,1,85,-25,Severe
14,8,176,M,44,7,9,93,-83,Severe
14,9,177,F,101,13,4,160,-17,Severe
12,7,151,M,98,13,0,156,5,Good
8,3,99,F,11,5,8,68,-31,Severe
13,10,166,M,98,13,0,156,-10,Severe
6,3,75,F,59,9,1,109,34,Well
8,10,106,M,20,6,2,74,-32,Severe
6,10,82,F,9,5,7,67,-15,Severe
8,4,100,F,24,6,5,77,-23,Severe
18,4,220,F,64,9,7,115,-105,Severe
6,9,81,M,31,6,9,81,0,Neutral
10,6,126,F,9,5,7,67,-59,Severe
18,5,221,F,57,8,10,106,-115,Severe
7,5,89,F,70,10,2,122,33,Well
8,10,106,M,93,12,6,150,44,Well
8,1,97,M,59,9,1,109,12,Well
17,9,213,M,63,9,6,114,-99,Severe
15,6,186,F,42,7,7,91,-95,Severe
10,1,121,M,41,7,6,90,-31,Severe
8,2,98,M,23,6,4,76,-22,Severe
11,11,143,F,88,12,0,144,1,Good
5,5,65,M,70,10,2,122,57,Well
8,6,102,M,79,11,1,133,31,Well
13,11,167,M,18,6,1,73,-94,Severe
18,7,223,F,106,13,10,166,-57,Severe
10,3,123,M,98,13,0,156,33,Well
12,9,153,F,13,5,9,69,-84,Severe
5,8,68,F,39,7,5,89,21,Well
9,7,115,M,4,5,4,64,-51,Severe
18,11,227,M,109,14,1,169,-58,Severe
11,4,136,M,29,6,8,80,-56,Severe
13,8,164,F,26,6,6,78,-86,Severe
13,1,157,M,91,12,4,148,-9,Severe
15,6,186,M,71,10,3,123,-63,Severe
5,5,65,M,3,5,3,63,-2,Mild
17,6,210,F,83,11,6,138,-72,Severe
8,10,106,F,98,13,0,156,50,Well
10,0,120,M,19,6,1,73,-47,Severe
15,3,183,M,36,7,2,86,-97,Severe
10,3,123,F,97,12,11,155,32,Well
18,9,225,M,90,12,3,147,-78,Severe
7,2,86,M,77,10,11,131,45,Well
17,9,213,M,97,12,11,155,-58,Severe
17,8,212,M,78,11,0,132,-80,Severe
5,3,63,F,45,7,10,94,31,Well
12,9,153,M,47,8,0,96,-57,Severe
10,3,123,F,110,14,3,171,48,Well
5,8,68,M,89,12,1,145,77,Well
9,4,112,F,70,10,2,122,10,Well
16,0,192,F,84,11,7,139,-53,Severe
15,3,183,F,90,12,3,147,-36,Severe
14,6,174,F,79,11,1,133,-41,Severe
11,3,135,F,75,10,9,129,-6,Severe
13,7,163,M,40,7,5,89,-74,Severe
13,11,167,M,108,14,0,168,1,Good
5,2,62,F,94,12,7,151,89,Well
17,2,206,M,67,9,10,118,-88,Severe
5,3,63,F,13,5,9,69,6,Well
13,3,159,F,104,13,7,163,4,Good
6,7,79,M,85,11,9,141,62,Well
13,4,160,F,93,12,6,150,-10,Severe
6,4,76,M,88,12,0,144,68,Well
5,9,69,F,16,5,11,71,2,Good
8,0,96,M,56,8,9,105,9,Well
17,11,215,F,24,6,5,77,-138,Severe
9,10,118,F,100,13,3,159,41,Well
18,5,221,F,71,10,3,123,-98,Severe
5,0,60,M,82,11,5,137,77,Well
10,11,131,F,75,10,9,129,-2,Mild
13,6,162,F,75,10,9,129,-33,Severe
5,4,64,M,52,8,5,101,37,Well
5,7,67,M,49,8,2,98,31,Well
16,3,195,M,6,5,5,65,-130,Severe
5,9,69,M,105,13,9,165,96,Well
18,10,226,F,102,13,6,162,-64,Severe
18,7,223,M,29,6,8,80,-143,Severe
5,3,63,M,65,9,8,116,53,Well
10,3,123,F,71,10,3,123,0,Neutral
18,8,224,M,60,9,2,110,-114,Severe
16,6,198,M,67,9,10,118,-80,Severe
9,7,115,F,109,14,1,169,54,Well
17,4,208,M,75,10,9,129,-79,Severe
5,8,68,M,95,12,9,153,85,Well
10,0,120,M,73,10,6,126,6,Well
7,9,93,F,60,9,2,110,17,Well
6,10,82,M,9,5,7,67,-15,Severe
9,2,110,M,88,12,0,144,34,Well
7,5,89,M,47,8,0,96,7,Well
16,5,197,F,73,10,6,126,-71,Severe
17,6,210,F,88,12,0,144,-66,Severe
16,1,193,F,21,6,2,74,-119,Severe
10,1,121,M,71,10,3,123,2,Good
9,11,119,F,77,10,11,131,12,Well
17,2,206,F,81,11,4,136,-70,Severe
8,7,103,M,61,9,3,111,8,Well
15,1,181,F,26,6,6,78,-103,Severe
15,0,180,M,100,13,3,159,-21,Severe
7,1,85,F,93,12,6,150,65,Well
14,1,169,F,8,5,6,66,-103,Severe
8,0,96,F,58,9,0,108,12,Well
17,6,210,F,76,10,10,130,-80,Severe
18,8,224,M,104,13,7,163,-61,Severe
5,3,63,M,23,6,4,76,13,Well
15,10,190,F,57,8,10,106,-84,Severe
7,11,95,M,38,7,4,88,-7,Severe
13,8,164,M,82,11,5,137,-27,Severe
9,3,111,F,81,11,4,136,25,Well
15,5,185,M,109,14,1,169,-16,Severe
10,2,122,M,2,5,3,63,-59,Severe
9,0,108,M,11,5,8,68,-40,Severe
5,6,66,F,16,5,11,71,5,Good
16,6,198,F,11,5,8,68,-130,Severe
14,6,174,M,55,8,8,104,-70,Severe
11,6,138,M,23,6,4,76,-62,Severe
7,8,92,F,88,12,0,144,52,Well
9,10,118,F,48,8,1,97,-21,Severe
13,7,163,M,76,10,10,130,-33,Severe
14,8,176,F,106,13,10,166,-10,Severe
14,3,171,M,48,8,1,97,-74,Severe
14,3,171,M,64,9,7,115,-56,Severe
18,3,219,F,98,13,0,156,-63,Severe
14,9,177,F,93,12,6,150,-27,Severe
8,8,104,M,20,6,2,74,-30,Severe
5,0,60,M,45,7,10,94,34,Well
17,0,204,F,28,6,8,80,-124,Severe
17,6,210,F,40,7,5,89,-121,Severe
8,1,97,M,29,6,8,80,-17,Severe
16,11,203,M,76,10,10,130,-73,Severe
5,6,66,F,46,7,11,95,29,Well
15,11,191,F,98,13,0,156,-35,Severe
18,9,225,F,100,13,3,159,-66,Severe
6,8,80,M,12,5,9,69,-11,Severe
10,7,127,F,36,7,2,86,-41,Severe
5,3,63,M,101,13,4,160,97,Well
5,3,63,M,56,8,9,105,42,Well
6,3,75,F,40,7,5,89,14,Well
10,8,128,F,21,6,2,74,-54,Severe
18,6,222,F,64,9,7,115,-107,Severe
10,5,125,M,12,5,9,69,-56,Severe
15,2,182,F,21,6,2,74,-108,Severe
14,1,169,M,84,11,7,139,-30,Severe
12,0,144,M,100,13,3,159,15,Well
10,10,130,M,85,11,9,141,11,Well
7,7,91,F,65,9,8,116,25,Well
9,2,110,F,13,5,9,69,-41,Severe
17,6,210,F,69,10,1,121,-89,Severe
8,8,104,M,104,13,7,163,59,Well
15,3,183,M,104,13,7,163,-20,Severe
16,1,193,F,79,11,1,133,-60,Severe
8,11,107,F,87,11,11,143,36,Well
17,5,209,M,19,6,1,73,-136,Severe
9,5,113,F,54,8,7,103,-10,Severe
7,4,88,M,34,7,0,84,-4,Mild
14,3,171,F,42,7,7,91,-80,Severe
10,6,126,F,87,11,11,143,17,Well
15,2,182,M,107,13,11,167,-15,Severe
18,0,216,M,69,10,1,121,-95,Severe
8,8,104,F,100,13,3,159,55,Well
10,6,126,M,54,8,7,103,-23,Severe
12,4,148,F,95,12,9,153,5,Good
15,9,189,M,56,8,9,105,-84,Severe
12,0,144,M,37,7,3,87,-57,Severe
10,9,129,M,87,11,11,143,14,Well
6,7,79,F,71,10,3,123,44,Well
14,1,169,F,44,7,9,93,-76,Severe
8,0,96,M,14,5,10,70,-26,Severe
17,8,212,F,87,11,11,143,-69,Severe
7,9,93,F,43,7,8,92,-1,Mild
15,3,183,F,12,5,9,69,-114,Severe
8,6,102,M,90,12,3,147,45,Well
16,7,199,M,74,10,7,127,-72,Severe
10,5,125,F,94,12,7,151,26,Well
8,8,104,F,38,7,4,88,-16,Severe
18,6,222,M,103,13,6,162,-60,Severe
13,2,158,F,52,8,5,101,-57,Severe
6,3,75,M,73,10,6,126,51,Well
13,3,159,M,69,10,1,121,-38,Severe
14,4,172,F,72,10,4,124,-48,Severe
16,6,198,M,57,8,10,106,-92,Severe
12,9,153,M,18,6,1,73,-80,Severe
10,10,130,M,90,12,3,147,17,Well
14,10,178,M,7,5,6,66,-112,Severe
13,5,161,M,80,11,3,135,-26,Severe
14,6,174,M,6,5,5,65,-109,Severe
14,4,172,M,16,5,11,71,-101,Severe
13,10,166,M,94,12,7,151,-15,Severe
15,9,189,M,30,6,9,81,-108,Severe
15,8,188,F,44,7,9,93,-95,Severe
9,10,118,F,84,11,7,139,21,Well
6,5,77,M,65,9,8,116,39,Well
14,3,171,M,88,12,0,144,-27,Severe
9,5,113,F,6,5,5,65,-48,Severe
14,3,171,M,103,13,6,162,-9,Severe
15,6,186,F,61,9,3,111,-75,Severe
8,0,96,M,109,14,1,169,73,Well
13,4,160,M,16,5,11,71,-89,Severe
15,11,191,F,42,7,7,91,-100,Severe
14,2,170,M,65,9,8,116,-54,Severe
17,5,209,F,94,12,7,151,-58,Severe
12,3,147,F,49,8,2,98,-49,Severe
5,2,62,F,97,12,11,155,93,Well
10,10,130,F,72,10,4,124,-6,Severe
11,1,133,F,88,12,0,144,11,Well
9,7,115,F,33,6,11,83,-32,Severe
17,1,205,F,69,10,1,121,-84,Severe
17,1,205,F,11,5,8,68,-137,Severe
14,9,177,M,19,6,1,73,-104,Severe
18,10,226,M,28,6,8,80,-146,Severe
12,9,153,F,35,7,1,85,-68,Severe
6,8,80,F,84,11,7,139,59,Well
5,5,65,M,52,8,5,101,36,Well
7,2,86,F,106,13,10,166,80,Well
14,3,171,M,32,6,10,82,-89,Severe
6,5,77,M,32,6,10,82,5,Good
9,7,115,F,31,6,9,81,-34,Severe
5,9,69,F,98,13,0,156,87,Well
5,2,62,M,78,11,0,132,70,Well
10,2,122,M,25,6,5,77,-45,Severe
8,3,99,M,71,10,3,123,24,Well
5,0,60,F,64,9,7,115,55,Well
5,7,67,M,81,11,4,136,69,Well
13,0,156,M,69,10,1,121,-35,Severe
12,1,145,F,20,6,2,74,-71,Severe
16,8,200,M,109,14,1,169,-31,Severe
18,9,225,F,75,10,9,129,-96,Severe
11,1,133,M,20,6,2,74,-59,Severe
13,3,159,M,100,13,3,159,0,Neutral
18,0,216,M,88,12,0,144,-72,Severe
12,3,147,F,108,14,0,168,21,Well
5,3,63,M,34,7,0,84,21,Well
17,7,211,M,78,11,0,132,-79,Severe
18,10,226,M,49,8,2,98,-128,Severe
18,10,226,F,18,6,1,73,-153,Severe
10,1,121,F,58,9,0,108,-13,Severe
14,2,170,F,17,6,0,72,-98,Severe
16,1,193,F,96,12,10,154,-39,Severe
10,2,122,M,20,6,2,74,-48,Severe
16,8,200,M,102,13,6,162,-38,Severe
8,3,99,F,16,5,11,71,-28,Severe
18,6,222,F,46,7,11,95,-127,Severe
16,10,202,M,103,13,6,162,-40,Severe
6,8,80,F,12,5,9,69,-11,Severe
12,10,154,M,42,7,7,91,-63,Severe
6,6,78,M,52,8,5,101,23,Well
8,3,99,M,67,9,10,118,19,Well
15,3,183,F,95,12,9,153,-30,Severe
11,9,141,M,54,8,7,103,-38,Severe
17,0,204,M,106,13,10,166,-38,Severe
16,4,196,F,14,5,10,70,-126,Severe
7,3,87,F,83,11,6,138,51,Well
18,6,222,M,37,7,3,87,-135,Severe
12,5,149,F,77,10,11,131,-18,Severe
7,3,87,F,41,7,6,90,3,Good
11,6,138,M,3,5,3,63,-75,Severe
16,3,195,F,34,7,0,84,-111,Severe
18,0,216,M,68,10,0,120,-96,Severe
8,3,99,M,29,6,8,80,-19,Severe
17,5,209,M,35,7,1,85,-124,Severe
12,8,152,M,10,5,7,67,-85,Severe
18,0,216,F,108,14,0,168,-48,Severe
18,4,220,F,54,8,7,103,-117,Severe
15,2,182,F,85,11,9,141,-41,Severe
6,8,80,M,20,6,2,74,-6,Severe
8,4,100,F,18,6,1,73,-27,Severe
13,9,165,F,80,11,3,135,-30,Severe
8,5,101,M,97,12,11,155,54,Well
15,3,183,F,23,6,4,76,-107,Severe
16,2,194,F,6,5,5,65,-129,Severe
7,10,94,F,44,7,9,93,-1,Mild
13,10,166,F,86,11,10,142,-24,Severe
8,6,102,M,13,5,9,69,-33,Severe
6,7,79,M,4,5,4,64,-15,Severe
18,9,225,F,20,6,2,74,-151,Severe
10,5,125,F,41,7,6,90,-35,Severe
6,10,82,M,2,5,3,63,-19,Severe
9,3,111,F,97,12,11,155,44,Well
11,0,132,F,17,6,0,72,-60,Severe
18,1,217,M,4,5,4,64,-153,Severe
17,3,207,F,55,8,8,104,-103,Severe
5,1,61,F,66,9,9,117,56,Well
10,10,130,F,2,5,3,63,-67,Severe
14,4,172,M,10,5,7,67,-105,Severe
9,11,119,F,59,9,1,109,-10,Severe
8,2,98,F,48,8,1,97,-1,Mild
10,8,128,M,73,10,6,126,-2,Mild
12,1,145,M,55,8,8,104,-41,Severe
8,3,99,F,12,5,9,69,-30,Severe
7,0,84,M,85,11,9,141,57,Well
15,3,183,M,50,8,3,99,-84,Severe
5,2,62,M,38,7,4,88,26,Well
5,6,66,F,30,6,9,81,15,Well
11,5,137,F,25,6,5,77,-60,Severe
6,6,78,F,35,7,1,85,7,Well
12,5,149,M,10,5,7,67,-82,Severe
7,5,89,F,52,8,5,101,12,Well
5,0,60,M,17,6,0,72,12,Well
6,7,79,F,98,13,0,156,77,Well
7,6,90,F,19,6,1,73,-17,Severe
16,4,196,M,97,12,11,155,-41,Severe
15,7,187,M,89,12,1,145,-42,Severe
17,10,214,M,50,8,3,99,-115,Severe
7,9,93,F,7,5,6,66,-27,Severe
12,1,145,M,50,8,3,99,-46,Severe
15,11,191,F,102,13,6,162,-29,Severe
5,2,62,M,28,6,8,80,18,Well
10,11,131,F,44,7,9,93,-38,Severe
5,0,60,F,108,14,0,168,108,Well
12,7,151,F,52,8,5,101,-50,Severe
9,1,109,F,71,10,3,123,14,Well
6,5,77,F,61,9,3,111,34,Well
7,1,85,F,46,7,11,95,10,Well
12,0,144,F,40,7,5,89,-55,Severe
17,11,215,M,33,6,11,83,-132,Severe
12,4,148,F,10,5,7,67,-81,Severe
18,0,216,M,39,7,5,89,-127,Severe
14,3,171,M,8,5,6,66,-105,Severe
15,3,183,F,107,13,11,167,-16,Severe
9,8,116,F,24,6,5,77,-39,Severe
15,1,181,F,42,7,7,91,-90,Severe
11,7,139,M,4,5,4,64,-75,Severe
6,10,82,F,82,11,5,137,55,Well
13,9,165,M,78,11,0,132,-33,Severe
6,7,79,M,18,6,1,73,-6,Severe
8,0,96,M,77,10,11,131,35,Well
16,6,198,M,51,8,4,100,-98,Severe
13,2,158,M,66,9,9,117,-41,Severe
15,3,183,F,110,14,3,171,-12,Severe
12,8,152,F,73,10,6,126,-26,Severe
12,0,144,F,14,5,10,70,-74,Severe
10,11,131,M,21,6,2,74,-57,Severe
12,6,150,F,12,5,9,69,-81,Severe
16,7,199,F,110,14,3,171,-28,Severe
9,5,113,F,81,11,4,136,23,Well
16,1,193,M,97,12,11,155,-38,Severe
17,3,207,F,74,10,7,127,-80,Severe
13,2,158,F,44,7,9,93,-65,Severe
15,3,183,F,53,8,6,102,-81,Severe
18,10,226,M,42,7,7,91,-135,Severe
9,4,112,M,48,8,1,97,-15,Severe
8,3,99,F,101,13,4,160,61,Well
11,4,136,F,92,12,5,149,13,Well
12,9,153,M,107,13,11,167,14,Well
16,3,195,M,65,9,8,116,-79,Severe
13,4,160,F,70,10,2,122,-38,Severe
9,9,117,F,45,7,10,94,-23,Severe
6,8,80,F,30,6,9,81,1,Good
15,8,188,M,19,6,1,73,-115,Severe
5,11,71,M,37,7,3,87,16,Well
12,8,152,M,39,7,5,89,-63,Severe
12,11,155,M,16,5,11,71,-84,Severe
12,1,145,F,54,8,7,103,-42,Severe
11,3,135,M,93,12,6,150,15,Well
11,3,135,F,99,13,1,157,22,Well
6,2,74,M,108,14,0,168,94,Well
18,11,227,F,62,9,4,112,-115,Severe
9,8,116,F,99,13,1,157,41,Well
10,9,129,F,102,13,6,162,33,Well
15,4,184,M,49,8,2,98,-86,Severe
10,4,124,F,17,6,0,72,-52,Severe
15,3,183,M,55,8,8,104,-79,Severe
14,2,170,M,29,6,8,80,-90,Severe
15,8,188,F,110,14,3,171,-17,Severe
10,11,131,F,18,6,1,73,-58,Severe
5,3,63,M,6,5,5,65,2,Good
12,11,155,M,100,13,3,159,4,Good
13,2,158,F,90,12,3,147,-11,Severe
16,1,193,F,29,6,8,80,-113,Severe
7,0,84,F,46,7,11,95,11,Well
16,3,195,M,36,7,2,86,-109,Severe
8,4,100,F,81,11,4,136,36,Well
12,10,154,F,12,5,9,69,-85,Severe
5,6,66,F,98,13,0,156,90,Well
15,7,187,F,105,13,9,165,-22,Severe
7,3,87,M,37,7,3,87,0,Neutral
13,5,161,F,109,14,1,169,8,Well
14,4,172,M,3,5,3,63,-109,Severe
11,3,135,F,25,6,5,77,-58,Severe
15,9,189,F,106,13,10,166,-23,Severe
17,8,212,F,76,10,10,130,-82,Severe
11,8,140,F,45,7,10,94,-46,Severe
6,5,77,F,77,10,11,131,54,Well
9,7,115,M,61,9,3,111,-4,Mild
6,9,81,F,17,6,0,72,-9,Severe
6,3,75,M,96,12,10,154,79,Well
5,3,63,M,41,7,6,90,27,Well
8,3,99,F,31,6,9,81,-18,Severe
10,4,124,M,5,5,5,65,-59,Severe
13,11,167,F,36,7,2,86,-81,Severe
18,10,226,F,89,12,1,145,-81,Severe
15,9,189,M,44,7,9,93,-96,Severe
9,8,116,F,12,5,9,69,-47,Severe
11,5,137,F,13,5,9,69,-68,Severe
16,3,195,F,76,10,10,130,-65,Severe
10,7,127,M,16,5,11,71,-56,Severe
16,5,197,M,108,14,0,168,-29,Severe
13,1,157,F,25,6,5,77,-80,Severe
5,5,65,F,52,8,5,101,36,Well
12,3,147,F,44,7,9,93,-54,Severe
17,1,205,F,110,14,3,171,-34,Severe
6,1,73,M,72,10,4,124,51,Well
8,5,101,M,26,6,6,78,-23,Severe
16,11,203,M,11,5,8,68,-135,Severe
8,9,105,M,65,9,8,116,11,Well
14,10,178,F,84,11,7,139,-39,Severe
16,0,192,F,59,9,1,109,-83,Severe
16,5,197,M,26,6,6,78,-119,Severe
5,3,63,F,11,5,8,68,5,Good
7,5,89,F,68,10,0,120,31,Well
14,1,169,M,99,13,1,157,-12,Severe
16,7,199,M,106,13,10,166,-33,Severe
12,10,154,M,37,7,3,87,-67,Severe
9,0,108,F,12,5,9,69,-39,Severe
6,4,76,F,20,6,2,74,-2,Mild
6,5,77,F,102,13,6,162,85,Well
13,7,163,F,73,10,6,126,-37,Severe
13,8,164,M,22,6,3,75,-89,Severe
7,2,86,F,6,5,5,65,-21,Severe
9,0,108,F,39,7,5,89,-19,Severe
8,9,105,M,105,13,9,165,60,Well
13,3,159,M,64,9,7,115,-44,Severe
7,2,86,M,21,6,2,74,-12,Severe
12,4,148,M,56,8,9,105,-43,Severe
13,6,162,F,11,5,8,68,-94,Severe
12,11,155,F,98,13,0,156,1,Good
16,3,195,F,3,5,3,63,-132,Severe
6,6,78,M,45,7,10,94,16,Well
17,5,209,F,65,9,8,116,-93,Severe
7,3,87,F,28,6,8,80,-7,Severe
17,8,212,M,79,11,1,133,-79,Severe
10,5,125,M,13,5,9,69,-56,Severe
6,5,77,M,109,14,1,169,92,Well
11,4,136,M,69,10,1,121,-15,Severe
7,6,90,F,103,13,6,162,72,Well
14,8,176,M,81,11,4,136,-40,Severe
11,9,141,M,73,10,6,126,-15,Severe
10,3,123,F,4,5,4,64,-59,Severe
15,11,191,F,90,12,3,147,-44,Severe
10,3,123,M,86,11,10,142,19,Well
13,3,159,M,92,12,5,149,-10,Severe
14,0,168,M,8,5,6,66,-102,Severe
13,3,159,F,25,6,5,77,-82,Severe
5,10,70,M,107,13,11,167,97,Well
13,9,165,M,46,7,11,95,-70,Severe
16,8,200,F,30,6,9,81,-119,Severe
5,7,67,F,107,13,11,167,100,Well
11,10,142,M,23,6,4,76,-66,Severe
10,5,125,F,49,8,2,98,-27,Severe
14,7,175,M,50,8,3,99,-76,Severe
16,9,201,M,46,7,11,95,-106,Severe
13,0,156,F,92,12,5,149,-7,Severe
12,0,144,M,30,6,9,81,-63,Severe
6,1,73,F,47,8,0,96,23,Well
11,7,139,M,55,8,8,104,-35,Severe
5,6,66,M,90,12,3,147,81,Well
12,1,145,M,39,7,5,89,-56,Severe
8,8,104,M,66,9,9,117,13,Well
16,2,194,F,22,6,3,75,-119,Severe
12,11,155,M,24,6,5,77,-78,Severe
9,6,114,F,91,12,4,148,34,Well
8,9,105,F,107,13,11,167,62,Well
7,2,86,M,24,6,5,77,-9,Severe
16,6,198,M,46,7,11,95,-103,Severe
7,3,87,M,90,12,3,147,60,Well
11,8,140,F,74,10,7,127,-13,Severe
8,10,106,F,13,5,9,69,-37,Severe
16,9,201,F,7,5,6,66,-135,Severe
15,3,183,M,96,12,10,154,-29,Severe
12,1,145,M,68,10,0,120,-25,Severe
9,11,119,F,5,5,5,65,-54,Severe
6,7,79,F,13,5,9,69,-10,Severe
11,5,137,M,53,8,6,102,-35,Severe
13,5,161,M,92,12,5,149,-12,Severe
10,11,131,M,24,6,5,77,-54,Severe
11,3,135,F,18,6,1,73,-62,Severe
5,3,63,M,15,5,11,71,8,Well
12,11,155,M,76,10,10,130,-25,Severe
9,6,114,M,22,6,3,75,-39,Severe
15,9,189,F,67,9,10,118,-71,Severe
18,4,220,M,79,11,1,133,-87,Severe
16,0,192,F,65,9,8,116,-76,Severe
13,0,156,M,61,9,3,111,-45,Severe
9,9,117,M,54,8,7,103,-14,Severe
18,8,224,M,18,6,1,73,-151,Severe
18,3,219,F,8,5,6,66,-153,Severe
6,6,78,M,69,10,1,121,43,Well
18,4,220,M,68,10,0,120,-100,Severe
5,8,68,F,87,11,11,143,75,Well
10,1,121,M,83,11,6,138,17,Well
13,2,158,F,42,7,7,91,-67,Severe
9,11,119,M,110,14,3,171,52,Well
16,6,198,F,40,7,5,89,-109,Severe
18,3,219,M,20,6,2,74,-145,Severe
12,10,154,M,40,7,5,89,-65,Severe
8,0,96,F,35,7,1,85,-11,Severe
14,11,179,F,30,6,9,81,-98,Severe
6,6,78,F,43,7,8,92,14,Well
8,6,102,F,78,11,0,132,30,Well
17,2,206,F,2,5,3,63,-143,Severe
14,1,169,F,56,8,9,105,-64,Severe
17,6,210,F,85,11,9,141,-69,Severe
6,4,76,M,56,8,9,105,29,Well
11,2,134,M,97,12,11,155,21,Well
10,9,129,F,68,10,0,120,-9,Severe
9,0,108,F,27,6,7,79,-29,Severe
11,5,137,M,7,5,6,66,-71,Severe
6,10,82,F,70,10,2,122,40,Well
9,8,116,F,70,10,2,122,6,Well
12,3,147,M,100,13,3,159,12,Well
11,4,136,F,39,7,5,89,-47,Severe
13,3,159,F,73,10,6,126,-33,Severe
9,11,119,M,23,6,4,76,-43,Severe
6,4,76,F,45,7,10,94,18,Well
15,3,183,M,22,6,3,75,-108,Severe
5,0,60,M,41,7,6,90,30,Well
18,10,226,F,60,9,2,110,-116,Severe
7,8,92,M,11,5,8,68,-24,Severe
17,3,207,M,108,14,0,168,-39,Severe
14,3,171,M,96,12,10,154,-17,Severe
17,0,204,M,82,11,5,137,-67,Severe
12,7,151,M,74,10,7,127,-24,Severe
10,6,126,M,47,8,0,96,-30,Severe
8,3,99,M,44,7,9,93,-6,Severe
15,4,184,M,101,13,4,160,-24,Severe
8,9,105,M,20,6,2,74,-31,Severe
14,7,175,F,93,12,6,150,-25,Severe
11,9,141,F,42,7,7,91,-50,Severe
8,2,98,M,7,5,6,66,-32,Severe
17,5,209,M,31,6,9,81,-128,Severe
8,4,100,M,100,13,3,159,59,Well
14,9,177,F,78,11,0,132,-45,Severe
16,9,201,F,88,12,0,144,-57,Severe
18,4,220,M,28,6,8,80,-140,Severe
10,6,126,M,14,5,10,70,-56,Severe
12,3,147,F,5,5,5,65,-82,Severe
16,1,193,F,51,8,4,100,-93,Severe
12,5,149,M,77,10,11,131,-18,Severe
16,10,202,F,50,8,3,99,-103,Severe
17,2,206,F,34,7,0,84,-122,Severe
13,11,167,F,73,10,6,126,-41,Severe
10,9,129,F,108,14,0,168,39,Well
14,1,169,F,60,9,2,110,-59,Severe
16,2,194,F,5,5,5,65,-129,Severe
7,10,94,F,88,12,0,144,50,Well
6,2,74,M,12,5,9,69,-5,Mild
12,2,146,M,56,8,9,105,-41,Severe
12,7,151,M,34,7,0,84,-67,Severe
5,0,60,F,45,7,10,94,34,Well
17,6,210,F,22,6,3,75,-135,Severe
9,8,116,M,21,6,2,74,-42,Severe
13,6,162,M,101,13,4,160,-2,Mild
11,6,138,F,13,5,9,69,-69,Severe
10,2,122,F,67,9,10,118,-4,Mild
9,2,110,M,20,6,2,74,-36,Severe
17,1,205,F,39,7,5,89,-116,Severe
18,7,223,M,69,10,1,121,-102,Severe
12,2,146,F,74,10,7,127,-19,Severe
12,4,148,M,51,8,4,100,-48,Severe
18,5,221,M,74,10,7,127,-94,Severe
18,11,227,M,64,9,7,115,-112,Severe
5,8,68,M,76,10,10,130,62,Well
16,4,196,F,63,9,6,114,-82,Severe
16,9,201,F,17,6,0,72,-129,Severe
7,9,93,F,45,7,10,94,1,Good
9,3,111,M,64,9,7,115,4,Good
13,3,159,F,13,5,9,69,-90,Severe
8,2,98,M,93,12,6,150,52,Well
12,11,155,M,37,7,3,87,-68,Severe
13,8,164,M,33,6,11,83,-81,Severe
8,3,99,M,105,13,9,165,66,Well
10,11,131,M,44,7,9,93,-38,Severe
13,10,166,F,71,10,3,123,-43,Severe
11,3,135,F,93,12,6,150,15,Well
13,3,159,F,102,13,6,162,3,Good
13,2,158,F,56,8,9,105,-53,Severe
6,0,72,F,19,6,1,73,1,Good
12,3,147,F,105,13,9,165,18,Well
12,4,148,M,66,9,9,117,-31,Severe
10,8,128,M,101,13,4,160,32,Well
5,4,64,M,109,14,1,169,105,Well
8,3,99,F,65,9,8,116,17,Well
18,6,222,M,69,10,1,121,-101,Severe
6,5,77,F,99,13,1,157,80,Well
14,2,170,M,17,6,0,72,-98,Severe
14,6,174,F,18,6,1,73,-101,Severe
5,7,67,M,96,12,10,154,87,Well
16,2,194,F,17,6,0,72,-122,Severe
7,3,87,F,23,6,4,76,-11,Severe
13,0,156,M,78,11,0,132,-24,Severe
16,6,198,M,103,13,6,162,-36,Severe
9,5,113,M,38,7,4,88,-25,Severe
17,10,214,F,80,11,3,135,-79,Severe
7,3,87,M,40,7,5,89,2,Good
7,0,84,M,18,6,1,73,-11,Severe
16,1,193,F,30,6,9,81,-112,Severe
8,3,99,M,30,6,9,81,-18,Severe
16,11,203,M,59,9,1,109,-94,Severe
16,3,195,F,42,7,7,91,-104,Severe
18,3,219,F,57,8,10,106,-113,Severe
7,10,94,M,16,5,11,71,-23,Severe
7,4,88,M,40,7,5,89,1,Good
13,7,163,M,61,9,3,111,-52,Severe
10,3,123,M,93,12,6,150,27,Well
10,8,128,M,36,7,2,86,-42,Severe
13,0,156,M,107,13,11,167,11,Well
8,11,107,F,110,14,3,171,64,Well
7,2,86,M,14,5,10,70,-16,Severe
13,7,163,F,18,6,1,73,-90,Severe
6,8,80,M,18,6,1,73,-7,Severe
14,11,179,F,27,6,7,79,-100,Severe
7,5,89,M,58,9,0,108,19,Well
7,3,87,F,73,10,6,126,39,Well
17,6,210,M,77,10,11,131,-79,Severe
17,7,211,F,18,6,1,73,-138,Severe
6,0,72,M,84,11,7,139,67,Well
11,0,132,F,36,7,2,86,-46,Severe
16,6,198,M,91,12,4,148,-50,Severe
7,1,85,M,5,5,5,65,-20,Severe
18,2,218,F,109,14,1,169,-49,Severe
7,9,93,F,10,5,7,67,-26,Severe
10,0,120,F,34,7,0,84,-36,Severe
12,11,155,F,23,6,4,76,-79,Severe
8,10,106,M,65,9,8,116,10,Well
15,4,184,M,50,8,3,99,-85,Severe
8,6,102,M,17,6,0,72,-30,Severe
14,6,174,M,54,8,7,103,-71,Severe
18,3,219,F,78,11,0,132,-87,Severe
11,6,138,M,32,6,10,82,-56,Severe
13,0,156,F,95,12,9,153,-3,Mild
10,1,121,M,72,10,4,124,3,Good
9,3,111,M,28,6,8,80,-31,Severe
15,11,191,F,22,6,3,75,-116,Severe
11,1,133,M,77,10,11,131,-2,Mild
8,3,99,F,84,11,7,139,40,Well
8,6,102,M,32,6,10,82,-20,Severe
18,5,221,M,110,14,3,171,-50,Severe
9,7,115,F,89,12,1,145,30,Well
18,8,224,F,106,13,10,166,-58,Severe
5,6,66,M,83,11,6,138,72,Well
6,9,81,M,51,8,4,100,19,Well
15,3,183,M,12,5,9,69,-114,Severe
15,6,186,M,37,7,3,87,-99,Severe
6,3,75,F,107,13,11,167,92,Well
8,10,106,M,97,12,11,155,49,Well
9,2,110,M,56,8,9,105,-5,Mild
10,11,131,M,42,7,7,91,-40,Severe
18,11,227,F,57,8,10,106,-121,Severe
13,6,162,M,79,11,1,133,-29,Severe
13,5,161,F,18,6,1,73,-88,Severe
5,4,64,M,98,13,0,156,92,Well
12,0,144,M,95,12,9,153,9,Well
9,2,110,M,17,6,0,72,-38,Severe
12,11,155,M,9,5,7,67,-88,Severe
5,3,63,M,85,11,9,141,78,Well
12,10,154,M,4,5,4,64,-90,Severe
6,2,74,F,73,10,6,126,52,Well
17,2,206,M,90,12,3,147,-59,Severe
15,10,190,M,32,6,10,82,-108,Severe
12,5,149,M,109,14,1,169,20,Well
8,5,101,M,60,9,2,110,9,Well
6,9,81,F,87,11,11,143,62,Well
9,0,108,M,55,8,8,104,-4,Mild
14,3,171,F,3,5,3,63,-108,Severe
13,8,164,F,5,5,5,65,-99,Severe
5,7,67,F,28,6,8,80,13,Well
15,11,191,F,81,11,4,136,-55,Severe
17,1,205,M,57,8,10,106,-99,Severe
14,5,173,F,77,10,11,131,-42,Severe
17,6,210,F,70,10,2,122,-88,Severe
13,3,159,F,22,6,3,75,-84,Severe
12,0,144,M,21,6,2,74,-70,Severe
13,2,158,M,42,7,7,91,-67,Severe
12,5,149,M,43,7,8,92,-57,Severe
10,6,126,F,29,6,8,80,-46,Severe
16,5,197,M,50,8,3,99,-98,Severe
7,7,91,F,63,9,6,114,23,Well
10,9,129,M,43,7,8,92,-37,Severe
6,9,81,M,40,7,5,89,8,Well
7,6,90,M,72,10,4,124,34,Well
7,4,88,M,67,9,10,118,30,Well
11,3,135,F,85,11,9,141,6,Well
9,2,110,F,109,14,1,169,59,Well
8,6,102,M,74,10,7,127,25,Well
11,4,136,M,38,7,4,88,-48,Severe
6,0,72,M,54,8,7,103,31,Well
16,8,200,M,60,9,2,110,-90,Severe
8,3,99,F,26,6,6,78,-21,Severe
12,6,150,M,70,10,2,122,-28,Severe
10,5,125,M,85,11,9,141,16,Well
9,0,108,M,5,5,5,65,-43,Severe
17,4,208,M,35,7,1,85,-123,Severe
10,6,126,F,56,8,9,105,-21,Severe
7,2,86,F,62,9,4,112,26,Well
16,4,196,F,109,14,1,169,-27,Severe
5,0,60,F,51,8,4,100,40,Well
9,0,108,F,23,6,4,76,-32,Severe
13,6,162,F,17,6,0,72,-90,Severe
18,8,224,F,101,13,4,160,-64,Severe
16,7,199,M,3,5,3,63,-136,Severe
7,3,87,M,76,10,10,130,43,Well
18,4,220,F,109,14,1,169,-51,Severe
10,6,126,F,49,8,2,98,-28,Severe
5,2,62,F,26,6,6,78,16,Well
9,10,118,M,91,12,4,148,30,Well
12,4,148,M,35,7,1,85,-63,Severe
10,11,131,F,54,8,7,103,-28,Severe
16,11,203,M,17,6,0,72,-131,Severe
12,7,151,M,44,7,9,93,-58,Severe
18,10,226,F,103,13,6,162,-64,Severe
7,8,92,M,49,8,2,98,6,Well
14,11,179,F,84,11,7,139,-40,Severe
17,6,210,F,95,12,9,153,-57,Severe
7,2,86,M,50,8,3,99,13,Well
14,1,169,M,19,6,1,73,-96,Severe
7,1,85,F,4,5,4,64,-21,Severe
15,0,180,M,48,8,1,97,-83,Severe
17,8,212,M,109,14,1,169,-43,Severe
5,2,62,M,26,6,6,78,16,Well
5,10,70,F,83,11,6,138,68,Well
17,3,207,M,36,7,2,86,-121,Severe
9,1,109,F,95,12,9,153,44,Well
12,9,153,M,24,6,5,77,-76,Severe
18,2,218,M,79,11,1,133,-85,Severe
8,3,99,F,58,9,0,108,9,Well
14,5,173,F,73,10,6,126,-47,Severe
10,10,130,F,70,10,2,122,-8,Severe
9,6,114,M,94,12,7,151,37,Well
17,0,204,F,85,11,9,141,-63,Severe
14,2,170,M,97,12,11,155,-15,Severe
11,9,141,F,90,12,3,147,6,Well
5,3,63,F,3,5,3,63,0,Neutral
14,8,176,M,4,5,4,64,-112,Severe
12,11,155,M,50,8,3,99,-56,Severe
13,5,161,M,74,10,7,127,-34,Severe
9,3,111,F,32,6,10,82,-29,Severe
14,9,177,M,73,10,6,126,-51,Severe
6,3,75,M,36,7,2,86,11,Well
13,3,159,F,69,10,1,121,-38,Severe
14,11,179,M,4,5,4,64,-115,Severe
7,9,93,M,85,11,9,141,48,Well
5,9,69,F,8,5,6,66,-3,Mild
11,0,132,M,14,5,10,70,-62,Severe
6,4,76,F,3,5,3,63,-13,Severe
14,2,170,M,72,10,4,124,-46,Severe
8,1,97,F,67,9,10,118,21,Well
16,7,199,M,84,11,7,139,-60,Severe
18,0,216,M,72,10,4,124,-92,Severe
6,3,75,F,42,7,7,91,16,Well
6,10,82,M,52,8,5,101,19,Well
12,9,153,F,78,11,0,132,-21,Severe
6,11,83,M,79,11,1,133,50,Well
11,8,140,F,105,13,9,165,25,Well
5,1,61,M,23,6,4,76,15,Well
14,5,173,M,93,12,6,150,-23,Severe
17,10,214,M,110,14,3,171,-43,Severe
17,3,207,F,27,6,7,79,-128,Severe
7,10,94,M,34,7,0,84,-10,Severe
14,11,179,M,53,8,6,102,-77,Severe
8,10,106,F,61,9,3,111,5,Good
17,2,206,M,59,9,1,109,-97,Severe
10,3,123,M,18,6,1,73,-50,Severe
7,11,95,M,15,5,11,71,-24,Severe
5,0,60,F,35,7,1,85,25,Well
9,8,116,F,95,12,9,153,37,Well
7,3,87,M,21,6,2,74,-13,Severe
18,11,227,M,22,6,3,75,-152,Severe
14,6,174,M,90,12,3,147,-27,Severe
13,5,161,M,42,7,7,91,-70,Severe
11,2,134,F,63,9,6,114,-20,Severe
15,10,190,F,50,8,3,99,-91,Severe
15,4,184,M,34,7,0,84,-100,Severe
5,9,69,F,74,10,7,127,58,Well
10,10,130,M,93,12,6,150,20,Well
17,3,207,F,81,11,4,136,-71,Severe
10,2,122,F,22,6,3,75,-47,Severe
13,11,167,M,40,7,5,89,-78,Severe
13,4,160,M,43,7,8,92,-68,Severe
5,1,61,F,76,10,10,130,69,Well
10,11,131,F,110,14,3,171,40,Well
17,5,209,F,88,12,0,144,-65,Severe
8,9,105,F,39,7,5,89,-16,Severe
6,3,75,F,29,6,8,80,5,Good
16,8,200,F,28,6,8,80,-120,Severe
6,6,78,F,51,8,4,100,22,Well
9,5,113,M,49,8,2,98,-15,Severe
6,1,73,F,18,6,1,73,0,Neutral
14,6,174,M,110,14,3,171,-3,Mild
13,11,167,F,34,7,0,84,-83,Severe
5,8,68,F,36,7,2,86,18,Well
16,5,197,F,87,11,11,143,-54,Severe
18,5,221,F,83,11,6,138,-83,Severe
7,5,89,M,21,6,2,74,-15,Severe
8,7,103,F,32,6,10,82,-21,Severe
16,8,200,F,40,7,5,89,-111,Severe
13,11,167,M,67,9,10,118,-49,Severe
8,1,97,M,26,6,6,78,-19,Severe
16,1,193,M,38,7,4,88,-105,Severe
9,7,115,F,43,7,8,92,-23,Severe
13,4,160,F,37,7,3,87,-73,Severe
7,3,87,F,11,5,8,68,-19,Severe
17,9,213,M,8,5,6,66,-147,Severe
15,9,189,F,38,7,4,88,-101,Severe
18,10,226,F,82,11,5,137,-89,Severe
8,3,99,F,58,9,0,108,9,Well
14,3,171,F,73,10,6,126,-45,Severe
9,3,111,F,96,12,10,154,43,Well
7,7,91,M,109,14,1,169,78,Well
6,11,83,F,69,10,1,121,38,Well
5,3,63,F,23,6,4,76,13,Well
6,4,76,F,29,6,8,80,4,Good
9,0,108,M,100,13,3,159,51,Well
9,7,115,F,50,8,3,99,-16,Severe
11,3,135,F,35,7,1,85,-50,Severe
7,3,87,F,60,9,2,110,23,Well
5,3,63,F,8,5,6,66,3,Good
15,7,187,M,13,5,9,69,-118,Severe
16,2,194,M,15,5,11,71,-123,Severe
9,10,118,F,23,6,4,76,-42,Severe
9,1,109,F,26,6,6,78,-31,Severe
17,3,207,F,20,6,2,74,-133,Severe
13,3,159,F,64,9,7,115,-44,Severe
10,8,128,F,11,5,8,68,-60,Severe
6,8,80,M,51,8,4,100,20,Well
15,1,181,F,97,12,11,155,-26,Severe
10,2,122,F,75,10,9,129,7,Well
7,1,85,F,49,8,2,98,13,Well
12,3,147,F,3,5,3,63,-84,Severe
6,1,73,F,84,11,7,139,66,Well
9,9,117,F,58,9,0,108,-9,Severe
7,7,91,F,3,5,3,63,-28,Severe
16,3,195,F,71,10,3,123,-72,Severe
5,7,67,M,39,7,5,89,22,Well
5,3,63,F,50,8,3,99,36,Well
9,7,115,F,34,7,0,84,-31,Severe
8,11,107,F,52,8,5,101,-6,Severe
6,6,78,F,34,7,0,84,6,Well
13,1,157,F,92,12,5,149,-8,Severe
15,4,184,F,33,6,11,83,-101,Severe
10,2,122,M,78,11,0,132,10,Well
9,0,108,M,33,6,11,83,-25,Severe
14,3,171,M,17,6,0,72,-99,Severe
12,9,153,F,25,6,5,77,-76,Severe
16,1,193,M,110,14,3,171,-22,Severe
16,11,203,F,29,6,8,80,-123,Severe
5,7,67,M,86,11,10,142,75,Well
17,10,214,F,94,12,7,151,-63,Severe
7,3,87,M,47,8,0,96,9,Well
15,4,184,F,60,9,2,110,-74,Severe
8,3,99,M,8,5,6,66,-33,Severe
15,1,181,F,2,5,3,63,-118,Severe
6,2,74,F,20,6,2,74,0,Neutral
9,3,111,M,26,6,6,78,-33,Severe
5,4,64,F,20,6,2,74,10,Well
15,8,188,F,53,8,6,102,-86,Severe
12,3,147,F,56,8,9,105,-42,Severe
11,10,142,M,11,5,8,68,-74,Severe
15,3,183,M,85,11,9,141,-42,Severe
7,7,91,F,24,6,5,77,-14,Severe
12,0,144,F,53,8,6,102,-42,Severe
15,2,182,F,59,9,1,109,-73,Severe
15,2,182,F,92,12,5,149,-33,Severe
12,11,155,M,20,6,2,74,-81,Severe
8,5,101,M,34,7,0,84,-17,Severe
8,1,97,F,33,6,11,83,-14,Severe
10,0,120,M,77,10,11,131,11,Well
10,3,123,F,70,10,2,122,-1,Mild
18,3,219,M,49,8,2,98,-121,Severe
14,0,168,F,37,7,3,87,-81,Severe
9,11,119,F,76,10,10,130,11,Well
5,7,67,F,68,10,0,120,53,Well
5,10,70,M,58,9,0,108,38,Well
18,9,225,M,101,13,4,160,-65,Severe
16,11,203,M,107,13,11,167,-36,Severe
17,11,215,F,101,13,4,160,-55,Severe
10,1,121,F,56,8,9,105,-16,Severe
11,6,138,F,87,11,11,143,5,Good
13,10,166,M,53,8,6,102,-64,Severe
8,10,106,F,16,5,11,71,-35,Severe
16,2,194,M,81,11,4,136,-58,Severe
11,2,134,F,39,7,5,89,-45,Severe
9,5,113,F,74,10,7,127,14,Well
18,0,216,F,99,13,1,157,-59,Severe
14,9,177,M,48,8,1,97,-80,Severe
7,6,90,F,90,12,3,147,57,Well
15,0,180,F,100,13,3,159,-21,Severe
12,9,153,F,72,10,4,124,-29,Severe
9,10,118,F,20,6,2,74,-44,Severe
14,8,176,M,92,12,5,149,-27,Severe
8,10,106,M,76,10,10,130,24,Well
18,3,219,M,97,12,11,155,-64,Severe
18,4,220,M,37,7,3,87,-133,Severe
16,8,200,F,93,12,6,150,-50,Severe
9,4,112,F,102,13,6,162,50,Well
14,4,172,F,63,9,6,114,-58,Severe
13,9,165,M,36,7,2,86,-79,Severe
11,3,135,M,33,6,11,83,-52,Severe
11,11,143,F,25,6,5,77,-66,Severe
9,4,112,M,109,14,1,169,57,Well
6,3,75,M,81,11,4,136,61,Well
16,3,195,M,42,7,7,91,-104,Severe
8,9,105,F,33,6,11,83,-22,Severe
6,0,72,F,52,8,5,101,29,Well
13,1,157,F,75,10,9,129,-28,Severe
12,3,147,M,49,8,2,98,-49,Severe
8,4,100,M,65,9,8,116,16,Well
10,10,130,M,76,10,10,130,0,Neutral
16,1,193,M,27,6,7,79,-114,Severe
13,5,161,F,85,11,9,141,-20,Severe
18,11,227,M,60,9,2,110,-117,Severe
13,3,159,F,85,11,9,141,-18,Severe
11,4,136,F,3,5,3,63,-73,Severe
11,3,135,F,65,9,8,116,-19,Severe
18,6,222,F,58,9,0,108,-114,Severe
18,8,224,M,80,11,3,135,-89,Severe
9,11,119,M,19,6,1,73,-46,Severe
16,10,202,F,11,5,8,68,-134,Severe
8,9,105,F,8,5,6,66,-39,Severe
9,3,111,M,55,8,8,104,-7,Severe
18,11,227,M,93,12,6,150,-77,Severe
14,10,178,M,56,8,9,105,-73,Severe
9,9,117,M,22,6,3,75,-42,Severe
6,3,75,F,9,5,7,67,-8,Severe
10,0,120,F,39,7,5,89,-31,Severe
8,3,99,F,24,6,5,77,-22,Severe
5,5,65,F,37,7,3,87,22,Well
8,5,101,M,35,7,1,85,-16,Severe
9,6,114,F,107,13,11,167,53,Well
8,1,97,M,52,8,5,101,4,Good
8,0,96,M,2,5,3,63,-33,Severe
12,0,144,F,92,12,5,149,5,Good
11,11,143,F,77,10,11,131,-12,Severe
6,2,74,M,95,12,9,153,79,Well
12,9,153,M,87,11,11,143,-10,Severe
5,4,64,M,29,6,8,80,16,Well
7,3,87,F,21,6,2,74,-13,Severe
10,0,120,M,34,7,0,84,-36,Severe
16,11,203,M,80,11,3,135,-68,Severe
9,8,116,F,100,13,3,159,43,Well
15,1,181,F,73,10,6,126,-55,Severe
17,3,207,M,8,5,6,66,-141,Severe
7,6,90,F,80,11,3,135,45,Well
17,3,207,M,75,10,9,129,-78,Severe
13,9,165,M,4,5,4,64,-101,Severe
10,5,125,F,60,9,2,110,-15,Severe
12,3,147,M,92,12,5,149,2,Good
9,0,108,M,97,12,11,155,47,Well
17,11,215,F,85,11,9,141,-74,Severe
16,3,195,M,79,11,1,133,-62,Severe
16,1,193,M,43,7,8,92,-101,Severe
6,7,79,M,22,6,3,75,-4,Mild
12,5,149,F,50,8,3,99,-50,Severe
16,3,195,F,61,9,3,111,-84,Severe
13,6,162,M,38,7,4,88,-74,Severe
15,5,185,M,83,11,6,138,-47,Severe
15,11,191,F,110,14,3,171,-20,Severe
5,6,66,M,84,11,7,139,73,Well
11,1,133,F,3,5,3,63,-70,Severe
17,5,209,F,35,7,1,85,-124,Severe
17,11,215,M,85,11,9,141,-74,Severe
5,10,70,M,90,12,3,147,77,Well
5,2,62,F,86,11,10,142,80,Well
11,6,138,M,2,5,3,63,-75,Severe
18,1,217,M,29,6,8,80,-137,Severe
14,3,171,M,68,10,0,120,-51,Severe
6,8,80,M,36,7,2,86,6,Well
11,11,143,F,92,12,5,149,6,Well
8,10,106,M,12,5,9,69,-37,Severe
10,4,124,F,97,12,11,155,31,Well
7,9,93,F,61,9,3,111,18,Well
13,6,162,M,21,6,2,74,-88,Severe
16,8,200,F,56,8,9,105,-95,Severe
15,0,180,M,67,9,10,118,-62,Severe
16,11,203,M,46,7,11,95,-108,Severe
15,6,186,M,13,5,9,69,-117,Severe
16,6,198,F,90,12,3,147,-51,Severe
8,9,105,M,86,11,10,142,37,Well
17,3,207,F,75,10,9,129,-78,Severe
15,3,183,F,17,6,0,72,-111,Severe
6,8,80,M,7,5,6,66,-14,Severe
15,8,188,F,73,10,6,126,-62,Severe
18,2,218,M,21,6,2,74,-144,Severe
13,5,161,F,63,9,6,114,-47,Severe
10,3,123,F,12,5,9,69,-54,Severe
16,3,195,F,77,10,11,131,-64,Severe
12,7,151,M,9,5,7,67,-84,Severe
15,11,191,F,106,13,10,166,-25,Severe
11,2,134,F,58,9,0,108,-26,Severe
17,4,208,M,91,12,4,148,-60,Severe
8,3,99,M,83,11,6,138,39,Well
13,5,161,F,46,7,11,95,-66,Severe
6,3,75,F,19,6,1,73,-2,Mild
5,9,69,M,10,5,7,67,-2,Mild
12,7,151,M,41,7,6,90,-61,Severe
18,9,225,F,98,13,0,156,-69,Severe
6,2,74,M,4,5,4,64,-10,Severe
10,11,131,F,79,11,1,133,2,Good
16,10,202,M,4,5,4,64,-138,Severe
14,8,176,M,40,7,5,89,-87,Severe
6,3,75,F,96,12,10,154,79,Well
11,0,132,F,9,5,7,67,-65,Severe
14,4,172,M,79,11,1,133,-39,Severe
10,11,131,F,67,9,10,118,-13,Severe
8,0,96,F,68,10,0,120,24,Well
16,10,202,F,88,12,0,144,-58,Severe
15,3,183,F,79,11,1,133,-50,Severe
5,3,63,F,30,6,9,81,18,Well
7,3,87,M,65,9,8,116,29,Well
12,7,151,F,107,13,11,167,16,Well
17,3,207,M,84,11,7,139,-68,Severe
7,1,85,F,10,5,7,67,-18,Severe
17,1,205,M,62,9,4,112,-93,Severe
17,5,209,M,50,8,3,99,-110,Severe
5,1,61,F,17,6,0,72,11,Well
15,4,184,F,13,5,9,69,-115,Severe
8,5,101,F,78,11,0,132,31,Well
8,8,104,M,38,7,4,88,-16,Severe
16,0,192,F,29,6,8,80,-112,Severe
14,2,170,F,107,13,11,167,-3,Mild
14,11,179,M,77,10,11,131,-48,Severe
18,8,224,M,34,7,0,84,-140,Severe
14,3,171,M,29,6,8,80,-91,Severe
17,11,215,F,52,8,5,101,-114,Severe
7,3,87,F,44,7,9,93,6,Well
9,7,115,F,10,5,7,67,-48,Severe
18,6,222,F,104,13,7,163,-59,Severe
13,3,159,M,7,5,6,66,-93,Severe
18,11,227,M,75,10,9,129,-98,Severe
7,0,84,F,59,9,1,109,25,Well
17,1,205,M,101,13,4,160,-45,Severe
10,1,121,F,36,7,2,86,-35,Severe
9,1,109,M,55,8,8,104,-5,Mild
14,11,179,F,75,10,9,129,-50,Severe
15,1,181,M,28,6,8,80,-101,Severe
15,7,187,F,87,11,11,143,-44,Severe
16,11,203,M,18,6,1,73,-130,Severe
14,7,175,M,27,6,7,79,-96,Severe
13,1,157,M,90,12,3,147,-10,Severe
13,11,167,F,101,13,4,160,-7,Severe
6,11,83,M,9,5,7,67,-16,Severe
15,7,187,F,13,5,9,69,-118,Severe
6,3,75,F,37,7,3,87,12,Well
17,8,212,M,47,8,0,96,-116,Severe
17,3,207,M,40,7,5,89,-118,Severe
14,5,173,M,71,10,3,123,-50,Severe
15,0,180,F,38,7,4,88,-92,Severe
14,5,173,F,53,8,6,102,-71,Severe
16,9,201,M,67,9,10,118,-83,Severe
8,7,103,F,5,5,5,65,-38,Severe
13,0,156,F,108,14,0,168,12,Well
17,4,208,F,57,8,10,106,-102,Severe
15,10,190,M,101,13,4,160,-30,Severe
8,6,102,F,50,8,3,99,-3,Mild
11,10,142,M,46,7,11,95,-47,Severe
15,3,183,F,81,11,4,136,-47,Severe
12,10,154,F,9,5,7,67,-87,Severe
10,3,123,M,7,5,6,66,-57,Severe
14,5,173,F,8,5,6,66,-107,Severe
15,10,190,F,72,10,4,124,-66,Severe
14,5,173,M,27,6,7,79,-94,Severe
16,3,195,M,22,6,3,75,-120,Severe
8,9,105,M,16,5,11,71,-34,Severe
16,6,198,M,71,10,3,123,-75,Severe
14,2,170,M,57,8,10,106,-64,Severe
6,7,79,M,80,11,3,135,56,Well
6,8,80,M,92,12,5,149,69,Well
17,4,208,M,34,7,0,84,-124,Severe
5,6,66,F,27,6,7,79,13,Well
12,3,147,M,13,5,9,69,-78,Severe
14,11,179,M,11,5,8,68,-111,Severe
9,10,118,F,29,6,8,80,-38,Severe
10,10,130,M,40,7,5,89,-41,Severe
10,3,123,M,11,5,8,68,-55,Severe
13,0,156,M,85,11,9,141,-15,Severe
8,3,99,M,52,8,5,101,2,Good
15,1,181,M,67,9,10,118,-63,Severe
7,0,84,M,87,11,11,143,59,Well
7,5,89,M,2,5,3,63,-26,Severe
11,11,143,F,104,13,7,163,20,Well
14,9,177,M,55,8,8,104,-73,Severe
7,1,85,F,50,8,3,99,14,Well
9,5,113,M,23,6,4,76,-37,Severe
8,2,98,F,84,11,7,139,41,Well
8,3,99,M,107,13,11,167,68,Well
5,2,62,M,59,9,1,109,47,Well
16,2,194,F,30,6,9,81,-113,Severe
17,5,209,F,80,11,3,135,-74,Severe
8,2,98,M,15,5,11,71,-27,Severe
5,11,71,F,59,9,1,109,38,Well
9,3,111,M,90,12,3,147,36,Well
5,7,67,M,4,5,4,64,-3,Mild
11,3,135,F,96,12,10,154,19,Well
18,4,220,F,92,12,5,149,-71,Severe
15,1,181,F,82,11,5,137,-44,Severe
14,2,170,M,74,10,7,127,-43,Severe
16,0,192,F,32,6,10,82,-110,Severe
10,3,123,F,3,5,3,63,-60,Severe
9,11,119,M,86,11,10,142,23,Well
16,0,192,M,18,6,1,73,-119,Severe
6,3,75,F,51,8,4,100,25,Well
9,11,119,F,73,10,6,126,7,Well
9,9,117,M,48,8,1,97,-20,Severe
11,0,132,M,44,7,9,93,-39,Severe
17,1,205,M,13,5,9,69,-136,Severe
13,5,161,M,71,10,3,123,-38,Severe
15,0,180,M,76,10,10,130,-50,Severe
7,8,92,M,88,12,0,144,52,Well
11,6,138,M,28,6,8,80,-58,Severe
16,7,199,F,50,8,3,99,-100,Severe
16,4,196,M,24,6,5,77,-119,Severe
11,3,135,F,77,10,11,131,-4,Mild
6,4,76,M,2,5,3,63,-13,Severe
9,3,111,F,46,7,11,95,-16,Severe
7,5,89,F,103,13,6,162,73,Well
11,4,136,F,51,8,4,100,-36,Severe
11,10,142,F,25,6,5,77,-65,Severe
6,0,72,F,18,6,1,73,1,Good
14,0,168,M,25,6,5,77,-91,Severe
10,3,123,F,80,11,3,135,12,Well
9,3,111,M,67,9,10,118,7,Well
10,0,120,F,29,6,8,80,-40,Severe
11,3,135,M,13,5,9,69,-66,Severe
16,8,200,F,84,11,7,139,-61,Severe
13,10,166,F,51,8,4,100,-66,Severe
16,8,200,F,10,5,7,67,-133,Severe
6,0,72,F,64,9,7,115,43,Well
16,9,201,M,9,5,7,67,-134,Severe
14,0,168,M,24,6,5,77,-91,Severe
5,5,65,M,20,6,2,74,9,Well
7,10,94,M,103,13,6,162,68,Well
7,9,93,F,90,12,3,147,54,Well
13,3,159,M,33,6,11,83,-76,Severe
15,6,186,M,2,5,3,63,-123,Severe
16,6,198,M,73,10,6,126,-72,Severe
16,3,195,M,105,13,9,165,-30,Severe
13,1,157,F,26,6,6,78,-79,Severe
8,2,98,M,20,6,2,74,-24,Severe
5,7,67,F,22,6,3,75,8,Well
5,9,69,M,24,6,5,77,8,Well
7,0,84,M,26,6,6,78,-6,Severe
13,9,165,M,109,14,1,169,4,Good
8,0,96,F,23,6,4,76,-20,Severe
8,11,107,M,14,5,10,70,-37,Severe
17,11,215,M,84,11,7,139,-76,Severe
10,10,130,M,23,6,4,76,-54,Severe
14,1,169,F,53,8,6,102,-67,Severe
15,4,184,M,60,9,2,110,-74,Severe
15,6,186,M,110,14,3,171,-15,Severe
14,1,169,F,84,11,7,139,-30,Severe
8,5,101,M,12,5,9,69,-32,Severe
14,3,171,M,98,13,0,156,-15,Severe
5,3,63,M,11,5,8,68,5,Good
9,2,110,F,90,12,3,147,37,Well
18,11,227,M,81,11,4,136,-91,Severe
8,3,99,M,80,11,3,135,36,Well
5,1,61,M,88,12,0,144,83,Well
9,3,111,M,25,6,5,77,-34,Severe
6,6,78,M,83,11,6,138,60,Well
11,0,132,F,74,10,7,127,-5,Mild
18,3,219,M,31,6,9,81,-138,Severe
13,6,162,F,98,13,0,156,-6,Severe
14,2,170,M,19,6,1,73,-97,Severe
8,7,103,M,68,10,0,120,17,Well
8,11,107,M,29,6,8,80,-27,Severe
11,0,132,F,61,9,3,111,-21,Severe
5,9,69,M,93,12,6,150,81,Well
12,9,153,F,67,9,10,118,-35,Severe
9,10,118,F,32,6,10,82,-36,Severe
12,1,145,F,66,9,9,117,-28,Severe
7,11,95,M,41,7,6,90,-5,Mild
8,8,104,M,26,6,6,78,-26,Severe
12,3,147,F,84,11,7,139,-8,Severe
16,4,196,F,79,11,1,133,-63,Severe
5,11,71,M,2,5,3,63,-8,Severe
9,5,113,F,96,12,10,154,41,Well
9,3,111,M,60,9,2,110,-1,Mild
6,5,77,F,94,12,7,151,74,Well
7,5,89,F,84,11,7,139,50,Well
17,4,208,F,88,12,0,144,-64,Severe
11,3,135,F,54,8,7,103,-32,Severe
10,4,124,F,108,14,0,168,44,Well
14,3,171,F,37,7,3,87,-84,Severe
13,4,160,M,41,7,6,90,-70,Severe
8,0,96,F,34,7,0,84,-12,Severe
13,8,164,F,103,13,6,162,-2,Mild
12,5,149,M,95,12,9,153,4,Good
12,11,155,M,105,13,9,165,10,Well
6,10,82,F,102,13,6,162,80,Well
14,4,172,F,98,13,0,156,-16,Severe
17,4,208,F,45,7,10,94,-114,Severe
5,2,62,M,105,13,9,165,103,Well
12,10,154,F,51,8,4,100,-54,Severe
10,2,122,F,59,9,1,109,-13,Severe
10,4,124,M,28,6,8,80,-44,Severe
10,3,123,F,2,5,3,63,-60,Severe
7,11,95,F,91,12,4,148,53,Well
7,10,94,F,40,7,5,89,-5,Mild
16,8,200,F,32,6,10,82,-118,Severe
11,6,138,M,61,9,3,111,-27,Severe
11,8,140,F,33,6,11,83,-57,Severe
9,4,112,M,22,6,3,75,-37,Severe
7,10,94,F,7,5,6,66,-28,Severe
7,3,87,M,79,11,1,133,46,Well
6,5,77,F,53,8,6,102,25,Well
10,4,124,F,24,6,5,77,-47,Severe
9,11,119,M,109,14,1,169,50,Well
6,8,80,M,17,6,0,72,-8,Severe
5,11,71,M,88,12,0,144,73,Well
16,6,198,M,17,6,0,72,-126,Severe
13,11,167,F,60,9,2,110,-57,Severe
9,3,111,M,58,9,0,108,-3,Mild
9,9,117,F,101,13,4,160,43,Well
12,2,146,M,65,9,8,116,-30,Severe
9,6,114,F,93,12,6,150,36,Well
14,7,175,M,56,8,9,105,-70,Severe
10,2,122,M,40,7,5,89,-33,Severe
11,2,134,F,110,14,3,171,37,Well
18,6,222,F,72,10,4,124,-98,Severe
5,9,69,F,30,6,9,81,12,Well
7,1,85,M,2,5,3,63,-22,Severe
18,10,226,F,34,7,0,84,-142,Severe
6,10,82,F,106,13,10,166,84,Well
13,2,158,M,101,13,4,160,2,Good
13,7,163,F,48,8,1,97,-66,Severe
13,9,165,M,50,8,3,99,-66,Severe
16,0,192,F,106,13,10,166,-26,Severe
5,4,64,F,23,6,4,76,12,Well
5,3,63,F,9,5,7,67,4,Good
17,3,207,F,35,7,1,85,-122,Severe
18,6,222,M,42,7,7,91,-131,Severe
10,4,124,M,6,5,5,65,-59,Severe
18,2,218,M,42,7,7,91,-127,Severe
11,3,135,F,47,8,0,96,-39,Severe
12,6,150,F,25,6,5,77,-73,Severe
7,5,89,F,88,12,0,144,55,Well
6,2,74,M,104,13,7,163,89,Well
18,5,221,M,96,12,10,154,-67,Severe
16,9,201,M,60,9,2,110,-91,Severe
16,5,197,M,86,11,10,142,-55,Severe
10,10,130,M,45,7,10,94,-36,Severe
17,9,213,F,101,13,4,160,-53,Severe
12,5,149,F,86,11,10,142,-7,Severe
11,9,141,M,107,13,11,167,26,Well
10,7,127,M,38,7,4,88,-39,Severe
16,10,202,F,83,11,6,138,-64,Severe
5,7,67,F,10,5,7,67,0,Neutral
16,10,202,M,34,7,0,84,-118,Severe
6,3,75,M,53,8,6,102,27,Well
7,3,87,M,43,7,8,92,5,Good
8,9,105,M,74,10,7,127,22,Well
13,3,159,F,35,7,1,85,-74,Severe
7,6,90,F,72,10,4,124,34,Well
15,5,185,M,76,10,10,130,-55,Severe
11,2,134,F,96,12,10,154,20,Well
11,10,142,M,76,10,10,130,-12,Severe
15,4,184,M,98,13,0,156,-28,Severe
8,6,102,M,77,10,11,131,29,Well
14,0,168,M,44,7,9,93,-75,Severe
10,3,123,M,49,8,2,98,-25,Severe
6,1,73,M,64,9,7,115,42,Well
14,1,169,F,67,9,10,118,-51,Severe
16,2,194,F,37,7,3,87,-107,Severe
6,7,79,F,23,6,4,76,-3,Mild
18,4,220,M,80,11,3,135,-85,Severe
15,4,184,F,11,5,8,68,-116,Severe
5,9,69,M,9,5,7,67,-2,Mild
7,3,87,F,39,7,5,89,2,Good
17,3,207,F,16,5,11,71,-136,Severe
7,3,87,F,18,6,1,73,-14,Severe
10,6,126,F,78,11,0,132,6,Well
5,7,67,M,25,6,5,77,10,Well
8,4,100,F,35,7,1,85,-15,Severe
17,1,205,F,80,11,3,135,-70,Severe
8,3,99,M,34,7,0,84,-15,Severe
10,7,127,F,55,8,8,104,-23,Severe
13,1,157,M,78,11,0,132,-25,Severe
6,0,72,M,7,5,6,66,-6,Severe
13,8,164,F,97,12,11,155,-9,Severe
10,7,127,M,47,8,0,96,-31,Severe
8,0,96,M,96,12,10,154,58,Well
17,11,215,M,69,10,1,121,-94,Severe
11,6,138,M,42,7,7,91,-47,Severe
9,5,113,F,89,12,1,145,32,Well
7,1,85,M,50,8,3,99,14,Well
8,6,102,F,106,13,10,166,64,Well
6,7,79,M,21,6,2,74,-5,Mild
10,10,130,M,15,5,11,71,-59,Severe
5,11,71,F,22,6,3,75,4,Good
13,2,158,M,82,11,5,137,-21,Severe
7,2,86,F,3,5,3,63,-23,Severe
16,3,195,M,37,7,3,87,-108,Severe
7,3,87,M,14,5,10,70,-17,Severe
8,4,100,M,23,6,4,76,-24,Severe
14,2,170,M,38,7,4,88,-82,Severe
9,1,109,F,70,10,2,122,13,Well
18,0,216,F,11,5,8,68,-148,Severe
5,7,67,F,92,12,5,149,82,Well
12,11,155,F,70,10,2,122,-33,Severe
9,9,117,F,20,6,2,74,-43,Severe
15,1,181,F,103,13,6,162,-19,Severe
16,10,202,F,40,7,5,89,-113,Severe
9,9,117,M,70,10,2,122,5,Good
10,0,120,M,53,8,6,102,-18,Severe
16,3,195,M,106,13,10,166,-29,Severe
10,7,127,F,3,5,3,63,-64,Severe
6,11,83,F,90,12,3,147,64,Well
17,7,211,M,99,13,1,157,-54,Severe
18,0,216,F,37,7,3,87,-129,Severe
15,9,189,F,76,10,10,130,-59,Severe
8,2,98,M,22,6,3,75,-23,Severe
11,7,139,M,85,11,9,141,2,Good
13,7,163,F,28,6,8,80,-83,Severe
11,7,139,M,10,5,7,67,-72,Severe
13,6,162,M,59,9,1,109,-53,Severe
7,7,91,M,19,6,1,73,-18,Severe
14,3,171,F,47,8,0,96,-75,Severe
9,3,111,M,72,10,4,124,13,Well
15,1,181,F,106,13,10,166,-15,Severe
18,1,217,M,95,12,9,153,-64,Severe
17,0,204,M,70,10,2,122,-82,Severe
7,2,86,M,108,14,0,168,82,Well
7,10,94,F,50,8,3,99,5,Good
14,1,169,M,45,7,10,94,-75,Severe
7,1,85,M,47,8,0,96,11,Well
9,3,111,F,9,5,7,67,-44,Severe
18,4,220,M,101,13,4,160,-60,Severe
10,10,130,M,29,6,8,80,-50,Severe
16,7,199,M,35,7,1,85,-114,Severe
12,10,154,M,5,5,5,65,-89,Severe
8,7,103,F,64,9,7,115,12,Well
12,5,149,M,61,9,3,111,-38,Severe
14,7,175,F,11,5,8,68,-107,Severe
14,6,174,F,37,7,3,87,-87,Severe
10,11,131,M,57,8,10,106,-25,Severe
15,1,181,F,59,9,1,109,-72,Severe
15,7,187,F,65,9,8,116,-71,Severe
5,0,60,M,61,9,3,111,51,Well
12,1,145,M,10,5,7,67,-78,Severe
7,8,92,F,12,5,9,69,-23,Severe
12,11,155,F,62,9,4,112,-43,Severe
10,2,122,F,15,5,11,71,-51,Severe
11,10,142,M,89,12,1,145,3,Good
15,10,190,F,91,12,4,148,-42,Severe
16,3,195,M,47,8,0,96,-99,Severe
5,11,71,M,100,13,3,159,88,Well
8,3,99,F,28,6,8,80,-19,Severe
12,8,152,M,23,6,4,76,-76,Severe
5,9,69,M,12,5,9,69,0,Neutral
11,10,142,F,48,8,1,97,-45,Severe
14,10,178,M,33,6,11,83,-95,Severe
13,3,159,M,68,10,0,120,-39,Severe
13,1,157,M,74,10,7,127,-30,Severe
13,7,163,F,68,10,0,120,-43,Severe
16,7,199,M,78,11,0,132,-67,Severe
16,8,200,M,16,5,11,71,-129,Severe
16,3,195,M,23,6,4,76,-119,Severe
11,6,138,F,83,11,6,138,0,Neutral
17,7,211,M,12,5,9,69,-142,Severe
9,8,116,M,67,9,10,118,2,Good
10,3,123,M,75,10,9,129,6,Well
5,11,71,M,71,10,3,123,52,Well
5,7,67,M,108,14,0,168,101,Well
15,3,183,F,31,6,9,81,-102,Severe
11,3,135,F,59,9,1,109,-26,Severe
5,5,65,F,42,7,7,91,26,Well
7,0,84,M,98,13,0,156,72,Well
15,5,185,F,85,11,9,141,-44,Severe
6,1,73,F,99,13,1,157,84,Well
13,6,162,M,74,10,7,127,-35,Severe
8,2,98,F,64,9,7,115,17,Well
13,8,164,M,50,8,3,99,-65,Severe
12,11,155,M,28,6,8,80,-75,Severe
13,3,159,M,98,13,0,156,-3,Mild
14,0,168,M,16,5,11,71,-97,Severe
16,4,196,F,31,6,9,81,-115,Severe
8,5,101,M,103,13,6,162,61,Well
8,10,106,F,69,10,1,121,15,Well
17,2,206,M,71,10,3,123,-83,Severe
9,11,119,F,98,13,0,156,37,Well
15,11,191,F,52,8,5,101,-90,Severe
14,10,178,F,47,8,0,96,-82,Severe
16,3,195,F,110,14,3,171,-24,Severe
7,7,91,F,45,7,10,94,3,Good
13,1,157,F,2,5,3,63,-94,Severe
12,0,144,F,108,14,0,168,24,Well
6,11,83,M,48,8,1,97,14,Well
10,3,123,F,104,13,7,163,40,Well
16,9,201,M,43,7,8,92,-109,Severe
8,11,107,F,37,7,3,87,-20,Severe
5,2,62,F,107,13,11,167,105,Well
11,9,141,F,9,5,7,67,-74,Severe
17,11,215,M,99,13,1,157,-58,Severe
16,1,193,M,41,7,6,90,-103,Severe
7,8,92,M,60,9,2,110,18,Well
14,5,173,F,45,7,10,94,-79,Severe
17,6,210,F,3,5,3,63,-147,Severe
9,8,116,M,78,11,0,132,16,Well
14,9,177,F,83,11,6,138,-39,Severe
11,4,136,M,66,9,9,117,-19,Severe
16,5,197,M,65,9,8,116,-81,Severe
18,2,218,F,44,7,9,93,-125,Severe
10,6,126,M,98,13,0,156,30,Well
11,6,138,F,100,13,3,159,21,Well
18,2,218,F,61,9,3,111,-107,Severe
18,10,226,M,60,9,2,110,-116,Severe
13,3,159,F,23,6,4,76,-83,Severe
8,7,103,M,51,8,4,100,-3,Mild
14,3,171,M,43,7,8,92,-79,Severe
6,0,72,F,14,5,10,70,-2,Mild
6,5,77,M,43,7,8,92,15,Well
8,7,103,F,62,9,4,112,9,Well
14,5,173,F,75,10,9,129,-44,Severe
6,10,82,F,99,13,1,157,75,Well
12,8,152,M,101,13,4,160,8,Well
18,3,219,M,80,11,3,135,-84,Severe
7,9,93,F,32,6,10,82,-11,Severe
10,1,121,F,69,10,1,121,0,Neutral
10,10,130,M,39,7,5,89,-41,Severe
9,5,113,M,21,6,2,74,-39,Severe
12,4,148,M,28,6,8,80,-68,Severe
18,5,221,M,48,8,1,97,-124,Severe
7,6,90,F,109,14,1,169,79,Well
16,5,197,F,100,13,3,159,-38,Severe
11,7,139,M,53,8,6,102,-37,Severe
9,5,113,F,39,7,5,89,-24,Severe
17,0,204,F,7,5,6,66,-138,Severe
7,3,87,M,85,11,9,141,54,Well
8,10,106,M,68,10,0,120,14,Well
9,1,109,F,77,10,11,131,22,Well
9,10,118,F,98,13,0,156,38,Well
10,8,128,M,76,10,10,130,2,Good
9,6,114,M,55,8,8,104,-10,Severe
8,4,100,M,35,7,1,85,-15,Severe
13,5,161,F,23,6,4,76,-85,Severe
9,3,111,F,14,5,10,70,-41,Severe
10,4,124,M,47,8,0,96,-28,Severe
6,8,80,F,83,11,6,138,58,Well
8,5,101,M,4,5,4,64,-37,Severe
18,6,222,M,47,8,0,96,-126,Severe
10,0,120,M,74,10,7,127,7,Well
17,7,211,M,69,10,1,121,-90,Severe
15,3,183,M,100,13,3,159,-24,Severe
12,1,145,M,58,9,0,108,-37,Severe
14,0,168,F,88,12,0,144,-24,Severe
6,2,74,F,46,7,11,95,21,Well
8,9,105,F,25,6,5,77,-28,Severe
11,10,142,M,83,11,6,138,-4,Mild
11,11,143,M,55,8,8,104,-39,Severe
15,10,190,F,60,9,2,110,-80,Severe
17,8,212,F,40,7,5,89,-123,Severe
15,9,189,M,13,5,9,69,-120,Severe
15,2,182,F,102,13,6,162,-20,Severe
7,8,92,M,4,5,4,64,-28,Severe
13,4,160,F,46,7,11,95,-65,Severe
5,9,69,M,72,10,4,124,55,Well
17,7,211,M,40,7,5,89,-122,Severe
14,6,174,M,32,6,10,82,-92,Severe
15,6,186,M,94,12,7,151,-35,Severe
17,5,209,F,34,7,0,84,-125,Severe
15,2,182,M,56,8,9,105,-77,Severe
17,2,206,F,77,10,11,131,-75,Severe
13,7,163,M,63,9,6,114,-49,Severe
5,10,70,M,53,8,6,102,32,Well
12,3,147,F,24,6,5,77,-70,Severe
17,3,207,F,15,5,11,71,-136,Severe
5,8,68,F,96,12,10,154,86,Well
13,5,161,F,93,12,6,150,-11,Severe
16,1,193,M,48,8,1,97,-96,Severe
6,0,72,F,96,12,10,154,82,Well
17,7,211,M,83,11,6,138,-73,Severe
11,3,135,M,69,10,1,121,-14,Severe
12,9,153,F,24,6,5,77,-76,Severe
15,0,180,F,110,14,3,171,-9,Severe
16,11,203,M,57,8,10,106,-97,Severe
15,3,183,M,7,5,6,66,-117,Severe
7,4,88,F,96,12,10,154,66,Well
9,3,111,M,29,6,8,80,-31,Severe
14,0,168,F,82,11,5,137,-31,Severe
12,10,154,F,58,9,0,108,-46,Severe
12,10,154,M,73,10,6,126,-28,Severe
15,5,185,F,28,6,8,80,-105,Severe
8,9,105,F,11,5,8,68,-37,Severe
5,0,60,M,68,10,0,120,60,Well
15,7,187,M,23,6,4,76,-111,Severe
15,8,188,F,17,6,0,72,-116,Severe
8,4,100,M,62,9,4,112,12,Well
5,3,63,M,14,5,10,70,7,Well
12,3,147,M,34,7,0,84,-63,Severe
17,3,207,M,9,5,7,67,-140,Severe
13,6,162,F,68,10,0,120,-42,Severe
9,5,113,M,87,11,11,143,30,Well
5,7,67,F,17,6,0,72,5,Good
5,10,70,F,39,7,5,89,19,Well
9,3,111,M,42,7,7,91,-20,Severe
15,6,186,M,108,14,0,168,-18,Severe
9,11,119,M,82,11,5,137,18,Well
16,11,203,F,100,13,3,159,-44,Severe
6,1,73,M,83,11,6,138,65,Well
18,1,217,M,20,6,2,74,-143,Severe
8,2,98,M,105,13,9,165,67,Well
12,3,147,M,47,8,0,96,-51,Severe
13,8,164,M,98,13,0,156,-8,Severe
13,9,165,F,85,11,9,141,-24,Severe
16,3,195,F,18,6,1,73,-122,Severe
5,0,60,M,79,11,1,133,73,Well
8,8,104,M,79,11,1,133,29,Well
15,3,183,M,77,10,11,131,-52,Severe
13,0,156,F,26,6,6,78,-78,Severe
7,9,93,F,74,10,7,127,34,Well
17,9,213,M,33,6,11,83,-130,Severe
14,5,173,F,37,7,3,87,-86,Severe
12,11,155,M,17,6,0,72,-83,Severe
11,9,141,F,72,10,4,124,-17,Severe
11,5,137,F,100,13,3,159,22,Well
12,2,146,F,81,11,4,136,-10,Severe
16,3,195,F,91,12,4,148,-47,Severe
18,10,226,F,88,12,0,144,-82,Severe
17,7,211,F,95,12,9,153,-58,Severe
10,1,121,F,84,11,7,139,18,Well
16,10,202,M,51,8,4,100,-102,Severe
8,6,102,F,55,8,8,104,2,Good
14,5,173,M,54,8,7,103,-70,Severe
9,3,111,F,29,6,8,80,-31,Severe
18,1,217,M,107,13,11,167,-50,Severe
7,3,87,F,102,13,6,162,75,Well
11,10,142,F,63,9,6,114,-28,Severe
13,3,159,F,63,9,6,114,-45,Severe
7,3,87,F,12,5,9,69,-18,Severe
15,5,185,F,21,6,2,74,-111,Severe
11,3,135,M,102,13,6,162,27,Well
16,9,201,M,71,10,3,123,-78,Severe
8,0,96,F,8,5,6,66,-30,Severe
5,6,66,M,24,6,5,77,11,Well
14,5,173,M,40,7,5,89,-84,Severe
8,3,99,F,66,9,9,117,18,Well
18,10,226,M,87,11,11,143,-83,Severe
5,11,71,M,3,5,3,63,-8,Severe
7,0,84,F,37,7,3,87,3,Good
13,10,166,F,99,13,1,157,-9,Severe
6,8,80,F,29,6,8,80,0,Neutral
17,8,212,M,104,13,7,163,-49,Severe
9,10,118,M,55,8,8,104,-14,Severe
14,3,171,F,101,13,4,160,-11,Severe
9,11,119,F,83,11,6,138,19,Well
7,4,88,M,97,12,11,155,67,Well
11,7,139,M,89,12,1,145,6,Well
5,8,68,F,79,11,1,133,65,Well
18,0,216,F,63,9,6,114,-102,Severe
7,8,92,F,76,10,10,130,38,Well
7,6,90,M,27,6,7,79,-11,Severe
15,8,188,F,36,7,2,86,-102,Severe
8,7,103,M,14,5,10,70,-33,Severe
18,4,220,M,45,7,10,94,-126,Severe
5,5,65,M,76,10,10,130,65,Well
12,6,150,F,72,10,4,124,-26,Severe
10,9,129,F,81,11,4,136,7,Well
16,10,202,F,34,7,0,84,-118,Severe
18,10,226,F,54,8,7,103,-123,Severe
8,3,99,F,104,13,7,163,64,Well
11,8,140,F,21,6,2,74,-66,Severe
16,2,194,F,52,8,5,101,-93,Severe
8,7,103,M,60,9,2,110,7,Well
14,1,169,M,55,8,8,104,-65,Severe
8,3,99,M,6,5,5,65,-34,Severe
13,4,160,M,64,9,7,115,-45,Severe
7,9,93,M,46,7,11,95,2,Good
16,8,200,F,98,13,0,156,-44,Severe
9,6,114,M,58,9,0,108,-6,Severe
7,3,87,F,104,13,7,163,76,Well
15,9,189,F,95,12,9,153,-36,Severe
7,2,86,F,100,13,3,159,73,Well
9,0,108,M,18,6,1,73,-35,Severe
9,5,113,M,61,9,3,111,-2,Mild
8,8,104,M,110,14,3,171,67,Well
6,11,83,F,46,7,11,95,12,Well
15,10,190,M,70,10,2,122,-68,Severe
8,3,99,F,43,7,8,92,-7,Severe
12,3,147,F,42,7,7,91,-56,Severe
7,2,86,M,6,5,5,65,-21,Severe
10,3,123,M,97,12,11,155,32,Well
14,1,169,F,82,11,5,137,-32,Severe
16,9,201,M,92,12,5,149,-52,Severe
15,1,181,F,54,8,7,103,-78,Severe
16,8,200,M,88,12,0,144,-56,Severe
8,7,103,F,106,13,10,166,63,Well
14,6,174,F,48,8,1,97,-77,Severe
5,2,62,F,95,12,9,153,91,Well
11,3,135,M,23,6,4,76,-59,Severe
11,1,133,M,25,6,5,77,-56,Severe
12,10,154,M,71,10,3,123,-31,Severe
15,0,180,M,101,13,4,160,-20,Severe
13,1,157,F,10,5,7,67,-90,Severe
17,1,205,M,76,10,10,130,-75,Severe
17,10,214,M,100,13,3,159,-55,Severe
5,3,63,F,85,11,9,141,78,Well
13,3,159,F,83,11,6,138,-21,Severe
17,9,213,M,21,6,2,74,-139,Severe
12,9,153,M,99,13,1,157,4,Good
10,9,129,M,6,5,5,65,-64,Severe
7,8,92,M,89,12,1,145,53,Well
13,9,165,F,9,5,7,67,-98,Severe
7,5,89,F,8,5,6,66,-23,Severe
5,3,63,F,60,9,2,110,47,Well
6,11,83,F,15,5,11,71,-12,Severe
8,11,107,M,19,6,1,73,-34,Severe
9,6,114,F,59,9,1,109,-5,Mild
13,11,167,M,23,6,4,76,-91,Severe
6,7,79,F,75,10,9,129,50,Well
5,4,64,F,77,10,11,131,67,Well
17,0,204,M,46,7,11,95,-109,Severe
12,11,155,M,26,6,6,78,-77,Severe
13,1,157,M,77,10,11,131,-26,Severe
12,2,146,F,76,10,10,130,-16,Severe
7,7,91,M,48,8,1,97,6,Well
12,3,147,F,109,14,1,169,22,Well
12,8,152,M,103,13,6,162,10,Well
15,0,180,M,52,8,5,101,-79,Severe
8,11,107,F,102,13,6,162,55,Well
12,0,144,F,17,6,0,72,-72,Severe
13,7,163,F,50,8,3,99,-64,Severe
6,5,77,M,70,10,2,122,45,Well
11,0,132,F,7,5,6,66,-66,Severe
15,9,189,F,9,5,7,67,-122,Severe
12,5,149,M,91,12,4,148,-1,Mild
5,10,70,M,82,11,5,137,67,Well
6,3,75,M,5,5,5,65,-10,Severe
12,1,145,M,70,10,2,122,-23,Severe
11,0,132,F,101,13,4,160,28,Well
13,4,160,F,110,14,3,171,11,Well
18,3,219,M,33,6,11,83,-136,Severe
14,6,174,M,50,8,3,99,-75,Severe
6,10,82,F,12,5,9,69,-13,Severe
14,10,178,M,10,5,7,67,-111,Severe
16,6,198,F,37,7,3,87,-111,Severe
5,3,63,M,40,7,5,89,26,Well
6,2,74,M,64,9,7,115,41,Well
5,3,63,M,50,8,3,99,36,Well
18,3,219,M,77,10,11,131,-88,Severe
10,8,128,M,99,13,1,157,29,Well
13,4,160,M,40,7,5,89,-71,Severe
15,9,189,F,69,10,1,121,-68,Severe
8,8,104,F,9,5,7,67,-37,Severe
12,2,146,M,61,9,3,111,-35,Severe
12,2,146,F,70,10,2,122,-24,Severe
13,2,158,M,51,8,4,100,-58,Severe
11,10,142,F,30,6,9,81,-61,Severe
8,1,97,M,71,10,3,123,26,Well
10,4,124,F,53,8,6,102,-22,Severe
7,8,92,M,47,8,0,96,4,Good
11,11,143,M,106,13,10,166,23,Well
9,2,110,F,80,11,3,135,25,Well
17,3,207,M,76,10,10,130,-77,Severe
18,6,222,F,23,6,4,76,-146,Severe
18,9,225,F,56,8,9,105,-120,Severe
7,8,92,M,14,5,10,70,-22,Severe
15,3,183,M,20,6,2,74,-109,Severe
11,11,143,M,21,6,2,74,-69,Severe
6,9,81,M,19,6,1,73,-8,Severe
11,3,135,F,92,12,5,149,14,Well
14,3,171,F,28,6,8,80,-91,Severe
13,10,166,M,64,9,7,115,-51,Severe
16,5,197,F,42,7,7,91,-106,Severe
18,10,226,M,74,10,7,127,-99,Severe
13,2,158,M,25,6,5,77,-81,Severe
7,10,94,F,65,9,8,116,22,Well
14,2,170,M,48,8,1,97,-73,Severe
7,3,87,M,96,12,10,154,67,Well
7,1,85,F,69,10,1,121,36,Well
9,3,111,F,77,10,11,131,20,Well
11,5,137,M,38,7,4,88,-49,Severe
11,3,135,F,86,11,10,142,7,Well
15,3,183,M,78,11,0,132,-51,Severe
16,0,192,M,76,10,10,130,-62,Severe
8,3,99,F,100,13,3,159,60,Well
17,3,207,M,23,6,4,76,-131,Severe
17,6,210,M,22,6,3,75,-135,Severe
10,0,120,M,43,7,8,92,-28,Severe
13,0,156,M,5,5,5,65,-91,Severe
7,10,94,F,80,11,3,135,41,Well
9,7,115,F,24,6,5,77,-38,Severe
14,9,177,M,46,7,11,95,-82,Severe
8,2,98,F,46,7,11,95,-3,Mild
7,11,95,M,59,9,1,109,14,Well
5,10,70,F,60,9,2,110,40,Well
16,2,194,F,48,8,1,97,-97,Severe
12,2,146,M,109,14,1,169,23,Well
17,2,206,F,74,10,7,127,-79,Severe
6,5,77,M,57,8,10,106,29,Well
18,7,223,F,68,10,0,120,-103,Severe
9,10,118,M,35,7,1,85,-33,Severe
16,3,195,F,38,7,4,88,-107,Severe
10,2,122,M,45,7,10,94,-28,Severe
12,11,155,F,107,13,11,167,12,Well
16,7,199,F,40,7,5,89,-110,Severe
5,11,71,M,97,12,11,155,84,Well
8,4,100,M,39,7,5,89,-11,Severe
11,2,134,F,10,5,7,67,-67,Severe
16,6,198,F,51,8,4,100,-98,Severe
16,11,203,M,29,6,8,80,-123,Severe
18,3,219,F,35,7,1,85,-134,Severe
6,7,79,M,96,12,10,154,75,Well
14,3,171,M,72,10,4,124,-47,Severe
13,3,159,F,55,8,8,104,-55,Severe
14,1,169,F,59,9,1,109,-60,Severe
18,1,217,F,52,8,5,101,-116,Severe
16,1,193,F,31,6,9,81,-112,Severe
13,3,159,F,54,8,7,103,-56,Severe
15,3,183,F,6,5,5,65,-118,Severe
15,11,191,M,65,9,8,116,-75,Severe
13,6,162,F,70,10,2,122,-40,Severe
15,2,182,M,100,13,3,159,-23,Severe
16,2,194,F,58,9,0,108,-86,Severe
11,3,135,F,17,6,0,72,-63,Severe
14,5,173,F,70,10,2,122,-51,Severe
11,8,140,F,8,5,6,66,-74,Severe
16,8,200,M,12,5,9,69,-131,Severe
17,4,208,F,82,11,5,137,-71,Severe
10,1,121,F,30,6,9,81,-40,Severe
12,5,149,M,57,8,10,106,-43,Severe
15,4,184,M,45,7,10,94,-90,Severe
5,11,71,M,94,12,7,151,80,Well
16,11,203,M,47,8,0,96,-107,Severe
6,8,80,M,65,9,8,116,36,Well
7,1,85,M,54,8,7,103,18,Well
10,8,128,M,107,13,11,167,39,Well
7,10,94,M,31,6,9,81,-13,Severe
7,5,89,F,25,6,5,77,-12,Severe
5,3,63,F,93,12,6,150,87,Well
16,11,203,F,53,8,6,102,-101,Severe
16,6,198,M,90,12,3,147,-51,Severe
12,10,154,F,39,7,5,89,-65,Severe
18,8,224,M,48,8,1,97,-127,Severe
8,10,106,F,84,11,7,139,33,Well
16,7,199,F,21,6,2,74,-125,Severe
8,3,99,M,7,5,6,66,-33,Severe
9,3,111,M,95,12,9,153,42,Well
7,11,95,M,95,12,9,153,58,Well
7,5,89,F,21,6,2,74,-15,Severe
5,6,66,M,70,10,2,122,56,Well
18,8,224,F,56,8,9,105,-119,Severe
10,4,124,F,80,11,3,135,11,Well
12,3,147,M,65,9,8,116,-31,Severe
17,9,213,M,27,6,7,79,-134,Severe
14,1,169,F,55,8,8,104,-65,Severe
15,3,183,M,17,6,0,72,-111,Severe
10,1,121,M,101,13,4,160,39,Well
10,10,130,F,10,5,7,67,-63,Severe
12,9,153,M,38,7,4,88,-65,Severe
11,7,139,M,109,14,1,169,30,Well
9,10,118,F,78,11,0,132,14,Well
18,5,221,F,30,6,9,81,-140,Severe
18,4,220,M,12,5,9,69,-151,Severe
8,9,105,F,65,9,8,116,11,Well
6,6,78,F,58,9,0,108,30,Well
16,8,200,F,109,14,1,169,-31,Severe
5,3,63,M,44,7,9,93,30,Well
15,2,182,M,101,13,4,160,-22,Severe
11,10,142,F,23,6,4,76,-66,Severe
14,10,178,M,110,14,3,171,-7,Severe
18,3,219,F,94,12,7,151,-68,Severe
15,2,182,M,68,10,0,120,-62,Severe
5,7,67,F,3,5,3,63,-4,Mild
17,4,208,M,101,13,4,160,-48,Severe
12,1,145,F,43,7,8,92,-53,Severe
5,11,71,F,97,12,11,155,84,Well
8,6,102,M,49,8,2,98,-4,Mild
7,0,84,M,16,5,11,71,-13,Severe
11,9,141,F,8,5,6,66,-75,Severe
15,6,186,M,61,9,3,111,-75,Severe
7,7,91,M,26,6,6,78,-13,Severe
17,11,215,M,28,6,8,80,-135,Severe
10,11,131,F,39,7,5,89,-42,Severe
8,2,98,F,60,9,2,110,12,Well
11,8,140,M,58,9,0,108,-32,Severe
5,5,65,M,37,7,3,87,22,Well
6,1,73,F,42,7,7,91,18,Well
14,2,170,M,96,12,10,154,-16,Severe
12,10,154,M,97,12,11,155,1,Good
14,2,170,F,79,11,1,133,-37,Severe
11,10,142,F,36,7,2,86,-56,Severe
12,11,155,F,44,7,9,93,-62,Severe
13,8,164,M,105,13,9,165,1,Good
6,7,79,M,57,8,10,106,27,Well
7,1,85,M,30,6,9,81,-4,Mild
17,7,211,M,27,6,7,79,-132,Severe
10,8,128,F,73,10,6,126,-2,Mild
12,6,150,F,88,12,0,144,-6,Severe
7,5,89,F,76,10,10,130,41,Well
9,10,118,F,55,8,8,104,-14,Severe
17,5,209,M,17,6,0,72,-137,Severe
5,11,71,M,15,5,11,71,0,Neutral
12,3,147,F,81,11,4,136,-11,Severe
6,6,78,M,64,9,7,115,37,Well
7,7,91,M,47,8,0,96,5,Good
5,7,67,F,74,10,7,127,60,Well
6,0,72,F,9,5,7,67,-5,Mild
15,7,187,F,74,10,7,127,-60,Severe
18,1,217,F,64,9,7,115,-102,Severe
9,8,116,M,93,12,6,150,34,Well
15,3,183,F,109,14,1,169,-14,Severe
9,11,119,F,86,11,10,142,23,Well
8,1,97,F,66,9,9,117,20,Well
7,10,94,M,65,9,8,116,22,Well
6,7,79,F,53,8,6,102,23,Well
8,3,99,F,95,12,9,153,54,Well
8,10,106,F,22,6,3,75,-31,Severe
11,2,134,M,58,9,0,108,-26,Severe
12,11,155,M,62,9,4,112,-43,Severe
9,5,113,F,101,13,4,160,47,Well
15,7,187,M,51,8,4,100,-87,Severe
8,1,97,M,79,11,1,133,36,Well
7,3,87,F,44,7,9,93,6,Well
16,6,198,M,39,7,5,89,-109,Severe
6,3,75,F,91,12,4,148,73,Well
5,9,69,F,36,7,2,86,17,Well
15,0,180,M,64,9,7,115,-65,Severe
12,5,149,M,66,9,9,117,-32,Severe
16,7,199,F,2,5,3,63,-136,Severe
18,6,222,M,16,5,11,71,-151,Severe
9,6,114,M,103,13,6,162,48,Well
16,11,203,F,50,8,3,99,-104,Severe
16,2,194,M,33,6,11,83,-111,Severe
16,8,200,F,51,8,4,100,-100,Severe
5,6,66,F,56,8,9,105,39,Well
8,7,103,F,11,5,8,68,-35,Severe
9,6,114,M,17,6,0,72,-42,Severe
17,1,205,F,21,6,2,74,-131,Severe
10,4,124,F,98,13,0,156,32,Well
15,7,187,F,84,11,7,139,-48,Severe
6,4,76,M,71,10,3,123,47,Well
13,4,160,F,31,6,9,81,-79,Severe
7,3,87,M,24,6,5,77,-10,Severe
13,8,164,M,48,8,1,97,-67,Severe
11,1,133,M,64,9,7,115,-18,Severe
9,6,114,F,33,6,11,83,-31,Severe
6,5,77,F,9,5,7,67,-10,Severe
16,1,193,F,93,12,6,150,-43,Severe
18,3,219,F,29,6,8,80,-139,Severe
5,3,63,M,79,11,1,133,70,Well
9,1,109,M,83,11,6,138,29,Well
8,8,104,M,93,12,6,150,46,Well
15,0,180,M,16,5,11,71,-109,Severe
9,2,110,M,25,6,5,77,-33,Severe
5,1,61,M,74,10,7,127,66,Well
18,9,225,M,32,6,10,82,-143,Severe
11,11,143,F,38,7,4,88,-55,Severe
10,9,129,M,8,5,6,66,-63,Severe
10,5,125,M,24,6,5,77,-48,Severe
11,0,132,M,98,13,0,156,24,Well
14,10,178,F,23,6,4,76,-102,Severe
7,6,90,F,77,10,11,131,41,Well
10,4,124,F,27,6,7,79,-45,Severe
8,3,99,M,25,6,5,77,-22,Severe
7,7,91,F,101,13,4,160,69,Well
14,3,171,M,106,13,10,166,-5,Mild
7,11,95,M,22,6,3,75,-20,Severe
7,4,88,M,52,8,5,101,13,Well
6,9,81,F,108,14,0,168,87,Well
6,3,75,F,23,6,4,76,1,Good
7,5,89,M,12,5,9,69,-20,Severe
16,2,194,M,49,8,2,98,-96,Severe
6,6,78,F,99,13,1,157,79,Well
16,4,196,M,106,13,10,166,-30,Severe
13,11,167,M,52,8,5,101,-66,Severe
15,7,187,F,63,9,6,114,-73,Severe
5,11,71,F,53,8,6,102,31,Well
8,9,105,M,12,5,9,69,-36,Severe
6,3,75,F,21,6,2,74,-1,Mild
5,10,70,F,66,9,9,117,47,Well
7,3,87,M,59,9,1,109,22,Well
7,1,85,F,15,5,11,71,-14,Severe
17,10,214,M,49,8,2,98,-116,Severe
5,2,62,M,41,7,6,90,28,Well
15,4,184,M,78,11,0,132,-52,Severe
5,5,65,F,50,8,3,99,34,Well
18,6,222,F,80,11,3,135,-87,Severe
18,3,219,F,6,5,5,65,-154,Severe
5,7,67,M,46,7,11,95,28,Well
11,9,141,M,55,8,8,104,-37,Severe
9,4,112,M,68,10,0,120,8,Well
18,2,218,F,92,12,5,149,-69,Severe
12,2,146,F,47,8,0,96,-50,Severe
7,6,90,F,83,11,6,138,48,Well
10,4,124,M,84,11,7,139,15,Well
7,3,87,M,15,5,11,71,-16,Severe
8,11,107,F,45,7,10,94,-13,Severe
18,9,225,M,81,11,4,136,-89,Severe
15,2,182,M,37,7,3,87,-95,Severe
10,11,131,M,103,13,6,162,31,Well
16,7,199,F,49,8,2,98,-101,Severe
17,7,211,F,46,7,11,95,-116,Severe
18,3,219,M,77,10,11,131,-88,Severe
10,10,130,F,83,11,6,138,8,Well
10,7,127,M,20,6,2,74,-53,Severe
6,1,73,M,35,7,1,85,12,Well
8,11,107,M,80,11,3,135,28,Well
14,7,175,F,21,6,2,74,-101,Severe
5,10,70,M,98,13,0,156,86,Well
14,3,171,F,72,10,4,124,-47,Severe
6,1,73,M,92,12,5,149,76,Well
12,3,147,F,46,7,11,95,-52,Severe
6,1,73,M,31,6,9,81,8,Well
5,6,66,M,56,8,9,105,39,Well
18,3,219,M,66,9,9,117,-102,Severe
14,11,179,F,62,9,4,112,-67,Severe
6,9,81,M,11,5,8,68,-13,Severe
10,6,126,F,32,6,10,82,-44,Severe
11,2,134,F,86,11,10,142,8,Well
10,6,126,M,65,9,8,116,-10,Severe
7,8,92,F,61,9,3,111,19,Well
11,11,143,F,26,6,6,78,-65,Severe
13,3,159,M,102,13,6,162,3,Good
10,1,121,F,21,6,2,74,-47,Severe
8,3,99,F,3,5,3,63,-36,Severe
5,9,69,F,15,5,11,71,2,Good
9,2,110,F,91,12,4,148,38,Well
10,3,123,M,31,6,9,81,-42,Severe
17,3,207,F,10,5,7,67,-140,Severe
11,9,141,M,83,11,6,138,-3,Mild
11,5,137,F,106,13,10,166,29,Well
13,10,166,F,70,10,2,122,-44,Severe
14,7,175,F,19,6,1,73,-102,Severe
10,4,124,M,15,5,11,71,-53,Severe
10,9,129,M,18,6,1,73,-56,Severe
12,2,146,F,46,7,11,95,-51,Severe
17,2,206,F,60,9,2,110,-96,Severe
5,6,66,M,72,10,4,124,58,Well
7,2,86,F,72,10,4,124,38,Well
14,0,168,M,72,10,4,124,-44,Severe
9,8,116,M,39,7,5,89,-27,Severe
14,3,171,M,23,6,4,76,-95,Severe
9,0,108,M,52,8,5,101,-7,Severe
12,5,149,M,86,11,10,142,-7,Severe
18,7,223,F,52,8,5,101,-122,Severe
16,2,194,M,40,7,5,89,-105,Severe
11,3,135,F,76,10,10,130,-5,Mild
14,8,176,M,34,7,0,84,-92,Severe
12,0,144,M,48,8,1,97,-47,Severe
7,7,91,F,51,8,4,100,9,Well
7,5,89,M,13,5,9,69,-20,Severe
16,10,202,M,87,11,11,143,-59,Severe
12,8,152,M,60,9,2,110,-42,Severe
15,0,180,M,90,12,3,147,-33,Severe
5,10,70,F,46,7,11,95,25,Well
5,8,68,F,30,6,9,81,13,Well
7,11,95,F,74,10,7,127,32,Well
16,5,197,M,22,6,3,75,-122,Severe
16,1,193,M,15,5,11,71,-122,Severe
16,2,194,F,36,7,2,86,-108,Severe
7,3,87,M,50,8,3,99,12,Well
9,8,116,M,4,5,4,64,-52,Severe
13,11,167,M,32,6,10,82,-85,Severe
14,7,175,F,16,5,11,71,-104,Severe
10,4,124,F,64,9,7,115,-9,Severe
6,10,82,F,4,5,4,64,-18,Severe
18,8,224,F,15,5,11,71,-153,Severe
6,3,75,M,16,5,11,71,-4,Mild
16,3,195,M,32,6,10,82,-113,Severe
7,8,92,F,36,7,2,86,-6,Severe
13,11,167,F,96,12,10,154,-13,Severe
16,11,203,F,95,12,9,153,-50,Severe
11,4,136,F,49,8,2,98,-38,Severe
6,10,82,F,57,8,10,106,24,Well
18,2,218,M,28,6,8,80,-138,Severe
11,7,139,F,13,5,9,69,-70,Severe
13,7,163,M,66,9,9,117,-46,Severe
18,8,224,F,102,13,6,162,-62,Severe
18,10,226,M,69,10,1,121,-105,Severe
14,9,177,M,78,11,0,132,-45,Severe
8,10,106,M,85,11,9,141,35,Well
16,1,193,M,92,12,5,149,-44,Severe
12,2,146,M,2,5,3,63,-83,Severe
5,8,68,F,32,6,10,82,14,Well
8,8,104,M,103,13,6,162,58,Well
6,2,74,F,30,6,9,81,7,Well
17,11,215,F,81,11,4,136,-79,Severe
8,6,102,M,50,8,3,99,-3,Mild
8,9,105,F,19,6,1,73,-32,Severe
9,10,118,M,18,6,1,73,-45,Severe
5,5,65,F,90,12,3,147,82,Well
9,0,108,M,91,12,4,148,40,Well
6,8,80,M,76,10,10,130,50,Well
13,5,161,M,18,6,1,73,-88,Severe
9,9,117,F,88,12,0,144,27,Well
14,9,177,M,43,7,8,92,-85,Severe
5,1,61,F,99,13,1,157,96,Well
18,1,217,M,60,9,2,110,-107,Severe
16,5,197,F,48,8,1,97,-100,Severe
15,5,185,M,47,8,0,96,-89,Severe
8,7,103,M,32,6,10,82,-21,Severe
17,5,209,M,14,5,10,70,-139,Severe
10,5,125,F,91,12,4,148,23,Well
9,8,116,M,90,12,3,147,31,Well
13,7,163,M,39,7,5,89,-74,Severe
5,7,67,F,77,10,11,131,64,Well
7,5,89,M,56,8,9,105,16,Well
17,2,206,F,11,5,8,68,-138,Severe
8,0,96,F,82,11,5,137,41,Well
7,4,88,F,15,5,11,71,-17,Severe
15,11,191,M,44,7,9,93,-98,Severe
12,0,144,F,7,5,6,66,-78,Severe
17,0,204,M,110,14,3,171,-33,Severe
7,11,95,M,44,7,9,93,-2,Mild
12,8,152,M,96,12,10,154,2,Good
5,3,63,F,3,5,3,63,0,Neutral
12,0,144,M,59,9,1,109,-35,Severe
7,0,84,F,86,11,10,142,58,Well
5,10,70,F,27,6,7,79,9,Well
5,7,67,F,35,7,1,85,18,Well
12,2,146,F,106,13,10,166,20,Well
13,3,159,M,31,6,9,81,-78,Severe
12,9,153,F,110,14,3,171,18,Well
14,9,177,M,102,13,6,162,-15,Severe
8,0,96,F,20,6,2,74,-22,Severe
17,8,212,M,31,6,9,81,-131,Severe
16,1,193,F,77,10,11,131,-62,Severe
8,0,96,M,18,6,1,73,-23,Severe
17,11,215,F,9,5,7,67,-148,Severe
12,3,147,F,58,9,0,108,-39,Severe
11,3,135,F,41,7,6,90,-45,Severe
12,10,154,M,39,7,5,89,-65,Severe
12,8,152,F,20,6,2,74,-78,Severe
11,7,139,F,93,12,6,150,11,Well
7,0,84,M,99,13,1,157,73,Well
8,8,104,F,94,12,7,151,47,Well
9,10,118,M,76,10,10,130,12,Well
5,5,65,F,4,5,4,64,-1,Mild
9,3,111,F,44,7,9,93,-18,Severe
14,9,177,M,65,9,8,116,-61,Severe
10,0,120,M,32,6,10,82,-38,Severe
10,0,120,M,14,5,10,70,-50,Severe
14,4,172,F,70,10,2,122,-50,Severe
11,9,141,F,61,9,3,111,-30,Severe
14,0,168,M,20,6,2,74,-94,Severe
8,6,102,M,6,5,5,65,-37,Severe
18,11,227,F,37,7,3,87,-140,Severe
18,11,227,F,81,11,4,136,-91,Severe
15,3,183,M,84,11,7,139,-44,Severe
18,10,226,F,32,6,10,82,-144,Severe
7,7,91,M,107,13,11,167,76,Well
9,6,114,M,42,7,7,91,-23,Severe
15,8,188,M,104,13,7,163,-25,Severe
17,9,213,F,7,5,6,66,-147,Severe
6,6,78,M,107,13,11,167,89,Well
7,3,87,M,39,7,5,89,2,Good
7,8,92,M,39,7,5,89,-3,Mild
11,6,138,F,55,8,8,104,-34,Severe
6,3,75,F,93,12,6,150,75,Well
13,1,157,M,100,13,3,159,2,Good
11,7,139,F,38,7,4,88,-51,Severe
8,11,107,M,68,10,0,120,13,Well
12,5,149,F,63,9,6,114,-35,Severe
18,0,216,M,2,5,3,63,-153,Severe
13,2,158,M,28,6,8,80,-78,Severe
13,8,164,F,52,8,5,101,-63,Severe
13,10,166,M,101,13,4,160,-6,Severe
8,4,100,F,15,5,11,71,-29,Severe
18,0,216,F,92,12,5,149,-67,Severe
7,6,90,M,44,7,9,93,3,Good
6,2,74,M,66,9,9,117,43,Well
5,11,71,M,35,7,1,85,14,Well
9,3,111,F,75,10,9,129,18,Well
9,11,119,F,10,5,7,67,-52,Severe
10,9,129,M,99,13,1,157,28,Well
9,0,108,M,35,7,1,85,-23,Severe
14,0,168,F,9,5,7,67,-101,Severe
14,2,170,F,101,13,4,160,-10,Severe
18,4,220,M,89,12,1,145,-75,Severe
6,9,81,M,61,9,3,111,30,Well
12,1,145,F,89,12,1,145,0,Neutral
12,7,151,F,70,10,2,122,-29,Severe
12,1,145,M,5,5,5,65,-80,Severe
17,0,204,F,55,8,8,104,-100,Severe
15,5,185,F,49,8,2,98,-87,Severe
18,4,220,M,6,5,5,65,-155,Severe
10,6,126,M,72,10,4,124,-2,Mild
6,4,76,M,83,11,6,138,62,Well
18,8,224,M,13,5,9,69,-155,Severe
7,10,94,M,39,7,5,89,-5,Mild
13,3,159,F,67,9,10,118,-41,Severe
13,6,162,M,16,5,11,71,-91,Severe
13,10,166,M,72,10,4,124,-42,Severe
12,2,146,M,22,6,3,75,-71,Severe
6,5,77,M,98,13,0,156,79,Well
7,11,95,F,107,13,11,167,72,Well
11,11,143,M,36,7,2,86,-57,Severe
6,2,74,M,59,9,1,109,35,Well
6,6,78,F,73,10,6,126,48,Well
11,4,136,F,110,14,3,171,35,Well
18,5,221,M,86,11,10,142,-79,Severe
14,3,171,F,91,12,4,148,-23,Severe
9,0,108,M,102,13,6,162,54,Well
6,0,72,M,40,7,5,89,17,Well
14,8,176,M,65,9,8,116,-60,Severe
13,5,161,F,79,11,1,133,-28,Severe
5,8,68,M,51,8,4,100,32,Well
13,8,164,F,80,11,3,135,-29,Severe
8,0,96,F,85,11,9,141,45,Well
17,5,209,F,67,9,10,118,-91,Severe
5,8,68,M,53,8,6,102,34,Well
18,6,222,F,6,5,5,65,-157,Severe
15,7,187,M,19,6,1,73,-114,Severe
16,3,195,M,34,7,0,84,-111,Severe
9,8,116,F,30,6,9,81,-35,Severe
7,4,88,M,7,5,6,66,-22,Severe
8,7,103,F,40,7,5,89,-14,Severe
9,6,114,M,5,5,5,65,-49,Severe
16,3,195,M,81,11,4,136,-59,Severe
7,8,92,M,69,10,1,121,29,Well
14,7,175,M,53,8,6,102,-73,Severe
17,4,208,M,31,6,9,81,-127,Severe
16,10,202,M,63,9,6,114,-88,Severe
16,2,194,F,47,8,0,96,-98,Severe
7,2,86,F,110,14,3,171,85,Well
9,0,108,F,80,11,3,135,27,Well
9,10,118,M,72,10,4,124,6,Well
9,8,116,F,48,8,1,97,-19,Severe
8,2,98,F,102,13,6,162,64,Well
11,11,143,F,5,5,5,65,-78,Severe
13,4,160,F,9,5,7,67,-93,Severe
12,8,152,M,91,12,4,148,-4,Mild
11,8,140,M,62,9,4,112,-28,Severe
7,3,87,F,89,12,1,145,58,Well
8,10,106,F,93,12,6,150,44,Well
14,2,170,F,83,11,6,138,-32,Severe
9,3,111,M,58,9,0,108,-3,Mild
5,9,69,F,60,9,2,110,41,Well
18,4,220,F,90,12,3,147,-73,Severe
12,3,147,M,106,13,10,166,19,Well
7,4,88,M,78,11,0,132,44,Well
6,3,75,M,80,11,3,135,60,Well
16,8,200,F,104,13,7,163,-37,Severe
11,7,139,F,82,11,5,137,-2,Mild
7,2,86,M,45,7,10,94,8,Well
13,5,161,M,23,6,4,76,-85,Severe
13,1,157,M,25,6,5,77,-80,Severe
16,11,203,M,78,11,0,132,-71,Severe
10,1,121,F,28,6,8,80,-41,Severe
8,3,99,M,38,7,4,88,-11,Severe
14,3,171,F,3,5,3,63,-108,Severe
12,8,152,M,89,12,1,145,-7,Severe
18,1,217,M,15,5,11,71,-146,Severe
10,3,123,M,31,6,9,81,-42,Severe
14,4,172,F,5,5,5,65,-107,Severe
9,6,114,M,10,5,7,67,-47,Severe
12,0,144,M,92,12,5,149,5,Good
6,0,72,F,58,9,0,108,36,Well
13,7,163,M,59,9,1,109,-54,Severe
6,4,76,F,84,11,7,139,63,Well
17,10,214,M,9,5,7,67,-147,Severe
13,0,156,F,66,9,9,117,-39,Severe
13,2,158,F,83,11,6,138,-20,Severe
7,0,84,M,106,13,10,166,82,Well
6,6,78,M,7,5,6,66,-12,Severe
5,8,68,M,74,10,7,127,59,Well
12,11,155,M,25,6,5,77,-78,Severe
8,9,105,F,7,5,6,66,-39,Severe
7,11,95,F,71,10,3,123,28,Well
18,8,224,M,61,9,3,111,-113,Severe
15,6,186,M,54,8,7,103,-83,Severe
6,5,77,F,12,5,9,69,-8,Severe
7,0,84,M,7,5,6,66,-18,Severe
9,1,109,F,6,5,5,65,-44,Severe
11,9,141,M,43,7,8,92,-49,Severe
13,0,156,M,32,6,10,82,-74,Severe
18,2,218,M,40,7,5,89,-129,Severe
16,6,198,F,89,12,1,145,-53,Severe
17,11,215,M,72,10,4,124,-91,Severe
14,6,174,M,88,12,0,144,-30,Severe
18,0,216,M,94,12,7,151,-65,Severe
14,9,177,F,28,6,8,80,-97,Severe
15,9,189,M,61,9,3,111,-78,Severe
13,11,167,M,78,11,0,132,-35,Severe
13,10,166,F,65,9,8,116,-50,Severe
14,0,168,F,13,5,9,69,-99,Severe
7,7,91,M,110,14,3,171,80,Well
10,6,126,F,3,5,3,63,-63,Severe
9,2,110,F,55,8,8,104,-6,Severe
11,4,136,F,97,12,11,155,19,Well
5,6,66,F,97,12,11,155,89,Well
7,4,88,F,2,5,3,63,-25,Severe
5,3,63,F,90,12,3,147,84,Well
11,3,135,M,92,12,5,149,14,Well
6,3,75,M,60,9,2,110,35,Well
8,0,96,F,74,10,7,127,31,Well
13,7,163,M,96,12,10,154,-9,Severe
18,5,221,F,8,5,6,66,-155,Severe
17,2,206,F,22,6,3,75,-131,Severe
17,0,204,F,102,13,6,162,-42,Severe
10,9,129,M,9,5,7,67,-62,Severe
17,3,207,M,83,11,6,138,-69,Severe
9,7,115,F,21,6,2,74,-41,Severe
14,11,179,M,81,11,4,136,-43,Severe
5,4,64,M,86,11,10,142,78,Well
17,5,209,F,49,8,2,98,-111,Severe
18,3,219,M,58,9,0,108,-111,Severe
16,3,195,M,57,8,10,106,-89,Severe
12,5,149,F,53,8,6,102,-47,Severe
5,1,61,F,56,8,9,105,44,Well
7,5,89,F,89,12,1,145,56,Well
8,5,101,M,88,12,0,144,43,Well
16,4,196,M,104,13,7,163,-33,Severe
13,2,158,M,57,8,10,106,-52,Severe
6,6,78,F,60,9,2,110,32,Well
18,0,216,F,22,6,3,75,-141,Severe
18,5,221,F,13,5,9,69,-152,Severe
7,10,94,M,104,13,7,163,69,Well
5,11,71,M,81,11,4,136,65,Well
10,0,120,M,10,5,7,67,-53,Severe
7,0,84,M,94,12,7,151,67,Well
14,8,176,F,107,13,11,167,-9,Severe
8,3,99,M,75,10,9,129,30,Well
16,5,197,M,17,6,0,72,-125,Severe
11,5,137,M,19,6,1,73,-64,Severe
14,4,172,M,56,8,9,105,-67,Severe
9,6,114,M,86,11,10,142,28,Well
14,0,168,M,55,8,8,104,-64,Severe
12,7,151,F,5,5,5,65,-86,Severe
16,5,197,M,53,8,6,102,-95,Severe
16,1,193,F,87,11,11,143,-50,Severe
16,8,200,F,107,13,11,167,-33,Severe
7,8,92,M,80,11,3,135,43,Well
13,5,161,F,97,12,11,155,-6,Severe
16,9,201,M,23,6,4,76,-125,Severe
9,4,112,F,14,5,10,70,-42,Severe
5,4,64,F,53,8,6,102,38,Well
12,2,146,M,57,8,10,106,-40,Severe
10,11,131,F,55,8,8,104,-27,Severe
10,9,129,M,67,9,10,118,-11,Severe
16,1,193,F,109,14,1,169,-24,Severe
7,3,87,M,25,6,5,77,-10,Severe
17,3,207,M,100,13,3,159,-48,Severe
6,3,75,M,11,5,8,68,-7,Severe
7,7,91,M,74,10,7,127,36,Well
12,9,153,M,94,12,7,151,-2,Mild
9,11,119,F,30,6,9,81,-38,Severe
12,9,153,F,12,5,9,69,-84,Severe
10,10,130,M,62,9,4,112,-18,Severe
18,8,224,M,54,8,7,103,-121,Severe
5,10,70,M,23,6,4,76,6,Well
10,7,127,F,105,13,9,165,38,Well
7,3,87,F,6,5,5,65,-22,Severe
17,10,214,M,33,6,11,83,-131,Severe
10,1,121,F,71,10,3,123,2,Good
9,5,113,F,56,8,9,105,-8,Severe
14,3,171,F,34,7,0,84,-87,Severe
12,7,151,M,36,7,2,86,-65,Severe
9,5,113,F,47,8,0,96,-17,Severe
11,1,133,M,34,7,0,84,-49,Severe
17,7,211,F,66,9,9,117,-94,Severe
11,6,138,M,41,7,6,90,-48,Severe
17,5,209,F,45,7,10,94,-115,Severe
17,10,214,M,19,6,1,73,-141,Severe
9,10,118,M,22,6,3,75,-43,Severe
16,4,196,F,30,6,9,81,-115,Severe
16,6,198,F,34,7,0,84,-114,Severe
13,3,159,M,88,12,0,144,-15,Severe
7,6,90,F,46,7,11,95,5,Good
15,3,183,F,64,9,7,115,-68,Severe
18,7,223,F,38,7,4,88,-135,Severe
7,7,91,F,77,10,11,131,40,Well
16,10,202,M,10,5,7,67,-135,Severe
14,1,169,F,20,6,2,74,-95,Severe
7,3,87,F,61,9,3,111,24,Well
17,4,208,F,62,9,4,112,-96,Severe
18,1,217,M,3,5,3,63,-154,Severe
13,4,160,M,70,10,2,122,-38,Severe
7,2,86,M,65,9,8,116,30,Well
8,0,96,M,79,11,1,133,37,Well
12,3,147,F,4,5,4,64,-83,Severe
13,11,167,M,92,12,5,149,-18,Severe
18,7,223,F,51,8,4,100,-123,Severe
13,5,161,M,21,6,2,74,-87,Severe
18,3,219,F,95,12,9,153,-66,Severe
16,2,194,M,71,10,3,123,-71,Severe
6,0,72,M,107,13,11,167,95,Well
12,5,149,M,82,11,5,137,-12,Severe
6,7,79,F,102,13,6,162,83,Well
13,4,160,F,71,10,3,123,-37,Severe
10,2,122,M,17,6,0,72,-50,Severe
11,2,134,M,25,6,5,77,-57,Severe
7,2,86,F,27,6,7,79,-7,Severe
14,4,172,F,92,12,5,149,-23,Severe
8,3,99,M,39,7,5,89,-10,Severe
11,1,133,M,47,8,0,96,-37,Severe
11,0,132,M,63,9,6,114,-18,Severe
12,2,146,F,38,7,4,88,-58,Severe
6,4,76,F,91,12,4,148,72,Well
8,7,103,M,42,7,7,91,-12,Severe
7,5,89,F,54,8,7,103,14,Well
10,7,127,M,99,13,1,157,30,Well
6,1,73,F,52,8,5,101,28,Well
13,6,162,F,33,6,11,83,-79,Severe
11,3,135,F,80,11,3,135,0,Neutral
12,2,146,F,90,12,3,147,1,Good
14,4,172,M,98,13,0,156,-16,Severe
10,1,121,F,104,13,7,163,42,Well
12,0,144,M,109,14,1,169,25,Well
7,9,93,M,67,9,10,118,25,Well
10,2,122,M,79,11,1,133,11,Well
13,5,161,M,7,5,6,66,-95,Severe
15,6,186,M,10,5,7,67,-119,Severe
14,8,176,F,41,7,6,90,-86,Severe
18,7,223,F,19,6,1,73,-150,Severe
17,3,207,M,26,6,6,78,-129,Severe
9,4,112,M,38,7,4,88,-24,Severe
15,7,187,M,29,6,8,80,-107,Severe
12,0,144,M,75,10,9,129,-15,Severe
17,0,204,F,91,12,4,148,-56,Severe
7,1,85,F,14,5,10,70,-15,Severe
6,4,76,M,58,9,0,108,32,Well
11,3,135,F,42,7,7,91,-44,Severe
16,2,194,F,59,9,1,109,-85,Severe
13,3,159,F,71,10,3,123,-36,Severe
8,6,102,F,63,9,6,114,12,Well
11,7,139,M,9,5,7,67,-72,Severe
17,3,207,M,40,7,5,89,-118,Severe
16,5,197,M,91,12,4,148,-49,Severe
15,6,186,M,97,12,11,155,-31,Severe
12,11,155,F,20,6,2,74,-81,Severe
18,2,218,F,15,5,11,71,-147,Severe
5,7,67,F,55,8,8,104,37,Well
12,4,148,F,35,7,1,85,-63,Severe
14,6,174,F,45,7,10,94,-80,Severe
12,8,152,F,6,5,5,65,-87,Severe
7,1,85,F,19,6,1,73,-12,Severe
6,7,79,M,92,12,5,149,70,Well
6,5,77,F,30,6,9,81,4,Good
10,4,124,F,77,10,11,131,7,Well
12,1,145,M,64,9,7,115,-30,Severe
15,11,191,F,89,12,1,145,-46,Severe
8,7,103,M,24,6,5,77,-26,Severe
9,6,114,M,23,6,4,76,-38,Severe
5,3,63,M,29,6,8,80,17,Well
10,8,128,F,104,13,7,163,35,Well
18,10,226,M,97,12,11,155,-71,Severe
17,3,207,F,62,9,4,112,-95,Severe
6,10,82,M,65,9,8,116,34,Well
6,2,74,F,59,9,1,109,35,Well
14,1,169,M,3,5,3,63,-106,Severe
5,1,61,M,42,7,7,91,30,Well
10,3,123,F,106,13,10,166,43,Well
6,3,75,M,79,11,1,133,58,Well
12,2,146,M,62,9,4,112,-34,Severe
16,8,200,M,25,6,5,77,-123,Severe
6,3,75,F,89,12,1,145,70,Well
5,6,66,F,34,7,0,84,18,Well
17,7,211,M,64,9,7,115,-96,Severe
9,2,110,M,91,12,4,148,38,Well
10,2,122,M,15,5,11,71,-51,Severe
9,2,110,F,103,13,6,162,52,Well
9,7,115,F,64,9,7,115,0,Neutral
10,3,123,F,45,7,10,94,-29,Severe
15,4,184,M,84,11,7,139,-45,Severe
13,9,165,F,19,6,1,73,-92,Severe
10,8,128,F,86,11,10,142,14,Well
15,10,190,M,57,8,10,106,-84,Severe
14,5,173,F,3,5,3,63,-110,Severe
11,2,134,F,84,11,7,139,5,Good
11,8,140,F,15,5,11,71,-69,Severe
13,0,156,F,8,5,6,66,-90,Severe
16,8,200,F,2,5,3,63,-137,Severe
5,6,66,F,103,13,6,162,96,Well
13,5,161,M,3,5,3,63,-98,Severe
7,2,86,F,14,5,10,70,-16,Severe
6,7,79,M,95,12,9,153,74,Well
10,8,128,M,109,14,1,169,41,Well
7,6,90,M,7,5,6,66,-24,Severe
17,7,211,F,102,13,6,162,-49,Severe
15,6,186,F,88,12,0,144,-42,Severe
13,9,165,M,19,6,1,73,-92,Severe
6,7,79,F,54,8,7,103,24,Well
8,3,99,M,102,13,6,162,63,Well
13,7,163,F,77,10,11,131,-32,Severe
17,7,211,F,94,12,7,151,-60,Severe
14,0,168,M,102,13,6,162,-6,Severe
5,3,63,M,70,10,2,122,59,Well
6,10,82,F,68,10,0,120,38,Well
17,8,212,F,69,10,1,121,-91,Severe
9,3,111,F,70,10,2,122,11,Well
6,11,83,M,43,7,8,92,9,Well
8,3,99,M,43,7,8,92,-7,Severe
15,9,189,M,16,5,11,71,-118,Severe
9,3,111,F,48,8,1,97,-14,Severe
15,9,189,M,106,13,10,166,-23,Severe
12,9,153,F,99,13,1,157,4,Good
7,0,84,M,14,5,10,70,-14,Severe
8,2,98,M,77,10,11,131,33,Well
18,7,223,F,28,6,8,80,-143,Severe
9,3,111,M,30,6,9,81,-30,Severe
18,8,224,M,63,9,6,114,-110,Severe
10,3,123,M,52,8,5,101,-22,Severe
17,1,205,M,63,9,6,114,-91,Severe
11,8,140,M,93,12,6,150,10,Well
9,1,109,F,16,5,11,71,-38,Severe
5,0,60,M,104,13,7,163,103,Well
17,6,210,F,26,6,6,78,-132,Severe
16,5,197,F,17,6,0,72,-125,Severe
11,3,135,M,22,6,3,75,-60,Severe
6,4,76,F,31,6,9,81,5,Good
18,0,216,F,77,10,11,131,-85,Severe
17,9,213,M,84,11,7,139,-74,Severe
13,5,161,M,47,8,0,96,-65,Severe
9,4,112,M,104,13,7,163,51,Well
15,0,180,F,7,5,6,66,-114,Severe
16,11,203,M,55,8,8,104,-99,Severe
17,6,210,M,16,5,11,71,-139,Severe
10,5,125,F,98,13,0,156,31,Well
16,11,203,M,106,13,10,166,-37,Severe
11,2,134,M,106,13,10,166,32,Well
8,4,100,M,85,11,9,141,41,Well
14,11,179,F,101,13,4,160,-19,Severe
15,0,180,M,40,7,5,89,-91,Severe
12,1,145,M,62,9,4,112,-33,Severe
6,7,79,M,33,6,11,83,4,Good
9,4,112,F,84,11,7,139,27,Well
12,8,152,M,6,5,5,65,-87,Severe
16,11,203,F,73,10,6,126,-77,Severe
6,5,77,M,81,11,4,136,59,Well
5,1,61,M,67,9,10,118,57,Well
6,9,81,M,76,10,10,130,49,Well
11,3,135,M,100,13,3,159,24,Well
16,11,203,F,94,12,7,151,-52,Severe
6,4,76,M,24,6,5,77,1,Good
11,10,142,M,97,12,11,155,13,Well
13,10,166,M,82,11,5,137,-29,Severe
13,10,166,M,48,8,1,97,-69,Severe
16,2,194,F,88,12,0,144,-50,Severe
18,4,220,F,5,5,5,65,-155,Severe
13,7,163,M,18,6,1,73,-90,Severe
10,3,123,M,55,8,8,104,-19,Severe
15,11,191,M,33,6,11,83,-108,Severe
7,7,91,F,87,11,11,143,52,Well
11,3,135,M,79,11,1,133,-2,Mild
5,6,66,M,46,7,11,95,29,Well
17,11,215,F,58,9,0,108,-107,Severe
5,5,65,M,87,11,11,143,78,Well
8,7,103,M,53,8,6,102,-1,Mild
18,7,223,F,74,10,7,127,-96,Severe
14,1,169,M,5,5,5,65,-104,Severe
10,6,126,F,23,6,4,76,-50,Severe
5,3,63,F,43,7,8,92,29,Well
15,0,180,M,44,7,9,93,-87,Severe
11,10,142,M,38,7,4,88,-54,Severe
6,3,75,F,82,11,5,137,62,Well
8,2,98,M,56,8,9,105,7,Well
9,0,108,F,2,5,3,63,-45,Severe
10,4,124,M,50,8,3,99,-25,Severe
5,8,68,M,64,9,7,115,47,Well
14,6,174,M,42,7,7,91,-83,Severe
7,4,88,M,73,10,6,126,38,Well
9,10,118,M,3,5,3,63,-55,Severe
18,11,227,M,24,6,5,77,-150,Severe
16,6,198,F,8,5,6,66,-132,Severe
14,8,176,M,97,12,11,155,-21,Severe
16,5,197,F,38,7,4,88,-109,Severe
16,10,202,F,97,12,11,155,-47,Severe
5,3,63,F,29,6,8,80,17,Well
18,5,221,F,96,12,10,154,-67,Severe
11,11,143,M,5,5,5,65,-78,Severe
16,1,193,M,9,5,7,67,-126,Severe
15,10,190,F,108,14,0,168,-22,Severe
16,0,192,M,67,9,10,118,-74,Severe
13,6,162,M,54,8,7,103,-59,Severe
17,10,214,F,85,11,9,141,-73,Severe
13,10,166,F,88,12,0,144,-22,Severe
7,11,95,M,74,10,7,127,32,Well
12,1,145,F,69,10,1,121,-24,Severe
18,2,218,F,89,12,1,145,-73,Severe
6,5,77,F,24,6,5,77,0,Neutral
16,11,203,M,10,5,7,67,-136,Severe
5,2,62,F,27,6,7,79,17,Well
15,2,182,F,4,5,4,64,-118,Severe
5,4,64,F,92,12,5,149,85,Well
16,7,199,M,83,11,6,138,-61,Severe
17,3,207,M,46,7,11,95,-112,Severe
18,1,217,M,79,11,1,133,-84,Severe
8,7,103,F,37,7,3,87,-16,Severe
5,5,65,F,94,12,7,151,86,Well
12,10,154,M,3,5,3,63,-91,Severe
17,11,215,M,58,9,0,108,-107,Severe
18,4,220,M,50,8,3,99,-121,Severe
14,6,174,M,81,11,4,136,-38,Severe
15,5,185,M,34,7,0,84,-101,Severe
16,6,198,F,41,7,6,90,-108,Severe
16,9,201,M,58,9,0,108,-93,Severe
15,8,188,M,62,9,4,112,-76,Severe
11,3,135,M,64,9,7,115,-20,Severe
7,6,90,M,36,7,2,86,-4,Mild
16,11,203,M,22,6,3,75,-128,Severe
8,6,102,F,97,12,11,155,53,Well
16,11,203,F,89,12,1,145,-58,Severe
11,3,135,F,17,6,0,72,-63,Severe
18,3,219,M,30,6,9,81,-138,Severe
10,7,127,F,100,13,3,159,32,Well
16,10,202,M,66,9,9,117,-85,Severe
17,9,213,M,62,9,4,112,-101,Severe
18,7,223,M,2,5,3,63,-160,Severe
6,11,83,F,83,11,6,138,55,Well
7,0,84,M,31,6,9,81,-3,Mild
8,7,103,F,63,9,6,114,11,Well
17,5,209,F,110,14,3,171,-38,Severe
14,11,179,M,13,5,9,69,-110,Severe
9,4,112,F,48,8,1,97,-15,Severe
11,3,135,M,38,7,4,88,-47,Severe
18,11,227,M,30,6,9,81,-146,Severe
9,11,119,F,9,5,7,67,-52,Severe
13,8,164,F,60,9,2,110,-54,Severe
18,0,216,M,41,7,6,90,-126,Severe
18,3,219,F,31,6,9,81,-138,Severe
12,3,147,F,3,5,3,63,-84,Severe
7,11,95,F,76,10,10,130,35,Well
13,1,157,M,17,6,0,72,-85,Severe
17,9,213,M,73,10,6,126,-87,Severe
18,9,225,F,88,12,0,144,-81,Severe
11,0,132,M,23,6,4,76,-56,Severe
17,5,209,F,59,9,1,109,-100,Severe
16,2,194,F,40,7,5,89,-105,Severe
14,8,176,F,74,10,7,127,-49,Severe
7,0,84,M,84,11,7,139,55,Well
14,11,179,M,31,6,9,81,-98,Severe
6,8,80,M,40,7,5,89,9,Well
6,1,73,M,16,5,11,71,-2,Mild
13,4,160,M,81,11,4,136,-24,Severe
13,2,158,M,94,12,7,151,-7,Severe
16,5,197,F,76,10,10,130,-67,Severe
17,3,207,F,42,7,7,91,-116,Severe
14,0,168,M,30,6,9,81,-87,Severe
18,10,226,F,38,7,4,88,-138,Severe
11,8,140,F,82,11,5,137,-3,Mild
12,3,147,M,39,7,5,89,-58,Severe
18,5,221,F,89,12,1,145,-76,Severe
13,6,162,F,64,9,7,115,-47,Severe
17,11,215,F,92,12,5,149,-66,Severe
18,8,224,F,42,7,7,91,-133,Severe
16,3,195,F,33,6,11,83,-112,Severe
6,1,73,M,105,13,9,165,92,Well
18,9,225,F,97,12,11,155,-70,Severe
17,2,206,M,28,6,8,80,-126,Severe
13,7,163,F,99,13,1,157,-6,Severe
8,7,103,M,101,13,4,160,57,Well
7,6,90,M,18,6,1,73,-17,Severe
17,11,215,F,38,7,4,88,-127,Severe
16,9,201,F,8,5,6,66,-135,Severe
6,7,79,F,79,11,1,133,54,Well
9,2,110,M,101,13,4,160,50,Well
16,0,192,F,23,6,4,76,-116,Severe
13,6,162,M,97,12,11,155,-7,Severe
13,5,161,M,61,9,3,111,-50,Severe
13,6,162,F,4,5,4,64,-98,Severe
7,6,90,M,102,13,6,162,72,Well
10,8,128,F,89,12,1,145,17,Well
16,3,195,M,37,7,3,87,-108,Severe
8,1,97,M,58,9,0,108,11,Well
11,5,137,M,94,12,7,151,14,Well
14,3,171,F,19,6,1,73,-98,Severe
11,1,133,F,10,5,7,67,-66,Severe
14,8,176,M,84,11,7,139,-37,Severe
5,11,71,M,8,5,6,66,-5,Mild
17,10,214,F,36,7,2,86,-128,Severe
15,9,189,M,97,12,11,155,-34,Severe
9,5,113,F,86,11,10,142,29,Well
6,6,78,M,46,7,11,95,17,Well
12,5,149,M,13,5,9,69,-80,Severe
10,9,129,F,56,8,9,105,-24,Severe
7,10,94,F,22,6,3,75,-19,Severe
5,7,67,M,88,12,0,144,77,Well
11,0,132,F,86,11,10,142,10,Well
6,4,76,M,21,6,2,74,-2,Mild
10,5,125,M,91,12,4,148,23,Well
11,7,139,F,9,5,7,67,-72,Severe
13,6,162,M,83,11,6,138,-24,Severe
18,0,216,M,103,13,6,162,-54,Severe
12,4,148,M,90,12,3,147,-1,Mild
18,2,218,M,88,12,0,144,-74,Severe
13,11,167,M,74,10,7,127,-40,Severe
11,6,138,F,104,13,7,163,25,Well
13,1,157,F,55,8,8,104,-53,Severe
5,4,64,F,101,13,4,160,96,Well
6,7,79,M,5,5,5,65,-14,Severe
16,11,203,M,87,11,11,143,-60,Severe
11,1,133,F,63,9,6,114,-19,Severe
12,3,147,F,103,13,6,162,15,Well
12,10,154,M,31,6,9,81,-73,Severe
10,5,125,F,10,5,7,67,-58,Severe
13,3,159,M,65,9,8,116,-43,Severe
5,3,63,F,19,6,1,73,10,Well
9,8,116,M,7,5,6,66,-50,Severe
5,1,61,M,110,14,3,171,110,Well
13,3,159,M,5,5,5,65,-94,Severe
14,5,173,M,7,5,6,66,-107,Severe
7,9,93,F,75,10,9,129,36,Well
15,3,183,M,45,7,10,94,-89,Severe
18,2,218,F,99,13,1,157,-61,Severe
8,2,98,M,70,10,2,122,24,Well
17,7,211,M,28,6,8,80,-131,Severe
11,6,138,F,54,8,7,103,-35,Severe
10,11,131,M,109,14,1,169,38,Well
17,6,210,F,105,13,9,165,-45,Severe
17,7,211,F,73,10,6,126,-85,Severe
11,4,136,M,30,6,9,81,-55,Severe
11,1,133,M,62,9,4,112,-21,Severe
16,7,199,F,88,12,0,144,-55,Severe
6,6,78,F,62,9,4,112,34,Well
7,5,89,M,44,7,9,93,4,Good
15,4,184,M,30,6,9,81,-103,Severe
6,2,74,F,9,5,7,67,-7,Severe
6,7,79,M,49,8,2,98,19,Well
11,8,140,F,24,6,5,77,-63,Severe
5,10,70,F,61,9,3,111,41,Well
13,6,162,F,45,7,10,94,-68,Severe
6,8,80,M,25,6,5,77,-3,Mild
17,9,213,F,65,9,8,116,-97,Severe
17,4,208,F,55,8,8,104,-104,Severe
17,5,209,F,106,13,10,166,-43,Severe
12,11,155,F,61,9,3,111,-44,Severe
18,6,222,M,64,9,7,115,-107,Severe
13,1,157,F,37,7,3,87,-70,Severe
7,3,87,F,81,11,4,136,49,Well
16,5,197,F,25,6,5,77,-120,Severe
13,10,166,F,43,7,8,92,-74,Severe
5,2,62,F,40,7,5,89,27,Well
5,1,61,F,90,12,3,147,86,Well
6,8,80,M,44,7,9,93,13,Well
8,6,102,F,21,6,2,74,-28,Severe
6,7,79,M,37,7,3,87,8,Well
5,3,63,M,21,6,2,74,11,Well
9,3,111,F,40,7,5,89,-22,Severe
15,0,180,M,96,12,10,154,-26,Severe
12,6,150,F,73,10,6,126,-24,Severe
15,9,189,F,28,6,8,80,-109,Severe
5,8,68,M,46,7,11,95,27,Well
11,7,139,M,103,13,6,162,23,Well
13,6,162,F,48,8,1,97,-65,Severe
17,7,211,F,42,7,7,91,-120,Severe
8,9,105,F,12,5,9,69,-36,Severe
6,4,76,F,39,7,5,89,13,Well
15,2,182,F,101,13,4,160,-22,Severe
8,10,106,F,19,6,1,73,-33,Severe
6,9,81,F,109,14,1,169,88,Well
13,3,159,F,47,8,0,96,-63,Severe
18,9,225,M,8,5,6,66,-159,Severe
12,3,147,M,51,8,4,100,-47,Severe
12,1,145,F,63,9,6,114,-31,Severe
17,2,206,M,29,6,8,80,-126,Severe
9,9,117,F,22,6,3,75,-42,Severe
16,3,195,F,45,7,10,94,-101,Severe
15,4,184,M,24,6,5,77,-107,Severe
6,10,82,M,35,7,1,85,3,Good
18,3,219,M,96,12,10,154,-65,Severe
7,5,89,F,24,6,5,77,-12,Severe
13,11,167,M,80,11,3,135,-32,Severe
15,5,185,M,31,6,9,81,-104,Severe
5,9,69,F,97,12,11,155,86,Well
11,3,135,M,78,11,0,132,-3,Mild
7,1,85,M,82,11,5,137,52,Well
15,0,180,F,61,9,3,111,-69,Severe
14,2,170,M,108,14,0,168,-2,Mild
10,5,125,F,73,10,6,126,1,Good
10,5,125,F,103,13,6,162,37,Well
8,5,101,M,53,8,6,102,1,Good
16,10,202,F,64,9,7,115,-87,Severe
14,4,172,F,15,5,11,71,-101,Severe
6,10,82,M,82,11,5,137,55,Well
5,0,60,M,98,13,0,156,96,Well
12,1,145,M,41,7,6,90,-55,Severe
18,4,220,M,26,6,6,78,-142,Severe
6,3,75,F,11,5,8,68,-7,Severe
8,6,102,F,53,8,6,102,0,Neutral
17,2,206,F,69,10,1,121,-85,Severe
10,0,120,F,14,5,10,70,-50,Severe
7,3,87,M,32,6,10,82,-5,Mild
13,6,162,M,17,6,0,72,-90,Severe
10,11,131,F,74,10,7,127,-4,Mild
8,0,96,M,69,10,1,121,25,Well
6,5,77,M,85,11,9,141,64,Well
16,6,198,M,43,7,8,92,-106,Severe
16,7,199,F,84,11,7,139,-60,Severe
11,11,143,F,6,5,5,65,-78,Severe
12,11,155,M,47,8,0,96,-59,Severe
5,3,63,F,45,7,10,94,31,Well
11,7,139,M,107,13,11,167,28,Well
18,3,219,M,63,9,6,114,-105,Severe
15,3,183,F,51,8,4,100,-83,Severe
11,6,138,M,43,7,8,92,-46,Severe
8,11,107,F,106,13,10,166,59,Well
15,11,191,M,96,12,10,154,-37,Severe
14,9,177,F,73,10,6,126,-51,Severe
13,11,167,F,98,13,0,156,-11,Severe
7,2,86,M,13,5,9,69,-17,Severe
14,0,168,M,50,8,3,99,-69,Severe
15,8,188,M,69,10,1,121,-67,Severe
7,11,95,M,30,6,9,81,-14,Severe
8,5,101,M,58,9,0,108,7,Well
17,6,210,F,25,6,5,77,-133,Severe
5,11,71,M,39,7,5,89,18,Well
12,5,149,F,79,11,1,133,-16,Severe
16,10,202,M,99,13,1,157,-45,Severe
8,6,102,F,66,9,9,117,15,Well
8,4,100,F,67,9,10,118,18,Well
14,2,170,M,105,13,9,165,-5,Mild
8,2,98,F,7,5,6,66,-32,Severe
10,6,126,M,19,6,1,73,-53,Severe
17,11,215,F,20,6,2,74,-141,Severe
13,7,163,M,37,7,3,87,-76,Severe
15,7,187,M,58,9,0,108,-79,Severe
17,11,215,M,11,5,8,68,-147,Severe
16,9,201,F,67,9,10,118,-83,Severe
14,0,168,M,90,12,3,147,-21,Severe
12,3,147,M,22,6,3,75,-72,Severe
5,1,61,M,51,8,4,100,39,Well
14,3,171,M,46,7,11,95,-76,Severe
10,3,123,M,70,10,2,122,-1,Mild
10,7,127,M,107,13,11,167,40,Well
5,3,63,M,11,5,8,68,5,Good
15,8,188,F,84,11,7,139,-49,Severe
13,1,157,M,85,11,9,141,-16,Severe
6,10,82,F,74,10,7,127,45,Well
16,0,192,M,84,11,7,139,-53,Severe
9,10,118,M,39,7,5,89,-29,Severe
9,2,110,M,94,12,7,151,41,Well
11,11,143,M,79,11,1,133,-10,Severe
14,6,174,F,47,8,0,96,-78,Severe
7,8,92,M,22,6,3,75,-17,Severe
7,0,84,M,97,12,11,155,71,Well
12,0,144,M,74,10,7,127,-17,Severe
7,5,89,M,105,13,9,165,76,Well
12,6,150,M,32,6,10,82,-68,Severe
13,0,156,M,90,12,3,147,-9,Severe
13,11,167,M,109,14,1,169,2,Good
17,4,208,F,77,10,11,131,-77,Severe
15,2,182,F,89,12,1,145,-37,Severe
17,9,213,F,89,12,1,145,-68,Severe
12,11,155,F,90,12,3,147,-8,Severe
5,0,60,M,70,10,2,122,62,Well
10,8,128,F,43,7,8,92,-36,Severe
8,6,102,F,91,12,4,148,46,Well
6,10,82,M,51,8,4,100,18,Well
7,4,88,F,100,13,3,159,71,Well
10,2,122,M,105,13,9,165,43,Well
16,11,203,F,81,11,4,136,-67,Severe
9,6,114,F,38,7,4,88,-26,Severe
15,3,183,F,61,9,3,111,-72,Severe
13,3,159,F,99,13,1,157,-2,Mild
11,5,137,M,74,10,7,127,-10,Severe
13,2,158,M,52,8,5,101,-57,Severe
18,4,220,F,12,5,9,69,-151,Severe
12,3,147,F,18,6,1,73,-74,Severe
7,7,91,F,11,5,8,68,-23,Severe
12,6,150,M,42,7,7,91,-59,Severe
13,9,165,M,28,6,8,80,-85,Severe
18,11,227,F,14,5,10,70,-157,Severe
11,6,138,F,78,11,0,132,-6,Severe
5,1,61,F,23,6,4,76,15,Well
10,2,122,F,91,12,4,148,26,Well
12,10,154,M,65,9,8,116,-38,Severe
9,4,112,F,91,12,4,148,36,Well
6,6,78,F,56,8,9,105,27,Well
11,11,143,F,57,8,10,106,-37,Severe
14,5,173,M,92,12,5,149,-24,Severe
10,3,123,F,88,12,0,144,21,Well
15,8,188,M,74,10,7,127,-61,Severe
13,1,157,M,71,10,3,123,-34,Severe
14,8,176,M,106,13,10,166,-10,Severe
10,9,129,F,66,9,9,117,-12,Severe
10,3,123,M,53,8,6,102,-21,Severe
14,6,174,M,72,10,4,124,-50,Severe
17,3,207,F,59,9,1,109,-98,Severe
5,9,69,M,25,6,5,77,8,Well
15,3,183,F,30,6,9,81,-102,Severe
14,11,179,F,97,12,11,155,-24,Severe
13,3,159,F,53,8,6,102,-57,Severe
10,3,123,M,47,8,0,96,-27,Severe
10,8,128,F,49,8,2,98,-30,Severe
14,11,179,F,39,7,5,89,-90,Severe
6,1,73,F,61,9,3,111,38,Well
14,5,173,M,25,6,5,77,-96,Severe
16,3,195,M,24,6,5,77,-118,Severe
11,10,142,M,40,7,5,89,-53,Severe
8,6,102,M,24,6,5,77,-25,Severe
14,7,175,M,84,11,7,139,-36,Severe
12,10,154,M,47,8,0,96,-58,Severe
7,6,90,F,101,13,4,160,70,Well
18,8,224,F,70,10,2,122,-102,Severe
6,4,76,M,81,11,4,136,60,Well
7,9,93,M,94,12,7,151,58,Well
15,2,182,M,59,9,1,109,-73,Severe
14,9,177,M,86,11,10,142,-35,Severe
8,2,98,M,19,6,1,73,-25,Severe
18,3,219,F,99,13,1,157,-62,Severe
7,0,84,F,75,10,9,129,45,Well
12,6,150,F,38,7,4,88,-62,Severe
6,9,81,M,60,9,2,110,29,Well
7,3,87,F,13,5,9,69,-18,Severe
12,2,146,M,74,10,7,127,-19,Severe
7,6,90,M,22,6,3,75,-15,Severe
9,4,112,M,108,14,0,168,56,Well
10,7,127,F,84,11,7,139,12,Well
15,8,188,F,62,9,4,112,-76,Severe
13,11,167,M,19,6,1,73,-94,Severe
17,3,207,M,109,14,1,169,-38,Severe
6,8,80,M,59,9,1,109,29,Well
12,7,151,M,12,5,9,69,-82,Severe
7,3,87,M,60,9,2,110,23,Well
5,6,66,M,15,5,11,71,5,Good
8,6,102,M,97,12,11,155,53,Well
9,9,117,M,89,12,1,145,28,Well
10,2,122,F,79,11,1,133,11,Well
13,10,166,F,19,6,1,73,-93,Severe
13,7,163,M,99,13,1,157,-6,Severe
17,6,210,F,60,9,2,110,-100,Severe
13,9,165,M,34,7,0,84,-81,Severe
6,7,79,M,74,10,7,127,48,Well
5,2,62,M,24,6,5,77,15,Well
8,3,99,F,77,10,11,131,32,Well
17,7,211,M,82,11,5,137,-74,Severe
11,7,139,M,21,6,2,74,-65,Severe
18,6,222,M,88,12,0,144,-78,Severe
8,11,107,M,70,10,2,122,15,Well
7,11,95,F,10,5,7,67,-28,Severe
5,8,68,M,20,6,2,74,6,Well
8,10,106,M,26,6,6,78,-28,Severe
13,3,159,F,33,6,11,83,-76,Severe
14,3,171,M,17,6,0,72,-99,Severe
17,6,210,M,28,6,8,80,-130,Severe
5,6,66,M,96,12,10,154,88,Well
18,7,223,F,110,14,3,171,-52,Severe
6,1,73,F,3,5,3,63,-10,Severe
6,0,72,F,97,12,11,155,83,Well
7,8,92,M,99,13,1,157,65,Well
14,4,172,M,77,10,11,131,-41,Severe
18,10,226,M,4,5,4,64,-162,Severe
8,10,106,M,83,11,6,138,32,Well
16,11,203,F,12,5,9,69,-134,Severe
10,5,125,F,109,14,1,169,44,Well
16,8,200,M,17,6,0,72,-128,Severe
7,10,94,F,94,12,7,151,57,Well
9,1,109,F,55,8,8,104,-5,Mild
15,4,184,F,8,5,6,66,-118,Severe
15,7,187,F,37,7,3,87,-100,Severe
11,7,139,F,18,6,1,73,-66,Severe
5,3,63,F,105,13,9,165,102,Well
10,1,121,F,9,5,7,67,-54,Severe
6,3,75,F,47,8,0,96,21,Well
14,0,168,F,87,11,11,143,-25,Severe
8,5,101,M,105,13,9,165,64,Well
15,6,186,F,40,7,5,89,-97,Severe
8,3,99,F,35,7,1,85,-14,Severe
15,3,183,F,44,7,9,93,-90,Severe
16,3,195,M,82,11,5,137,-58,Severe
11,3,135,F,33,6,11,83,-52,Severe
6,8,80,M,101,13,4,160,80,Well
16,7,199,F,18,6,1,73,-126,Severe
9,6,114,M,38,7,4,88,-26,Severe
10,9,129,F,100,13,3,159,30,Well
11,2,134,M,10,5,7,67,-67,Severe
11,5,137,F,93,12,6,150,13,Well
17,5,209,M,28,6,8,80,-129,Severe
15,5,185,F,64,9,7,115,-70,Severe
16,1,193,F,14,5,10,70,-123,Severe
8,9,105,M,91,12,4,148,43,Well
10,5,125,F,67,9,10,118,-7,Severe
8,8,104,F,32,6,10,82,-22,Severe
11,11,143,M,70,10,2,122,-21,Severe
18,5,221,M,17,6,0,72,-149,Severe
12,7,151,M,28,6,8,80,-71,Severe
5,8,68,F,91,12,4,148,80,Well
11,0,132,M,73,10,6,126,-6,Severe
11,2,134,M,52,8,5,101,-33,Severe
7,2,86,M,102,13,6,162,76,Well
11,9,141,M,41,7,6,90,-51,Severe
18,0,216,F,82,11,5,137,-79,Severe
16,3,195,F,90,12,3,147,-48,Severe
15,7,187,F,71,10,3,123,-64,Severe
8,5,101,F,61,9,3,111,10,Well
17,7,211,F,36,7,2,86,-125,Severe
6,11,83,F,67,9,10,118,35,Well
18,3,219,F,61,9,3,111,-108,Severe
18,10,226,F,30,6,9,81,-145,Severe
12,1,145,M,95,12,9,153,8,Well
18,4,220,F,13,5,9,69,-151,Severe
6,3,75,M,37,7,3,87,12,Well
7,3,87,F,57,8,10,106,19,Well
13,5,161,F,22,6,3,75,-86,Severe
5,11,71,M,33,6,11,83,12,Well
8,1,97,M,70,10,2,122,25,Well
13,8,164,F,105,13,9,165,1,Good
6,6,78,F,55,8,8,104,26,Well
13,10,166,M,56,8,9,105,-61,Severe
10,4,124,F,72,10,4,124,0,Neutral
16,11,203,F,108,14,0,168,-35,Severe
15,3,183,F,82,11,5,137,-46,Severe
5,0,60,F,60,9,2,110,50,Well
9,5,113,F,26,6,6,78,-35,Severe
7,10,94,M,89,12,1,145,51,Well
8,5,101,M,83,11,6,138,37,Well
16,4,196,M,43,7,8,92,-104,Severe
9,6,114,F,109,14,1,169,55,Well
13,8,164,F,98,13,0,156,-8,Severe
9,3,111,F,22,6,3,75,-36,Severe
16,4,196,F,86,11,10,142,-54,Severe
16,2,194,M,99,13,1,157,-37,Severe
13,4,160,F,105,13,9,165,5,Good
8,2,98,F,51,8,4,100,2,Good
18,11,227,F,67,9,10,118,-109,Severe
14,10,178,M,72,10,4,124,-54,Severe
18,6,222,F,92,12,5,149,-73,Severe
16,5,197,F,77,10,11,131,-66,Severe
9,3,111,F,109,14,1,169,58,Well
13,4,160,M,88,12,0,144,-16,Severe
14,0,168,F,64,9,7,115,-53,Severe
6,10,82,F,58,9,0,108,26,Well
6,9,81,F,67,9,10,118,37,Well
7,2,86,F,76,10,10,130,44,Well
7,8,92,M,74,10,7,127,35,Well
8,5,101,M,80,11,3,135,34,Well
17,7,211,F,37,7,3,87,-124,Severe
17,1,205,F,74,10,7,127,-78,Severe
12,2,146,M,11,5,8,68,-78,Severe
5,7,67,M,100,13,3,159,92,Well
7,9,93,F,86,11,10,142,49,Well
8,10,106,F,7,5,6,66,-40,Severe
14,3,171,M,18,6,1,73,-98,Severe
6,3,75,M,46,7,11,95,20,Well
7,11,95,F,69,10,1,121,26,Well
18,7,223,M,85,11,9,141,-82,Severe
9,4,112,F,88,12,0,144,32,Well
5,10,70,F,75,10,9,129,59,Well
11,8,140,M,5,5,5,65,-75,Severe
14,0,168,F,45,7,10,94,-74,Severe
16,4,196,M,85,11,9,141,-55,Severe
17,10,214,M,78,11,0,132,-82,Severe
13,3,159,F,18,6,1,73,-86,Severe
6,9,81,M,38,7,4,88,7,Well
12,10,154,F,87,11,11,143,-11,Severe
11,5,137,M,13,5,9,69,-68,Severe
16,11,203,M,40,7,5,89,-114,Severe
5,9,69,M,99,13,1,157,88,Well
11,1,133,F,56,8,9,105,-28,Severe
14,6,174,F,28,6,8,80,-94,Severe
14,8,176,M,90,12,3,147,-29,Severe
16,7,199,F,92,12,5,149,-50,Severe
9,10,118,M,79,11,1,133,15,Well
8,5,101,F,32,6,10,82,-19,Severe
9,6,114,F,4,5,4,64,-50,Severe
17,11,215,M,46,7,11,95,-120,Severe
14,9,177,M,89,12,1,145,-32,Severe
8,3,99,M,29,6,8,80,-19,Severe
18,0,216,F,75,10,9,129,-87,Severe
10,8,128,F,81,11,4,136,8,Well
11,5,137,M,91,12,4,148,11,Well
16,4,196,M,75,10,9,129,-67,Severe
15,8,188,M,15,5,11,71,-117,Severe
15,5,185,F,33,6,11,83,-102,Severe
15,8,188,M,103,13,6,162,-26,Severe
18,3,219,M,22,6,3,75,-144,Severe
15,6,186,M,14,5,10,70,-116,Severe
18,3,219,F,8,5,6,66,-153,Severe
17,10,214,M,104,13,7,163,-51,Severe
10,2,122,M,30,6,9,81,-41,Severe
18,2,218,F,88,12,0,144,-74,Severe
11,2,134,M,35,7,1,85,-49,Severe
7,7,91,F,54,8,7,103,12,Well
9,8,116,M,63,9,6,114,-2,Mild
6,2,74,M,109,14,1,169,95,Well
6,5,77,F,101,13,4,160,83,Well
12,7,151,F,108,14,0,168,17,Well
17,2,206,M,83,11,6,138,-68,Severe
13,8,164,M,78,11,0,132,-32,Severe
12,6,150,M,23,6,4,76,-74,Severe
8,10,106,M,37,7,3,87,-19,Severe
12,9,153,F,64,9,7,115,-38,Severe
14,11,179,F,56,8,9,105,-74,Severe
5,8,68,M,84,11,7,139,71,Well
13,11,167,M,47,8,0,96,-71,Severe
8,8,104,F,37,7,3,87,-17,Severe
6,1,73,F,38,7,4,88,15,Well
14,8,176,F,13,5,9,69,-107,Severe
7,11,95,F,32,6,10,82,-13,Severe
12,6,150,F,51,8,4,100,-50,Severe
9,2,110,M,45,7,10,94,-16,Severe
8,0,96,M,32,6,10,82,-14,Severe
16,0,192,F,31,6,9,81,-111,Severe
6,7,79,F,3,5,3,63,-16,Severe
7,8,92,F,95,12,9,153,61,Well
13,9,165,F,53,8,6,102,-63,Severe
16,7,199,M,23,6,4,76,-123,Severe
12,3,147,M,4,5,4,64,-83,Severe
8,1,97,M,24,6,5,77,-20,Severe
15,3,183,F,70,10,2,122,-61,Severe
13,10,166,F,10,5,7,67,-99,Severe
6,3,75,M,8,5,6,66,-9,Severe
5,3,63,M,103,13,6,162,99,Well
5,0,60,F,9,5,7,67,7,Well
11,0,132,F,28,6,8,80,-52,Severe
8,5,101,F,54,8,7,103,2,Good
13,3,159,M,55,8,8,104,-55,Severe
15,1,181,F,108,14,0,168,-13,Severe
14,5,173,F,50,8,3,99,-74,Severe
16,3,195,F,39,7,5,89,-106,Severe
16,4,196,M,3,5,3,63,-133,Severe
11,5,137,F,14,5,10,70,-67,Severe
7,9,93,M,2,5,3,63,-30,Severe
8,1,97,M,83,11,6,138,41,Well
18,10,226,M,96,12,10,154,-72,Severe
13,1,157,F,24,6,5,77,-80,Severe
12,1,145,F,59,9,1,109,-36,Severe
10,11,131,M,3,5,3,63,-68,Severe
12,0,144,F,64,9,7,115,-29,Severe
9,6,114,M,12,5,9,69,-45,Severe
13,3,159,F,90,12,3,147,-12,Severe
8,10,106,M,28,6,8,80,-26,Severe
17,7,211,F,17,6,0,72,-139,Severe
18,10,226,F,10,5,7,67,-159,Severe
17,8,212,M,15,5,11,71,-141,Severe
7,0,84,M,90,12,3,147,63,Well
13,8,164,F,88,12,0,144,-20,Severe
10,4,124,M,31,6,9,81,-43,Severe
8,0,96,F,11,5,8,68,-28,Severe
16,9,201,F,2,5,3,63,-138,Severe
14,10,178,M,49,8,2,98,-80,Severe
7,1,85,M,85,11,9,141,56,Well
10,10,130,M,5,5,5,65,-65,Severe
8,5,101,M,86,11,10,142,41,Well
13,7,163,F,38,7,4,88,-75,Severe
6,2,74,M,110,14,3,171,97,Well
15,11,191,F,56,8,9,105,-86,Severe
5,8,68,M,33,6,11,83,15,Well
7,2,86,F,95,12,9,153,67,Well
18,4,220,F,51,8,4,100,-120,Severe
12,10,154,M,62,9,4,112,-42,Severe
16,3,195,F,14,5,10,70,-125,Severe
6,10,82,M,90,12,3,147,65,Well
8,0,96,F,107,13,11,167,71,Well
18,11,227,F,24,6,5,77,-150,Severe
9,6,114,F,24,6,5,77,-37,Severe
16,7,199,M,13,5,9,69,-130,Severe
5,3,63,F,12,5,9,69,6,Well
7,8,92,F,14,5,10,70,-22,Severe
9,4,112,M,103,13,6,162,50,Well
8,7,103,F,3,5,3,63,-40,Severe
6,1,73,F,70,10,2,122,49,Well
7,11,95,F,20,6,2,74,-21,Severe
12,0,144,M,23,6,4,76,-68,Severe
15,3,183,M,18,6,1,73,-110,Severe
13,6,162,F,5,5,5,65,-97,Severe
6,1,73,F,39,7,5,89,16,Well
8,7,103,F,29,6,8,80,-23,Severe
10,2,122,M,97,12,11,155,33,Well
11,4,136,F,70,10,2,122,-14,Severe
9,9,117,F,87,11,11,143,26,Well
16,5,197,F,81,11,4,136,-61,Severe
17,1,205,F,24,6,5,77,-128,Severe
18,5,221,M,20,6,2,74,-147,Severe
16,10,202,M,17,6,0,72,-130,Severe
8,7,103,F,50,8,3,99,-4,Mild
9,0,108,F,4,5,4,64,-44,Severe
16,4,196,M,21,6,2,74,-122,Severe
14,1,169,F,10,5,7,67,-102,Severe
15,10,190,F,10,5,7,67,-123,Severe
14,0,168,F,103,13,6,162,-6,Severe
17,8,212,F,80,11,3,135,-77,Severe
16,10,202,M,104,13,7,163,-39,Severe
9,3,111,M,50,8,3,99,-12,Severe
16,3,195,M,3,5,3,63,-132,Severe
6,11,83,F,32,6,10,82,-1,Mild
10,6,126,M,68,10,0,120,-6,Severe
18,6,222,F,100,13,3,159,-63,Severe
6,2,74,F,33,6,11,83,9,Well
7,11,95,M,94,12,7,151,56,Well
5,3,63,M,63,9,6,114,51,Well
15,2,182,F,5,5,5,65,-117,Severe
18,3,219,F,14,5,10,70,-149,Severe
5,5,65,M,68,10,0,120,55,Well
13,5,161,M,99,13,1,157,-4,Mild
12,3,147,F,43,7,8,92,-55,Severe
10,10,130,F,56,8,9,105,-25,Severe
12,0,144,M,40,7,5,89,-55,Severe
15,1,181,M,94,12,7,151,-30,Severe
14,7,175,M,21,6,2,74,-101,Severe
16,9,201,M,42,7,7,91,-110,Severe
7,5,89,M,43,7,8,92,3,Good
5,3,63,M,82,11,5,137,74,Well
12,3,147,M,21,6,2,74,-73,Severe
12,0,144,F,80,11,3,135,-9,Severe
16,4,196,M,98,13,0,156,-40,Severe
15,10,190,M,58,9,0,108,-82,Severe
7,3,87,F,3,5,3,63,-24,Severe
7,3,87,F,14,5,10,70,-17,Severe
13,3,159,F,56,8,9,105,-54,Severe
16,2,194,F,8,5,6,66,-128,Severe
17,4,208,F,32,6,10,82,-126,Severe
16,6,198,M,3,5,3,63,-135,Severe
9,3,111,F,43,7,8,92,-19,Severe
6,4,76,M,9,5,7,67,-9,Severe
10,3,123,F,26,6,6,78,-45,Severe
15,10,190,M,3,5,3,63,-127,Severe
10,0,120,F,92,12,5,149,29,Well
11,1,133,M,102,13,6,162,29,Well
17,5,209,M,61,9,3,111,-98,Severe
6,6,78,M,41,7,6,90,12,Well
8,11,107,M,37,7,3,87,-20,Severe
12,1,145,M,104,13,7,163,18,Well
11,4,136,M,74,10,7,127,-9,Severe
7,2,86,M,17,6,0,72,-14,Severe
9,7,115,F,99,13,1,157,42,Well
9,2,110,M,79,11,1,133,23,Well
13,10,166,F,105,13,9,165,-1,Mild
9,9,117,M,104,13,7,163,46,Well
10,9,129,F,92,12,5,149,20,Well
18,7,223,F,26,6,6,78,-145,Severe
7,10,94,M,43,7,8,92,-2,Mild
9,1,109,M,21,6,2,74,-35,Severe
16,3,195,F,11,5,8,68,-127,Severe
8,0,96,M,86,11,10,142,46,Well
15,8,188,F,92,12,5,149,-39,Severe
12,4,148,M,22,6,3,75,-73,Severe
8,1,97,M,90,12,3,147,50,Well
13,9,165,M,99,13,1,157,-8,Severe
15,7,187,M,4,5,4,64,-123,Severe
13,9,165,F,41,7,6,90,-75,Severe
8,0,96,F,37,7,3,87,-9,Severe
15,6,186,F,18,6,1,73,-113,Severe
6,8,80,F,76,10,10,130,50,Well
12,8,152,F,43,7,8,92,-60,Severe
15,6,186,F,98,13,0,156,-30,Severe
11,5,137,F,72,10,4,124,-13,Severe
15,4,184,M,19,6,1,73,-111,Severe
6,11,83,F,31,6,9,81,-2,Mild
13,11,167,M,2,5,3,63,-104,Severe
9,3,111,F,58,9,0,108,-3,Mild
17,4,208,M,76,10,10,130,-78,Severe
7,9,93,F,42,7,7,91,-2,Mild
16,8,200,F,8,5,6,66,-134,Severe
7,1,85,M,9,5,7,67,-18,Severe
11,8,140,M,77,10,11,131,-9,Severe
10,2,122,F,85,11,9,141,19,Well
7,6,90,F,48,8,1,97,7,Well
9,2,110,F,41,7,6,90,-20,Severe
11,8,140,M,18,6,1,73,-67,Severe
18,5,221,M,11,5,8,68,-153,Severe
5,9,69,F,18,6,1,73,4,Good
16,6,198,M,83,11,6,138,-60,Severe
7,7,91,F,55,8,8,104,13,Well
5,3,63,F,75,10,9,129,66,Well
10,4,124,M,60,9,2,110,-14,Severe
13,9,165,F,29,6,8,80,-85,Severe
18,8,224,F,80,11,3,135,-89,Severe
13,3,159,M,2,5,3,63,-96,Severe
11,1,133,F,84,11,7,139,6,Well
17,1,205,F,33,6,11,83,-122,Severe
15,4,184,M,91,12,4,148,-36,Severe
11,3,135,F,21,6,2,74,-61,Severe
11,9,141,F,87,11,11,143,2,Good
5,6,66,M,47,8,0,96,30,Well
14,2,170,F,24,6,5,77,-93,Severe
13,11,167,F,11,5,8,68,-99,Severe
18,0,216,M,21,6,2,74,-142,Severe
11,9,141,F,79,11,1,133,-8,Severe
10,9,129,M,63,9,6,114,-15,Severe
6,6,78,F,104,13,7,163,85,Well
10,3,123,M,80,11,3,135,12,Well
15,1,181,F,24,6,5,77,-104,Severe
11,3,135,M,93,12,6,150,15,Well
6,6,78,F,79,11,1,133,55,Well
14,0,168,M,83,11,6,138,-30,Severe
8,3,99,F,57,8,10,106,7,Well
16,8,200,M,63,9,6,114,-86,Severe
5,5,65,F,12,5,9,69,4,Good
8,7,103,F,87,11,11,143,40,Well
18,5,221,F,104,13,7,163,-58,Severe
15,8,188,F,4,5,4,64,-124,Severe
17,0,204,F,11,5,8,68,-136,Severe
8,4,100,F,103,13,6,162,62,Well
15,0,180,M,109,14,1,169,-11,Severe
10,9,129,F,77,10,11,131,2,Good
7,6,90,M,50,8,3,99,9,Well
18,3,219,F,24,6,5,77,-142,Severe
16,11,203,F,24,6,5,77,-126,Severe
6,11,83,F,81,11,4,136,53,Well
10,4,124,M,57,8,10,106,-18,Severe
12,10,154,F,17,6,0,72,-82,Severe
12,7,151,F,71,10,3,123,-28,Severe
14,2,170,M,66,9,9,117,-53,Severe
18,8,224,F,55,8,8,104,-120,Severe
6,0,72,M,61,9,3,111,39,Well
17,11,215,M,2,5,3,63,-152,Severe
13,9,165,M,68,10,0,120,-45,Severe
16,3,195,F,12,5,9,69,-126,Severe
18,5,221,M,16,5,11,71,-150,Severe
15,7,187,M,50,8,3,99,-88,Severe
12,4,148,M,18,6,1,73,-75,Severe
10,1,121,M,23,6,4,76,-45,Severe
8,10,106,M,49,8,2,98,-8,Severe
16,7,199,M,67,9,10,118,-81,Severe
10,6,126,M,69,10,1,121,-5,Mild
14,11,179,M,82,11,5,137,-42,Severe
11,6,138,M,36,7,2,86,-52,Severe
17,8,212,F,32,6,10,82,-130,Severe
6,6,78,M,55,8,8,104,26,Well
10,3,123,F,58,9,0,108,-15,Severe
12,4,148,F,24,6,5,77,-71,Severe
7,3,87,F,79,11,1,133,46,Well
14,10,178,M,2,5,3,63,-115,Severe
15,7,187,F,59,9,1,109,-78,Severe
10,0,120,M,104,13,7,163,43,Well
12,0,144,M,24,6,5,77,-67,Severe
9,5,113,M,101,13,4,160,47,Well
10,4,124,M,83,11,6,138,14,Well
7,9,93,M,25,6,5,77,-16,Severe
7,6,90,M,59,9,1,109,19,Well
10,11,131,F,92,12,5,149,18,Well
15,3,183,F,56,8,9,105,-78,Severe
9,5,113,F,2,5,3,63,-50,Severe
14,4,172,M,94,12,7,151,-21,Severe
18,9,225,F,32,6,10,82,-143,Severe
8,3,99,M,92,12,5,149,50,Well
14,0,168,F,31,6,9,81,-87,Severe
15,4,184,F,65,9,8,116,-68,Severe
9,11,119,M,61,9,3,111,-8,Severe
10,11,131,F,87,11,11,143,12,Well
16,8,200,F,74,10,7,127,-73,Severe
5,1,61,M,38,7,4,88,27,Well
17,9,213,M,15,5,11,71,-142,Severe
15,3,183,F,76,10,10,130,-53,Severe
14,0,168,F,75,10,9,129,-39,Severe
13,9,165,F,67,9,10,118,-47,Severe
11,6,138,M,13,5,9,69,-69,Severe
5,5,65,F,95,12,9,153,88,Well
13,4,160,M,37,7,3,87,-73,Severe
18,3,219,M,40,7,5,89,-130,Severe
13,8,164,F,11,5,8,68,-96,Severe
10,9,129,M,88,12,0,144,15,Well
6,9,81,F,3,5,3,63,-18,Severe
12,7,151,M,47,8,0,96,-55,Severe
17,5,209,M,109,14,1,169,-40,Severe
11,10,142,F,57,8,10,106,-36,Severe
6,5,77,M,23,6,4,76,-1,Mild
7,9,93,F,80,11,3,135,42,Well
18,11,227,F,58,9,0,108,-119,Severe
9,10,118,M,94,12,7,151,33,Well
5,2,62,F,49,8,2,98,36,Well
10,11,131,F,72,10,4,124,-7,Severe
15,10,190,M,5,5,5,65,-125,Severe
5,4,64,M,78,11,0,132,68,Well
11,7,139,M,29,6,8,80,-59,Severe
5,4,64,F,13,5,9,69,5,Good
7,11,95,F,7,5,6,66,-29,Severe
10,6,126,M,103,13,6,162,36,Well
10,10,130,M,83,11,6,138,8,Well
18,2,218,M,16,5,11,71,-147,Severe
18,5,221,M,78,11,0,132,-89,Severe
14,11,179,F,77,10,11,131,-48,Severe
8,3,99,F,10,5,7,67,-32,Severe
7,4,88,M,22,6,3,75,-13,Severe
18,5,221,M,72,10,4,124,-97,Severe
13,1,157,F,108,14,0,168,11,Well
8,1,97,F,98,13,0,156,59,Well
10,6,126,F,11,5,8,68,-58,Severe
6,10,82,F,3,5,3,63,-19,Severe
13,7,163,F,94,12,7,151,-12,Severe
6,5,77,M,47,8,0,96,19,Well
18,1,217,M,47,8,0,96,-121,Severe
5,7,67,M,15,5,11,71,4,Good
12,7,151,F,89,12,1,145,-6,Severe
16,3,195,F,68,10,0,120,-75,Severe
10,1,121,M,108,14,0,168,47,Well
18,1,217,M,31,6,9,81,-136,Severe
13,6,162,F,66,9,9,117,-45,Severe
11,1,133,F,51,8,4,100,-33,Severe
10,3,123,M,23,6,4,76,-47,Severe
13,1,157,M,48,8,1,97,-60,Severe
8,2,98,M,42,7,7,91,-7,Severe
10,11,131,M,79,11,1,133,2,Good
7,6,90,M,75,10,9,129,39,Well
9,11,119,M,13,5,9,69,-50,Severe
12,3,147,F,27,6,7,79,-68,Severe
16,7,199,M,71,10,3,123,-76,Severe
8,7,103,F,21,6,2,74,-29,Severe
8,8,104,M,11,5,8,68,-36,Severe
17,1,205,M,43,7,8,92,-113,Severe
18,2,218,F,58,9,0,108,-110,Severe
17,4,208,M,97,12,11,155,-53,Severe
8,4,100,M,17,6,0,72,-28,Severe
14,5,173,M,24,6,5,77,-96,Severe
11,4,136,M,24,6,5,77,-59,Severe
18,8,224,M,92,12,5,149,-75,Severe
5,3,63,F,91,12,4,148,85,Well
6,3,75,M,41,7,6,90,15,Well
9,9,117,M,98,13,0,156,39,Well
14,8,176,F,56,8,9,105,-71,Severe
17,9,213,M,25,6,5,77,-136,Severe
10,10,130,M,67,9,10,118,-12,Severe
18,7,223,F,61,9,3,111,-112,Severe
13,2,158,F,103,13,6,162,4,Good
10,10,130,F,88,12,0,144,14,Well
18,7,223,M,58,9,0,108,-115,Severe
11,11,143,F,15,5,11,71,-72,Severe
11,8,140,M,11,5,8,68,-72,Severe
8,6,102,F,39,7,5,89,-13,Severe
8,0,96,M,8,5,6,66,-30,Severe
14,1,169,F,62,9,4,112,-57,Severe
14,9,177,M,3,5,3,63,-114,Severe
6,3,75,M,12,5,9,69,-6,Severe
16,10,202,F,91,12,4,148,-54,Severe
7,10,94,M,71,10,3,123,29,Well
8,6,102,M,93,12,6,150,48,Well
15,1,181,F,65,9,8,116,-65,Severe
7,4,88,F,21,6,2,74,-14,Severe
9,3,111,F,16,5,11,71,-40,Severe
16,11,203,F,46,7,11,95,-108,Severe
11,6,138,F,80,11,3,135,-3,Mild
15,10,190,F,43,7,8,92,-98,Severe
13,8,164,M,14,5,10,70,-94,Severe
8,9,105,M,85,11,9,141,36,Well
8,3,99,F,59,9,1,109,10,Well
15,5,185,M,60,9,2,110,-75,Severe
13,5,161,M,25,6,5,77,-84,Severe
7,4,88,F,24,6,5,77,-11,Severe
5,1,61,F,26,6,6,78,17,Well
9,6,114,F,75,10,9,129,15,Well
8,3,99,M,49,8,2,98,-1,Mild
10,6,126,F,28,6,8,80,-46,Severe
11,1,133,F,100,13,3,159,26,Well
17,5,209,M,73,10,6,126,-83,Severe
15,11,191,F,66,9,9,117,-74,Severe
14,3,171,F,65,9,8,116,-55,Severe
9,3,111,M,54,8,7,103,-8,Severe
8,4,100,F,53,8,6,102,2,Good
15,1,181,F,91,12,4,148,-33,Severe
12,10,154,F,93,12,6,150,-4,Mild
12,6,150,F,95,12,9,153,3,Good
18,6,222,M,91,12,4,148,-74,Severe
12,3,147,M,2,5,3,63,-84,Severe
5,7,67,F,100,13,3,159,92,Well
6,2,74,M,39,7,5,89,15,Well
6,1,73,M,4,5,4,64,-9,Severe
14,10,178,M,19,6,1,73,-105,Severe
9,3,111,M,48,8,1,97,-14,Severe
5,4,64,F,5,5,5,65,1,Good
18,8,224,M,27,6,7,79,-145,Severe
11,7,139,F,77,10,11,131,-8,Severe
17,3,207,F,86,11,10,142,-65,Severe
8,3,99,F,51,8,4,100,1,Good
7,6,90,M,57,8,10,106,16,Well
17,10,214,M,72,10,4,124,-90,Severe
11,0,132,F,12,5,9,69,-63,Severe
13,0,156,M,20,6,2,74,-82,Severe
15,3,183,F,63,9,6,114,-69,Severe
18,1,217,M,103,13,6,162,-55,Severe
18,6,222,M,21,6,2,74,-148,Severe
7,0,84,M,15,5,11,71,-13,Severe
6,5,77,F,49,8,2,98,21,Well
12,10,154,M,11,5,8,68,-86,Severe
7,0,84,F,97,12,11,155,71,Well
13,3,159,F,14,5,10,70,-89,Severe
15,4,184,M,107,13,11,167,-17,Severe
12,8,152,F,55,8,8,104,-48,Severe
7,7,91,M,106,13,10,166,75,Well
18,4,220,F,47,8,0,96,-124,Severe
18,9,225,F,16,5,11,71,-154,Severe
17,10,214,F,37,7,3,87,-127,Severe
6,9,81,F,12,5,9,69,-12,Severe
8,8,104,M,33,6,11,83,-21,Severe
18,2,218,F,107,13,11,167,-51,Severe
18,1,217,M,106,13,10,166,-51,Severe
13,3,159,M,57,8,10,106,-53,Severe
9,3,111,F,3,5,3,63,-48,Severe
5,8,68,F,84,11,7,139,71,Well
10,7,127,M,45,7,10,94,-33,Severe
10,3,123,M,26,6,6,78,-45,Severe
15,1,181,M,105,13,9,165,-16,Severe
8,3,99,M,9,5,7,67,-32,Severe
8,11,107,M,63,9,6,114,7,Well
11,3,135,M,109,14,1,169,34,Well
9,3,111,M,24,6,5,77,-34,Severe
5,11,71,F,45,7,10,94,23,Well
6,2,74,F,34,7,0,84,10,Well
10,3,123,M,83,11,6,138,15,Well
7,1,85,F,28,6,8,80,-5,Mild
16,7,199,M,73,10,6,126,-73,Severe
5,9,69,F,65,9,8,116,47,Well
5,4,64,M,100,13,3,159,95,Well
14,7,175,F,74,10,7,127,-48,Severe
6,1,73,M,94,12,7,151,78,Well
14,7,175,M,5,5,5,65,-110,Severe
15,8,188,F,109,14,1,169,-19,Severe
10,3,123,F,81,11,4,136,13,Well
13,4,160,F,88,12,0,144,-16,Severe
6,7,79,M,10,5,7,67,-12,Severe
11,4,136,F,18,6,1,73,-63,Severe
18,6,222,M,52,8,5,101,-121,Severe
18,3,219,F,50,8,3,99,-120,Severe
11,5,137,F,43,7,8,92,-45,Severe
5,4,64,M,110,14,3,171,107,Well
18,0,216,F,28,6,8,80,-136,Severe
8,3,99,M,87,11,11,143,44,Well
12,10,154,M,2,5,3,63,-91,Severe
15,11,191,M,14,5,10,70,-121,Severe
18,5,221,M,26,6,6,78,-143,Severe
14,8,176,M,36,7,2,86,-90,Severe
13,4,160,M,106,13,10,166,6,Well
6,6,78,F,57,8,10,106,28,Well
10,6,126,F,2,5,3,63,-63,Severe
10,8,128,F,56,8,9,105,-23,Severe
13,8,164,F,47,8,0,96,-68,Severe
6,10,82,F,100,13,3,159,77,Well
10,1,121,M,4,5,4,64,-57,Severe
16,2,194,F,56,8,9,105,-89,Severe
8,9,105,F,110,14,3,171,66,Well
9,0,108,F,21,6,2,74,-34,Severe
9,5,113,M,98,13,0,156,43,Well
13,8,164,F,42,7,7,91,-73,Severe
18,3,219,F,19,6,1,73,-146,Severe
10,3,123,M,40,7,5,89,-34,Severe
6,10,82,M,22,6,3,75,-7,Severe
17,3,207,F,61,9,3,111,-96,Severe
15,3,183,F,40,7,5,89,-94,Severe
7,2,86,F,11,5,8,68,-18,Severe
6,2,74,F,87,11,11,143,69,Well
17,6,210,M,13,5,9,69,-141,Severe
11,1,133,F,21,6,2,74,-59,Severe
11,9,141,F,62,9,4,112,-29,Severe
18,3,219,M,35,7,1,85,-134,Severe
10,5,125,F,15,5,11,71,-54,Severe
9,1,109,M,79,11,1,133,24,Well
8,3,99,F,33,6,11,83,-16,Severe
9,3,111,F,30,6,9,81,-30,Severe
15,2,182,M,24,6,5,77,-105,Severe
6,3,75,M,8,5,6,66,-9,Severe
18,4,220,F,32,6,10,82,-138,Severe
11,5,137,M,12,5,9,69,-68,Severe
14,8,176,M,7,5,6,66,-110,Severe
17,6,210,F,75,10,9,129,-81,Severe
17,5,209,M,53,8,6,102,-107,Severe
8,6,102,M,10,5,7,67,-35,Severe
12,5,149,M,80,11,3,135,-14,Severe
12,5,149,F,14,5,10,70,-79,Severe
17,3,207,F,21,6,2,74,-133,Severe
5,6,66,F,40,7,5,89,23,Well
9,7,115,F,20,6,2,74,-41,Severe
8,3,99,M,108,14,0,168,69,Well
13,0,156,F,51,8,4,100,-56,Severe
17,2,206,F,58,9,0,108,-98,Severe
8,6,102,F,94,12,7,151,49,Well
15,3,183,F,108,14,0,168,-15,Severe
8,4,100,F,99,13,1,157,57,Well
6,4,76,F,15,5,11,71,-5,Mild
12,1,145,M,93,12,6,150,5,Good
14,10,178,F,33,6,11,83,-95,Severe
18,11,227,F,107,13,11,167,-60,Severe
11,7,139,M,82,11,5,137,-2,Mild
14,3,171,F,98,13,0,156,-15,Severe
11,4,136,F,42,7,7,91,-45,Severe
15,2,182,M,43,7,8,92,-90,Severe
15,1,181,F,68,10,0,120,-61,Severe
6,6,78,M,76,10,10,130,52,Well
14,8,176,M,47,8,0,96,-80,Severe
14,1,169,M,98,13,0,156,-13,Severe
5,3,63,F,27,6,7,79,16,Well
5,4,64,F,102,13,6,162,98,Well
13,1,157,F,11,5,8,68,-89,Severe
6,10,82,F,87,11,11,143,61,Well
6,3,75,M,69,10,1,121,46,Well
6,10,82,M,27,6,7,79,-3,Mild
15,7,187,M,27,6,7,79,-108,Severe
7,3,87,M,101,13,4,160,73,Well
11,11,143,M,92,12,5,149,6,Well
10,6,126,F,71,10,3,123,-3,Mild
15,3,183,F,104,13,7,163,-20,Severe
11,5,137,F,40,7,5,89,-48,Severe
5,5,65,M,61,9,3,111,46,Well
12,8,152,M,69,10,1,121,-31,Severe
14,10,178,M,81,11,4,136,-42,Severe
18,2,218,F,8,5,6,66,-152,Severe
18,3,219,F,17,6,0,72,-147,Severe
15,5,185,F,16,5,11,71,-114,Severe
6,3,75,F,78,11,0,132,57,Well
18,10,226,F,81,11,4,136,-90,Severe
15,4,184,F,73,10,6,126,-58,Severe
7,10,94,F,97,12,11,155,61,Well
12,2,146,M,9,5,7,67,-79,Severe
9,1,109,F,110,14,3,171,62,Well
11,7,139,F,4,5,4,64,-75,Severe
16,9,201,F,72,10,4,124,-77,Severe
9,11,119,F,7,5,6,66,-53,Severe
14,10,178,F,91,12,4,148,-30,Severe
16,5,197,F,29,6,8,80,-117,Severe
18,11,227,M,92,12,5,149,-78,Severe
5,10,70,M,3,5,3,63,-7,Severe
14,6,174,M,27,6,7,79,-95,Severe
16,0,192,F,46,7,11,95,-97,Severe
17,3,207,M,19,6,1,73,-134,Severe
5,8,68,M,42,7,7,91,23,Well
18,8,224,F,14,5,10,70,-154,Severe
9,10,118,M,63,9,6,114,-4,Mild
16,11,203,F,60,9,2,110,-93,Severe
6,7,79,F,81,11,4,136,57,Well
8,3,99,F,40,7,5,89,-10,Severe
18,1,217,F,98,13,0,156,-61,Severe
14,1,169,M,16,5,11,71,-98,Severe
8,0,96,F,95,12,9,153,57,Well
9,3,111,F,76,10,10,130,19,Well
7,8,92,F,40,7,5,89,-3,Mild
7,1,85,F,43,7,8,92,7,Well
10,11,131,F,100,13,3,159,28,Well
9,0,108,F,33,6,11,83,-25,Severe
9,11,119,F,70,10,2,122,3,Good
10,9,129,F,14,5,10,70,-59,Severe
16,4,196,F,10,5,7,67,-129,Severe
9,5,113,M,22,6,3,75,-38,Severe
12,8,152,F,25,6,5,77,-75,Severe
12,5,149,M,98,13,0,156,7,Well
12,0,144,F,26,6,6,78,-66,Severe
17,3,207,F,107,13,11,167,-40,Severe
7,11,95,M,19,6,1,73,-22,Severe
12,6,150,M,90,12,3,147,-3,Mild
16,9,201,M,66,9,9,117,-84,Severe
8,5,101,F,95,12,9,153,52,Well
15,2,182,F,110,14,3,171,-11,Severe
12,8,152,M,38,7,4,88,-64,Severe
10,6,126,F,22,6,3,75,-51,Severe
16,8,200,F,72,10,4,124,-76,Severe
8,7,103,M,17,6,0,72,-31,Severe
7,9,93,M,59,9,1,109,16,Well
13,0,156,F,9,5,7,67,-89,Severe
17,9,213,F,41,7,6,90,-123,Severe
8,0,96,M,107,13,11,167,71,Well
9,3,111,F,74,10,7,127,16,Well
15,8,188,F,12,5,9,69,-119,Severe
7,2,86,M,84,11,7,139,53,Well
7,0,84,F,36,7,2,86,2,Good
8,0,96,M,51,8,4,100,4,Good
18,3,219,M,56,8,9,105,-114,Severe
18,11,227,M,13,5,9,69,-158,Severe
15,6,186,F,19,6,1,73,-113,Severe
14,3,171,M,14,5,10,70,-101,Severe
15,8,188,M,82,11,5,137,-51,Severe
15,4,184,F,45,7,10,94,-90,Severe
16,11,203,F,71,10,3,123,-80,Severe
15,9,189,F,2,5,3,63,-126,Severe
8,9,105,M,101,13,4,160,55,Well
9,7,115,F,26,6,6,78,-37,Severe
14,3,171,F,49,8,2,98,-73,Severe
12,1,145,F,78,11,0,132,-13,Severe
18,3,219,M,80,11,3,135,-84,Severe
17,9,213,M,94,12,7,151,-62,Severe
13,1,157,F,31,6,9,81,-76,Severe
17,10,214,M,64,9,7,115,-99,Severe
15,1,181,F,66,9,9,117,-64,Severe
18,6,222,F,5,5,5,65,-157,Severe
13,3,159,F,101,13,4,160,1,Good
7,3,87,M,86,11,10,142,55,Well
15,3,183,M,87,11,11,143,-40,Severe
17,2,206,F,76,10,10,130,-76,Severe
14,2,170,M,2,5,3,63,-107,Severe
12,7,151,F,105,13,9,165,14,Well
7,8,92,F,71,10,3,123,31,Well
17,5,209,F,17,6,0,72,-137,Severe
18,2,218,M,30,6,9,81,-137,Severe
18,3,219,M,85,11,9,141,-78,Severe
9,10,118,F,106,13,10,166,48,Well
13,11,167,F,81,11,4,136,-31,Severe
10,9,129,M,80,11,3,135,6,Well
12,4,148,M,38,7,4,88,-60,Severe
7,4,88,F,48,8,1,97,9,Well
12,2,146,M,35,7,1,85,-61,Severe
6,3,75,F,66,9,9,117,42,Well
16,11,203,M,101,13,4,160,-43,Severe
10,4,124,M,105,13,9,165,41,Well
7,10,94,F,27,6,7,79,-15,Severe
6,2,74,M,86,11,10,142,68,Well
11,1,133,M,59,9,1,109,-24,Severe
13,7,163,F,76,10,10,130,-33,Severe
16,6,198,M,104,13,7,163,-35,Severe
17,0,204,M,76,10,10,130,-74,Severe
9,5,113,F,103,13,6,162,49,Well
6,4,76,M,3,5,3,63,-13,Severe
12,11,155,F,73,10,6,126,-29,Severe
15,10,190,M,67,9,10,118,-72,Severe
5,3,63,M,92,12,5,149,86,Well
17,0,204,F,17,6,0,72,-132,Severe
18,8,224,F,30,6,9,81,-143,Severe
5,7,67,F,21,6,2,74,7,Well
16,9,201,M,3,5,3,63,-138,Severe
7,6,90,M,82,11,5,137,47,Well
13,7,163,F,70,10,2,122,-41,Severe
7,1,85,M,24,6,5,77,-8,Severe
7,0,84,M,72,10,4,124,40,Well
12,4,148,F,55,8,8,104,-44,Severe
13,9,165,F,47,8,0,96,-69,Severe
7,1,85,F,67,9,10,118,33,Well
6,3,75,M,43,7,8,92,17,Well
10,0,120,M,90,12,3,147,27,Well
12,9,153,M,96,12,10,154,1,Good
12,9,153,F,75,10,9,129,-24,Severe
12,3,147,F,82,11,5,137,-10,Severe
15,0,180,F,2,5,3,63,-117,Severe
18,9,225,F,69,10,1,121,-104,Severe
11,3,135,F,49,8,2,98,-37,Severe
14,6,174,F,83,11,6,138,-36,Severe
12,8,152,F,78,11,0,132,-20,Severe
14,2,170,F,70,10,2,122,-48,Severe
12,5,149,F,22,6,3,75,-74,Severe
16,5,197,F,55,8,8,104,-93,Severe
16,6,198,M,23,6,4,76,-122,Severe
11,4,136,M,106,13,10,166,30,Well
13,3,159,M,55,8,8,104,-55,Severe
10,1,121,M,24,6,5,77,-44,Severe
15,2,182,M,70,10,2,122,-60,Severe
10,0,120,M,33,6,11,83,-37,Severe
10,5,125,F,8,5,6,66,-59,Severe
12,5,149,F,26,6,6,78,-71,Severe
15,1,181,F,16,5,11,71,-110,Severe
5,9,69,M,43,7,8,92,23,Well
9,11,119,M,83,11,6,138,19,Well
9,7,115,F,68,10,0,120,5,Good
6,9,81,F,55,8,8,104,23,Well
14,0,168,M,56,8,9,105,-63,Severe
7,4,88,M,64,9,7,115,27,Well
8,9,105,F,30,6,9,81,-24,Severe
12,11,155,F,92,12,5,149,-6,Severe
16,3,195,F,41,7,6,90,-105,Severe
16,10,202,F,66,9,9,117,-85,Severe
17,6,210,F,39,7,5,89,-121,Severe
8,0,96,F,18,6,1,73,-23,Severe
8,10,106,F,35,7,1,85,-21,Severe
7,0,84,M,66,9,9,117,33,Well
15,8,188,F,87,11,11,143,-45,Severe
16,11,203,M,109,14,1,169,-34,Severe
10,9,129,M,107,13,11,167,38,Well
8,9,105,F,62,9,4,112,7,Well
18,3,219,F,48,8,1,97,-122,Severe
5,1,61,M,93,12,6,150,89,Well
18,7,223,M,53,8,6,102,-121,Severe
18,3,219,M,21,6,2,74,-145,Severe
18,10,226,F,27,6,7,79,-147,Severe
9,3,111,M,99,13,1,157,46,Well
18,3,219,M,40,7,5,89,-130,Severe
6,0,72,M,106,13,10,166,94,Well
11,10,142,F,58,9,0,108,-34,Severe
15,7,187,F,109,14,1,169,-18,Severe
8,5,101,M,59,9,1,109,8,Well
15,11,191,F,92,12,5,149,-42,Severe
16,8,200,M,40,7,5,89,-111,Severe
15,1,181,M,16,5,11,71,-110,Severe
17,3,207,M,37,7,3,87,-120,Severe
8,3,99,F,78,11,0,132,33,Well
13,6,162,M,12,5,9,69,-93,Severe
6,10,82,F,93,12,6,150,68,Well
18,5,221,M,57,8,10,106,-115,Severe
5,11,71,F,72,10,4,124,53,Well
15,8,188,M,34,7,0,84,-104,Severe
11,3,135,M,24,6,5,77,-58,Severe
12,10,154,M,58,9,0,108,-46,Severe
18,11,227,F,43,7,8,92,-135,Severe
17,5,209,F,9,5,7,67,-142,Severe
6,7,79,F,109,14,1,169,90,Well
17,4,208,F,81,11,4,136,-72,Severe
16,8,200,M,100,13,3,159,-41,Severe
8,2,98,M,47,8,0,96,-2,Mild
8,6,102,M,52,8,5,101,-1,Mild
9,3,111,M,88,12,0,144,33,Well
17,10,214,M,27,6,7,79,-135,Severe
13,6,162,M,47,8,0,96,-66,Severe
9,0,108,M,90,12,3,147,39,Well
5,10,70,M,37,7,3,87,17,Well
5,2,62,M,4,5,4,64,2,Good
17,9,213,F,21,6,2,74,-139,Severe
8,4,100,F,47,8,0,96,-4,Mild
6,2,74,M,89,12,1,145,71,Well
10,10,130,M,82,11,5,137,7,Well
12,7,151,M,16,5,11,71,-80,Severe
15,10,190,F,14,5,10,70,-120,Severe
15,3,183,M,10,5,7,67,-116,Severe
7,2,86,F,33,6,11,83,-3,Mild
6,0,72,F,32,6,10,82,10,Well
13,8,164,F,94,12,7,151,-13,Severe
15,10,190,F,76,10,10,130,-60,Severe
15,9,189,M,4,5,4,64,-125,Severe
17,10,214,M,10,5,7,67,-147,Severe
8,10,106,F,18,6,1,73,-33,Severe
5,5,65,F,32,6,10,82,17,Well
9,5,113,F,9,5,7,67,-46,Severe
12,11,155,M,52,8,5,101,-54,Severe
17,5,209,F,29,6,8,80,-129,Severe
12,0,144,M,55,8,8,104,-40,Severe
14,7,175,F,34,7,0,84,-91,Severe
17,1,205,M,81,11,4,136,-69,Severe
15,2,182,M,44,7,9,93,-89,Severe
5,0,60,F,61,9,3,111,51,Well
7,3,87,M,5,5,5,65,-22,Severe
11,7,139,M,23,6,4,76,-63,Severe
18,9,225,F,71,10,3,123,-102,Severe
8,11,107,F,66,9,9,117,10,Well
6,2,74,M,47,8,0,96,22,Well
6,3,75,F,55,8,8,104,29,Well
5,5,65,F,15,5,11,71,6,Well
11,2,134,F,15,5,11,71,-63,Severe
5,10,70,F,89,12,1,145,75,Well
10,3,123,M,3,5,3,63,-60,Severe
13,1,157,F,44,7,9,93,-64,Severe
9,2,110,F,3,5,3,63,-47,Severe
14,6,174,M,5,5,5,65,-109,Severe
5,3,63,M,69,10,1,121,58,Well
13,3,159,M,54,8,7,103,-56,Severe
9,8,116,M,96,12,10,154,38,Well
8,3,99,F,23,6,4,76,-23,Severe
9,1,109,F,28,6,8,80,-29,Severe
16,2,194,F,45,7,10,94,-100,Severe
11,5,137,F,51,8,4,100,-37,Severe
18,10,226,M,66,9,9,117,-109,Severe
14,3,171,M,58,9,0,108,-63,Severe
7,10,94,F,104,13,7,163,69,Well
12,8,152,M,68,10,0,120,-32,Severe
9,9,117,M,23,6,4,76,-41,Severe
17,3,207,M,60,9,2,110,-97,Severe
12,1,145,M,74,10,7,127,-18,Severe
15,3,183,M,6,5,5,65,-118,Severe
13,1,157,M,27,6,7,79,-78,Severe
9,3,111,M,57,8,10,106,-5,Mild
16,4,196,M,100,13,3,159,-37,Severe
14,11,179,F,80,11,3,135,-44,Severe
7,5,89,F,27,6,7,79,-10,Severe
14,9,177,F,52,8,5,101,-76,Severe
9,10,118,F,12,5,9,69,-49,Severe
7,6,90,M,71,10,3,123,33,Well
7,2,86,M,72,10,4,124,38,Well
12,1,145,F,84,11,7,139,-6,Severe
14,6,174,F,62,9,4,112,-62,Severe
8,4,100,F,13,5,9,69,-31,Severe
6,11,83,F,6,5,5,65,-18,Severe
11,8,140,F,66,9,9,117,-23,Severe
17,7,211,F,109,14,1,169,-42,Severe
5,3,63,F,85,11,9,141,78,Well
11,1,133,F,87,11,11,143,10,Well
9,3,111,M,20,6,2,74,-37,Severe
8,5,101,M,50,8,3,99,-2,Mild
5,4,64,M,60,9,2,110,46,Well
5,10,70,F,74,10,7,127,57,Well
8,10,106,F,38,7,4,88,-18,Severe
7,5,89,M,51,8,4,100,11,Well
9,3,111,F,8,5,6,66,-45,Severe
9,7,115,F,23,6,4,76,-39,Severe
8,10,106,F,20,6,2,74,-32,Severe
9,8,116,M,91,12,4,148,32,Well
11,9,141,M,61,9,3,111,-30,Severe
8,1,97,F,23,6,4,76,-21,Severe
6,6,78,M,30,6,9,81,3,Good
12,10,154,F,25,6,5,77,-77,Severe
17,11,215,F,25,6,5,77,-138,Severe
6,1,73,M,68,10,0,120,47,Well
10,0,120,F,47,8,0,96,-24,Severe
11,11,143,M,93,12,6,150,7,Well
17,11,215,F,97,12,11,155,-60,Severe
7,6,90,M,9,5,7,67,-23,Severe
16,3,195,F,40,7,5,89,-106,Severe
13,10,166,M,91,12,4,148,-18,Severe
6,0,72,M,55,8,8,104,32,Well
9,0,108,M,51,8,4,100,-8,Severe
12,9,153,M,97,12,11,155,2,Good
13,0,156,F,78,11,0,132,-24,Severe
18,3,219,M,15,5,11,71,-148,Severe
16,10,202,M,65,9,8,116,-86,Severe
15,7,187,F,6,5,5,65,-122,Severe
8,2,98,M,38,7,4,88,-10,Severe
16,1,193,F,97,12,11,155,-38,Severe
7,0,84,F,106,13,10,166,82,Well
12,8,152,M,95,12,9,153,1,Good
9,9,117,F,89,12,1,145,28,Well
12,2,146,M,55,8,8,104,-42,Severe
12,10,154,M,60,9,2,110,-44,Severe
9,10,118,M,66,9,9,117,-1,Mild
11,8,140,F,75,10,9,129,-11,Severe
18,10,226,F,48,8,1,97,-129,Severe
14,3,171,M,5,5,5,65,-106,Severe
17,11,215,F,48,8,1,97,-118,Severe
7,5,89,F,26,6,6,78,-11,Severe
13,1,157,F,90,12,3,147,-10,Severe
7,7,91,F,102,13,6,162,71,Well
17,9,213,F,33,6,11,83,-130,Severe
13,2,158,F,48,8,1,97,-61,Severe
7,2,86,M,8,5,6,66,-20,Severe
12,0,144,F,22,6,3,75,-69,Severe
12,11,155,M,102,13,6,162,7,Well
14,4,172,F,59,9,1,109,-63,Severe
15,8,188,M,73,10,6,126,-62,Severe
14,9,177,M,101,13,4,160,-17,Severe
5,7,67,M,6,5,5,65,-2,Mild
9,5,113,M,88,12,0,144,31,Well
11,6,138,M,81,11,4,136,-2,Mild
11,6,138,F,107,13,11,167,29,Well
8,11,107,F,86,11,10,142,35,Well
5,11,71,F,74,10,7,127,56,Well
15,4,184,F,68,10,0,120,-64,Severe
8,5,101,F,74,10,7,127,26,Well
18,10,226,F,80,11,3,135,-91,Severe
13,1,157,M,102,13,6,162,5,Good
14,11,179,M,104,13,7,163,-16,Severe
7,7,91,F,46,7,11,95,4,Good
5,3,63,F,64,9,7,115,52,Well
13,7,163,M,104,13,7,163,0,Neutral
16,7,199,M,64,9,7,115,-84,Severe
13,11,167,F,74,10,7,127,-40,Severe
16,11,203,M,66,9,9,117,-86,Severe
18,11,227,M,12,5,9,69,-158,Severe
9,8,116,F,51,8,4,100,-16,Severe
17,10,214,F,15,5,11,71,-143,Severe
7,2,86,F,22,6,3,75,-11,Severe
14,5,173,F,23,6,4,76,-97,Severe
6,4,76,F,9,5,7,67,-9,Severe
13,7,163,M,105,13,9,165,2,Good
9,6,114,F,35,7,1,85,-29,Severe
12,3,147,F,17,6,0,72,-75,Severe
13,11,167,M,79,11,1,133,-34,Severe
5,7,67,F,33,6,11,83,16,Well
5,5,65,M,82,11,5,137,72,Well
5,3,63,M,89,12,1,145,82,Well
12,9,153,M,60,9,2,110,-43,Severe
18,9,225,M,63,9,6,114,-111,Severe
7,9,93,F,82,11,5,137,44,Well
9,1,109,M,36,7,2,86,-23,Severe
12,7,151,F,103,13,6,162,11,Well
7,5,89,F,91,12,4,148,59,Well
17,3,207,F,5,5,5,65,-142,Severe
5,0,60,F,48,8,1,97,37,Well
8,8,104,M,77,10,11,131,27,Well
13,7,163,F,105,13,9,165,2,Good
6,5,77,M,48,8,1,97,20,Well
12,11,155,M,44,7,9,93,-62,Severe
14,5,173,M,41,7,6,90,-83,Severe
8,9,105,M,61,9,3,111,6,Well
13,2,158,M,97,12,11,155,-3,Mild
10,7,127,M,90,12,3,147,20,Well
18,9,225,F,9,5,7,67,-158,Severe
18,1,217,F,82,11,5,137,-80,Severe
6,1,73,F,53,8,6,102,29,Well
8,5,101,M,45,7,10,94,-7,Severe
15,1,181,M,69,10,1,121,-60,Severe
9,7,115,M,18,6,1,73,-42,Severe
11,11,143,F,96,12,10,154,11,Well
6,1,73,F,28,6,8,80,7,Well
16,10,202,M,52,8,5,101,-101,Severe
16,5,197,M,16,5,11,71,-126,Severe
5,9,69,F,57,8,10,106,37,Well
16,6,198,F,4,5,4,64,-134,Severe
6,6,78,F,61,9,3,111,33,Well
14,0,168,M,104,13,7,163,-5,Mild
6,0,72,M,79,11,1,133,61,Well
13,10,166,M,85,11,9,141,-25,Severe
16,5,197,F,23,6,4,76,-121,Severe
8,8,104,F,11,5,8,68,-36,Severe
5,2,62,M,69,10,1,121,59,Well
16,6,198,M,47,8,0,96,-102,Severe
13,3,159,F,15,5,11,71,-88,Severe
10,3,123,M,40,7,5,89,-34,Severe
17,11,215,F,72,10,4,124,-91,Severe
15,3,183,M,92,12,5,149,-34,Severe
6,7,79,F,48,8,1,97,18,Well
17,7,211,M,103,13,6,162,-49,Severe
14,7,175,F,92,12,5,149,-26,Severe
14,0,168,F,34,7,0,84,-84,Severe
7,8,92,M,2,5,3,63,-29,Severe
17,6,210,M,14,5,10,70,-140,Severe
5,5,65,F,106,13,10,166,101,Well
6,11,83,F,33,6,11,83,0,Neutral
5,7,67,F,57,8,10,106,39,Well
14,6,174,M,41,7,6,90,-84,Severe
6,4,76,F,98,13,0,156,80,Well
12,6,150,M,21,6,2,74,-76,Severe
5,3,63,M,84,11,7,139,76,Well
14,11,179,F,85,11,9,141,-38,Severe
18,5,221,F,32,6,10,82,-139,Severe
18,7,223,M,83,11,6,138,-85,Severe
6,2,74,F,56,8,9,105,31,Well
16,11,203,M,99,13,1,157,-46,Severe
11,3,135,M,94,12,7,151,16,Well
6,10,82,F,38,7,4,88,6,Well
8,1,97,M,47,8,0,96,-1,Mild
18,7,223,M,82,11,5,137,-86,Severe
17,6,210,M,2,5,3,63,-147,Severe
16,11,203,M,89,12,1,145,-58,Severe
17,8,212,M,46,7,11,95,-117,Severe
11,0,132,M,68,10,0,120,-12,Severe
18,3,219,M,106,13,10,166,-53,Severe
15,11,191,M,51,8,4,100,-91,Severe
7,10,94,M,37,7,3,87,-7,Severe
8,4,100,M,13,5,9,69,-31,Severe
18,5,221,F,25,6,5,77,-144,Severe
9,0,108,F,54,8,7,103,-5,Mild
8,6,102,F,70,10,2,122,20,Well
15,8,188,M,96,12,10,154,-34,Severe
13,2,158,F,69,10,1,121,-37,Severe
12,7,151,M,72,10,4,124,-27,Severe
12,2,146,F,97,12,11,155,9,Well
7,6,90,F,84,11,7,139,49,Well
6,4,76,F,41,7,6,90,14,Well
13,1,157,F,33,6,11,83,-74,Severe
17,7,211,M,48,8,1,97,-114,Severe
15,11,191,M,100,13,3,159,-32,Severe
8,8,104,F,36,7,2,86,-18,Severe
5,8,68,M,36,7,2,86,18,Well
17,5,209,M,82,11,5,137,-72,Severe
5,5,65,F,102,13,6,162,97,Well
10,3,123,F,108,14,0,168,45,Well
8,2,98,F,103,13,6,162,64,Well
5,6,66,M,99,13,1,157,91,Well
8,0,96,F,108,14,0,168,72,Well
18,6,222,F,86,11,10,142,-80,Severe
15,2,182,M,98,13,0,156,-26,Severe
6,11,83,M,58,9,0,108,25,Well
10,1,121,F,37,7,3,87,-34,Severe
5,2,62,M,2,5,3,63,1,Good
12,1,145,M,23,6,4,76,-69,Severe
7,10,94,M,98,13,0,156,62,Well
17,3,207,F,47,8,0,96,-111,Severe
13,3,159,M,29,6,8,80,-79,Severe
18,10,226,F,46,7,11,95,-131,Severe
15,8,188,M,16,5,11,71,-117,Severe
9,7,115,F,72,10,4,124,9,Well
6,10,82,M,78,11,0,132,50,Well
5,11,71,F,108,14,0,168,97,Well
6,1,73,F,96,12,10,154,81,Well
17,5,209,F,24,6,5,77,-132,Severe
16,3,195,M,84,11,7,139,-56,Severe
5,1,61,M,70,10,2,122,61,Well
5,10,70,M,25,6,5,77,7,Well
12,8,152,M,108,14,0,168,16,Well
13,6,162,F,50,8,3,99,-63,Severe
12,7,151,M,87,11,11,143,-8,Severe
18,11,227,M,106,13,10,166,-61,Severe
15,9,189,M,49,8,2,98,-91,Severe
18,2,218,F,79,11,1,133,-85,Severe
5,9,69,F,96,12,10,154,85,Well
15,5,185,F,72,10,4,124,-61,Severe
11,3,135,F,73,10,6,126,-9,Severe
13,11,167,F,38,7,4,88,-79,Severe
15,3,183,F,73,10,6,126,-57,Severe
14,0,168,M,109,14,1,169,1,Good
15,10,190,F,24,6,5,77,-113,Severe
6,11,83,F,108,14,0,168,85,Well
6,9,81,F,90,12,3,147,66,Well
8,8,104,M,45,7,10,94,-10,Severe
10,4,124,F,35,7,1,85,-39,Severe
9,3,111,M,79,11,1,133,22,Well
10,9,129,M,48,8,1,97,-32,Severe
10,0,120,M,52,8,5,101,-19,Severe
7,4,88,F,6,5,5,65,-23,Severe
14,9,177,M,27,6,7,79,-98,Severe
7,6,90,M,96,12,10,154,64,Well
10,8,128,M,104,13,7,163,35,Well
12,1,145,M,35,7,1,85,-60,Severe
18,11,227,F,31,6,9,81,-146,Severe
5,1,61,F,100,13,3,159,98,Well
15,1,181,F,77,10,11,131,-50,Severe
8,2,98,F,82,11,5,137,39,Well
18,9,225,F,94,12,7,151,-74,Severe
14,4,172,F,81,11,4,136,-36,Severe
6,3,75,M,100,13,3,159,84,Well
11,4,136,M,108,14,0,168,32,Well
16,5,197,M,4,5,4,64,-133,Severe
14,8,176,F,76,10,10,130,-46,Severe
14,8,176,M,103,13,6,162,-14,Severe
15,10,190,F,19,6,1,73,-117,Severe
17,9,213,M,99,13,1,157,-56,Severe
13,11,167,F,87,11,11,143,-24,Severe
7,2,86,M,18,6,1,73,-13,Severe
13,11,167,M,25,6,5,77,-90,Severe
13,3,159,F,30,6,9,81,-78,Severe
9,9,117,F,91,12,4,148,31,Well
9,8,116,F,21,6,2,74,-42,Severe
13,5,161,F,30,6,9,81,-80,Severe
14,6,174,F,13,5,9,69,-105,Severe
7,6,90,F,61,9,3,111,21,Well
18,11,227,M,77,10,11,131,-96,Severe
13,2,158,F,109,14,1,169,11,Well
5,8,68,F,80,11,3,135,67,Well
12,0,144,F,79,11,1,133,-11,Severe
17,6,210,F,68,10,0,120,-90,Severe
11,4,136,M,92,12,5,149,13,Well
14,3,171,M,101,13,4,160,-11,Severe
18,0,216,F,8,5,6,66,-150,Severe
7,3,87,F,43,7,8,92,5,Good
18,11,227,M,43,7,8,92,-135,Severe
6,3,75,F,64,9,7,115,40,Well
10,11,131,M,61,9,3,111,-20,Severe
11,9,141,M,57,8,10,106,-35,Severe
12,4,148,F,31,6,9,81,-67,Severe
10,10,130,F,92,12,5,149,19,Well
11,2,134,F,19,6,1,73,-61,Severe
16,8,200,F,85,11,9,141,-59,Severe
18,3,219,M,3,5,3,63,-156,Severe
6,3,75,M,55,8,8,104,29,Well
12,11,155,M,35,7,1,85,-70,Severe
10,1,121,M,58,9,0,108,-13,Severe
15,1,181,F,28,6,8,80,-101,Severe
9,11,119,F,105,13,9,165,46,Well
13,9,165,F,7,5,6,66,-99,Severe
8,9,105,M,25,6,5,77,-28,Severe
14,7,175,F,9,5,7,67,-108,Severe
17,8,212,F,52,8,5,101,-111,Severe
10,10,130,F,58,9,0,108,-22,Severe
11,10,142,M,29,6,8,80,-62,Severe
12,2,146,M,71,10,3,123,-23,Severe
17,3,207,M,28,6,8,80,-127,Severe
9,2,110,M,22,6,3,75,-35,Severe
9,1,109,M,92,12,5,149,40,Well
9,2,110,M,27,6,7,79,-31,Severe
16,8,200,F,82,11,5,137,-63,Severe
11,10,142,M,110,14,3,171,29,Well
15,9,189,F,65,9,8,116,-73,Severe
17,11,215,M,96,12,10,154,-61,Severe
18,9,225,M,109,14,1,169,-56,Severe
11,3,135,M,94,12,7,151,16,Well
10,7,127,F,13,5,9,69,-58,Severe
14,5,173,F,5,5,5,65,-108,Severe
11,2,134,M,60,9,2,110,-24,Severe
9,2,110,F,36,7,2,86,-24,Severe
17,8,212,F,100,13,3,159,-53,Severe
7,4,88,F,98,13,0,156,68,Well
10,0,120,F,68,10,0,120,0,Neutral
10,10,130,M,55,8,8,104,-26,Severe
5,10,70,M,94,12,7,151,81,Well
12,9,153,F,47,8,0,96,-57,Severe
10,7,127,M,78,11,0,132,5,Good
18,7,223,M,48,8,1,97,-126,Severe
17,5,209,M,56,8,9,105,-104,Severe
17,1,205,M,3,5,3,63,-142,Severe
17,6,210,M,56,8,9,105,-105,Severe
18,8,224,F,88,12,0,144,-80,Severe
10,11,131,M,37,7,3,87,-44,Severe
11,10,142,F,26,6,6,78,-64,Severe
14,0,168,M,4,5,4,64,-104,Severe
11,6,138,F,17,6,0,72,-66,Severe
13,8,164,F,36,7,2,86,-78,Severe
6,7,79,M,59,9,1,109,30,Well
12,8,152,F,41,7,6,90,-62,Severe
11,3,135,F,94,12,7,151,16,Well
15,9,189,F,45,7,10,94,-95,Severe
10,7,127,M,7,5,6,66,-61,Severe
5,2,62,F,4,5,4,64,2,Good
13,2,158,F,104,13,7,163,5,Good
6,2,74,F,66,9,9,117,43,Well
11,3,135,F,38,7,4,88,-47,Severe
14,7,175,M,60,9,2,110,-65,Severe
6,6,78,M,90,12,3,147,69,Well
12,2,146,M,97,12,11,155,9,Well
5,3,63,M,3,5,3,63,0,Neutral
6,0,72,M,4,5,4,64,-8,Severe
10,8,128,F,102,13,6,162,34,Well
12,7,151,F,60,9,2,110,-41,Severe
17,8,212,M,101,13,4,160,-52,Severe
12,0,144,F,16,5,11,71,-73,Severe
7,11,95,F,102,13,6,162,67,Well
13,3,159,M,61,9,3,111,-48,Severe
11,11,143,M,13,5,9,69,-74,Severe
13,11,167,M,56,8,9,105,-62,Severe
13,3,159,F,50,8,3,99,-60,Severe
5,6,66,F,15,5,11,71,5,Good
5,9,69,F,10,5,7,67,-2,Mild
15,0,180,F,24,6,5,77,-103,Severe
10,2,122,M,44,7,9,93,-29,Severe
5,6,66,F,57,8,10,106,40,Well
16,4,196,F,17,6,0,72,-124,Severe
15,9,189,M,52,8,5,101,-88,Severe
12,2,146,F,88,12,0,144,-2,Mild
9,3,111,M,66,9,9,117,6,Well
8,4,100,M,67,9,10,118,18,Well
9,6,114,M,64,9,7,115,1,Good
15,0,180,F,16,5,11,71,-109,Severe
18,2,218,F,56,8,9,105,-113,Severe
11,8,140,M,48,8,1,97,-43,Severe
17,2,206,M,21,6,2,74,-132,Severe
8,11,107,F,51,8,4,100,-7,Severe
16,0,192,F,50,8,3,99,-93,Severe
17,6,210,M,15,5,11,71,-139,Severe
18,5,221,F,62,9,4,112,-109,Severe
11,4,136,F,86,11,10,142,6,Well
15,6,186,M,42,7,7,91,-95,Severe
8,9,105,F,15,5,11,71,-34,Severe
15,4,184,M,62,9,4,112,-72,Severe
16,8,200,F,70,10,2,122,-78,Severe
5,6,66,F,106,13,10,166,100,Well
8,0,96,F,65,9,8,116,20,Well
17,3,207,M,16,5,11,71,-136,Severe
5,3,63,M,84,11,7,139,76,Well
18,5,221,F,87,11,11,143,-78,Severe
7,4,88,M,15,5,11,71,-17,Severe
9,2,110,M,87,11,11,143,33,Well
11,3,135,M,60,9,2,110,-25,Severe
18,3,219,M,82,11,5,137,-82,Severe
13,11,167,F,100,13,3,159,-8,Severe
17,5,209,M,55,8,8,104,-105,Severe
13,4,160,M,62,9,4,112,-48,Severe
11,3,135,F,88,12,0,144,9,Well
9,4,112,M,39,7,5,89,-23,Severe
6,4,76,F,24,6,5,77,1,Good
16,2,194,M,54,8,7,103,-91,Severe
13,10,166,F,85,11,9,141,-25,Severe
10,6,126,M,49,8,2,98,-28,Severe
16,0,192,F,7,5,6,66,-126,Severe
8,4,100,F,20,6,2,74,-26,Severe
12,0,144,M,72,10,4,124,-20,Severe
7,6,90,F,73,10,6,126,36,Well
18,11,227,F,15,5,11,71,-156,Severe
17,11,215,F,83,11,6,138,-77,Severe
9,10,118,M,19,6,1,73,-45,Severe
6,3,75,F,22,6,3,75,0,Neutral
14,10,178,F,52,8,5,101,-77,Severe
10,1,121,M,30,6,9,81,-40,Severe
18,11,227,M,29,6,8,80,-147,Severe
17,0,204,F,38,7,4,88,-116,Severe
13,6,162,F,56,8,9,105,-57,Severe
11,1,133,F,4,5,4,64,-69,Severe
17,11,215,F,95,12,9,153,-62,Severe
7,11,95,M,110,14,3,171,76,Well
8,6,102,M,30,6,9,81,-21,Severe
14,6,174,F,95,12,9,153,-21,Severe
7,2,86,M,32,6,10,82,-4,Mild
6,11,83,M,103,13,6,162,79,Well
5,9,69,M,63,9,6,114,45,Well
17,10,214,F,95,12,9,153,-61,Severe
15,8,188,M,88,12,0,144,-44,Severe
10,10,130,F,17,6,0,72,-58,Severe
7,9,93,M,30,6,9,81,-12,Severe
15,3,183,M,14,5,10,70,-113,Severe
18,2,218,M,80,11,3,135,-83,Severe
14,5,173,F,32,6,10,82,-91,Severe
7,7,91,M,52,8,5,101,10,Well
9,11,119,F,64,9,7,115,-4,Mild
15,10,190,F,46,7,11,95,-95,Severe
14,5,173,F,12,5,9,69,-104,Severe
6,11,83,M,55,8,8,104,21,Well
9,3,111,F,57,8,10,106,-5,Mild
5,1,61,M,40,7,5,89,28,Well
7,5,89,M,79,11,1,133,44,Well
13,7,163,F,4,5,4,64,-99,Severe
18,8,224,M,4,5,4,64,-160,Severe
10,0,120,F,60,9,2,110,-10,Severe
10,3,123,F,24,6,5,77,-46,Severe
16,8,200,M,99,13,1,157,-43,Severe
6,1,73,M,36,7,2,86,13,Well
17,3,207,M,53,8,6,102,-105,Severe
14,8,176,F,8,5,6,66,-110,Severe
10,7,127,M,55,8,8,104,-23,Severe
13,0,156,F,14,5,10,70,-86,Severe
8,5,101,M,67,9,10,118,17,Well
12,9,153,F,82,11,5,137,-16,Severe
12,3,147,M,84,11,7,139,-8,Severe
18,3,219,F,101,13,4,160,-59,Severe
17,1,205,F,98,13,0,156,-49,Severe
7,1,85,M,97,12,11,155,70,Well
14,1,169,F,91,12,4,148,-21,Severe
8,6,102,M,107,13,11,167,65,Well
14,5,173,M,29,6,8,80,-93,Severe
6,10,82,M,16,5,11,71,-11,Severe
14,0,168,M,69,10,1,121,-47,Severe
12,3,147,M,71,10,3,123,-24,Severe
8,4,100,F,2,5,3,63,-37,Severe
9,9,117,M,15,5,11,71,-46,Severe
14,3,171,F,59,9,1,109,-62,Severe
7,0,84,M,88,12,0,144,60,Well
12,2,146,M,54,8,7,103,-43,Severe
16,2,194,M,50,8,3,99,-95,Severe
10,11,131,M,82,11,5,137,6,Well
17,5,209,F,72,10,4,124,-85,Severe
7,0,84,F,99,13,1,157,73,Well
8,5,101,F,79,11,1,133,32,Well
14,5,173,M,107,13,11,167,-6,Severe
5,4,64,M,106,13,10,166,102,Well
6,10,82,M,94,12,7,151,69,Well
9,0,108,M,60,9,2,110,2,Good
9,5,113,M,4,5,4,64,-49,Severe
17,1,205,F,4,5,4,64,-141,Severe
9,4,112,F,54,8,7,103,-9,Severe
13,9,165,F,15,5,11,71,-94,Severe
6,9,81,F,110,14,3,171,90,Well
8,3,99,M,39,7,5,89,-10,Severe
6,6,78,F,17,6,0,72,-6,Severe
8,4,100,F,30,6,9,81,-19,Severe
8,10,106,M,43,7,8,92,-14,Severe
15,7,187,F,83,11,6,138,-49,Severe
17,10,214,M,21,6,2,74,-140,Severe
17,2,206,M,34,7,0,84,-122,Severe
13,10,166,F,78,11,0,132,-34,Severe
18,4,220,F,102,13,6,162,-58,Severe
7,0,84,F,63,9,6,114,30,Well
12,9,153,F,20,6,2,74,-79,Severe
12,3,147,M,42,7,7,91,-56,Severe
17,1,205,F,88,12,0,144,-61,Severe
10,5,125,F,43,7,8,92,-33,Severe
10,1,121,M,55,8,8,104,-17,Severe
5,10,70,M,93,12,6,150,80,Well
10,7,127,M,88,12,0,144,17,Well
7,10,94,F,99,13,1,157,63,Well
15,10,190,M,38,7,4,88,-102,Severe
11,10,142,M,70,10,2,122,-20,Severe
16,8,200,M,10,5,7,67,-133,Severe
9,1,109,M,16,5,11,71,-38,Severe
14,5,173,M,86,11,10,142,-31,Severe
16,0,192,M,99,13,1,157,-35,Severe
14,4,172,F,39,7,5,89,-83,Severe
14,8,176,M,69,10,1,121,-55,Severe
10,3,123,M,105,13,9,165,42,Well
11,8,140,F,3,5,3,63,-77,Severe
12,2,146,M,18,6,1,73,-73,Severe
12,3,147,M,74,10,7,127,-20,Severe
9,1,109,M,42,7,7,91,-18,Severe
15,6,186,F,27,6,7,79,-107,Severe
15,9,189,F,29,6,8,80,-109,Severe
7,5,89,F,86,11,10,142,53,Well
8,3,99,F,93,12,6,150,51,Well
13,0,156,F,91,12,4,148,-8,Severe
13,8,164,M,17,6,0,72,-92,Severe
8,7,103,F,54,8,7,103,0,Neutral
18,10,226,M,38,7,4,88,-138,Severe
15,8,188,M,31,6,9,81,-107,Severe
13,10,166,M,26,6,6,78,-88,Severe
16,10,202,F,77,10,11,131,-71,Severe
7,6,90,M,76,10,10,130,40,Well
11,8,140,M,39,7,5,89,-51,Severe
9,7,115,M,100,13,3,159,44,Well
14,10,178,F,95,12,9,153,-25,Severe
5,3,63,F,41,7,6,90,27,Well
14,6,174,M,45,7,10,94,-80,Severe
11,6,138,F,33,6,11,83,-55,Severe
5,6,66,M,58,9,0,108,42,Well
13,5,161,M,75,10,9,129,-32,Severe
16,0,192,F,57,8,10,106,-86,Severe
7,3,87,F,71,10,3,123,36,Well
12,9,153,F,88,12,0,144,-9,Severe
12,3,147,M,63,9,6,114,-33,Severe
15,4,184,F,83,11,6,138,-46,Severe
13,2,158,M,20,6,2,74,-84,Severe
6,5,77,F,71,10,3,123,46,Well
11,3,135,M,21,6,2,74,-61,Severe
17,2,206,M,73,10,6,126,-80,Severe
10,1,121,M,89,12,1,145,24,Well
14,8,176,M,46,7,11,95,-81,Severe
17,3,207,F,16,5,11,71,-136,Severe
5,9,69,F,63,9,6,114,45,Well
6,6,78,F,42,7,7,91,13,Well
13,7,163,M,10,5,7,67,-96,Severe
7,3,87,F,88,12,0,144,57,Well
7,5,89,M,52,8,5,101,12,Well
16,8,200,M,39,7,5,89,-111,Severe
12,1,145,M,7,5,6,66,-79,Severe
17,1,205,M,97,12,11,155,-50,Severe
17,11,215,M,87,11,11,143,-72,Severe
10,2,122,M,51,8,4,100,-22,Severe
15,3,183,F,86,11,10,142,-41,Severe
7,7,91,M,32,6,10,82,-9,Severe
15,3,183,F,100,13,3,159,-24,Severe
14,4,172,M,6,5,5,65,-107,Severe
8,9,105,M,93,12,6,150,45,Well
18,9,225,M,98,13,0,156,-69,Severe
18,2,218,M,22,6,3,75,-143,Severe
17,1,205,M,83,11,6,138,-67,Severe
10,9,129,M,77,10,11,131,2,Good
5,8,68,M,67,9,10,118,50,Well
12,11,155,M,98,13,0,156,1,Good
13,5,161,F,99,13,1,157,-4,Mild
5,3,63,F,33,6,11,83,20,Well
13,3,159,M,4,5,4,64,-95,Severe
18,7,223,F,73,10,6,126,-97,Severe
6,5,77,M,67,9,10,118,41,Well
9,7,115,M,78,11,0,132,17,Well
5,8,68,M,72,10,4,124,56,Well
15,9,189,F,11,5,8,68,-121,Severe
17,2,206,F,28,6,8,80,-126,Severe
5,5,65,M,91,12,4,148,83,Well
8,10,106,M,24,6,5,77,-29,Severe
5,3,63,F,36,7,2,86,23,Well
9,2,110,M,76,10,10,130,20,Well
17,4,208,M,77,10,11,131,-77,Severe
11,8,140,M,2,5,3,63,-77,Severe
5,10,70,F,79,11,1,133,63,Well
14,7,175,F,108,14,0,168,-7,Severe
17,5,209,M,71,10,3,123,-86,Severe
5,8,68,F,49,8,2,98,30,Well
15,4,184,F,18,6,1,73,-111,Severe
12,3,147,M,58,9,0,108,-39,Severe
10,6,126,F,89,12,1,145,19,Well
16,10,202,M,85,11,9,141,-61,Severe
6,8,80,F,79,11,1,133,53,Well
16,7,199,M,103,13,6,162,-37,Severe
14,1,169,M,86,11,10,142,-27,Severe
11,5,137,F,95,12,9,153,16,Well
14,1,169,F,13,5,9,69,-100,Severe
8,1,97,F,55,8,8,104,7,Well
13,0,156,M,79,11,1,133,-23,Severe
9,8,116,M,70,10,2,122,6,Well
9,4,112,F,57,8,10,106,-6,Severe
5,4,64,F,34,7,0,84,20,Well
17,0,204,F,37,7,3,87,-117,Severe
14,11,179,F,20,6,2,74,-105,Severe
11,3,135,F,78,11,0,132,-3,Mild
7,11,95,F,6,5,5,65,-30,Severe
12,10,154,F,104,13,7,163,9,Well
5,2,62,F,2,5,3,63,1,Good
17,3,207,F,56,8,9,105,-102,Severe
14,2,170,M,76,10,10,130,-40,Severe
9,6,114,F,60,9,2,110,-4,Mild
8,11,107,F,58,9,0,108,1,Good
17,3,207,M,68,10,0,120,-87,Severe
15,6,186,F,102,13,6,162,-24,Severe
6,0,72,F,93,12,6,150,78,Well
8,3,99,F,109,14,1,169,70,Well
5,11,71,M,40,7,5,89,18,Well
7,0,84,F,28,6,8,80,-4,Mild
10,0,120,F,8,5,6,66,-54,Severe
18,8,224,F,57,8,10,106,-118,Severe
15,3,183,F,37,7,3,87,-96,Severe
17,5,209,F,62,9,4,112,-97,Severe
5,3,63,M,48,8,1,97,34,Well
15,7,187,M,22,6,3,75,-112,Severe
7,11,95,M,67,9,10,118,23,Well
12,10,154,F,10,5,7,67,-87,Severe
7,9,93,F,84,11,7,139,46,Well
12,4,148,F,68,10,0,120,-28,Severe
7,8,92,F,47,8,0,96,4,Good
9,11,119,M,15,5,11,71,-48,Severe
14,11,179,M,72,10,4,124,-55,Severe
12,4,148,M,101,13,4,160,12,Well
8,11,107,F,5,5,5,65,-42,Severe
12,2,146,F,53,8,6,102,-44,Severe
12,0,144,F,39,7,5,89,-55,Severe
9,11,119,M,106,13,10,166,47,Well
7,3,87,F,56,8,9,105,18,Well
12,3,147,M,87,11,11,143,-4,Mild
13,5,161,F,88,12,0,144,-17,Severe
9,1,109,M,10,5,7,67,-42,Severe
16,9,201,F,66,9,9,117,-84,Severe
16,3,195,M,61,9,3,111,-84,Severe
8,3,99,F,57,8,10,106,7,Well
18,4,220,F,37,7,3,87,-133,Severe
7,8,92,M,5,5,5,65,-27,Severe
6,9,81,M,89,12,1,145,64,Well
15,2,182,M,9,5,7,67,-115,Severe
8,6,102,M,88,12,0,144,42,Well
8,10,106,M,38,7,4,88,-18,Severe
18,1,217,M,24,6,5,77,-140,Severe
11,6,138,M,20,6,2,74,-64,Severe
6,0,72,M,94,12,7,151,79,Well
13,11,167,M,11,5,8,68,-99,Severe
8,6,102,M,19,6,1,73,-29,Severe
5,10,70,M,77,10,11,131,61,Well
10,1,121,M,79,11,1,133,12,Well
8,7,103,F,7,5,6,66,-37,Severe
18,8,224,M,36,7,2,86,-138,Severe
18,0,216,M,86,11,10,142,-74,Severe
15,3,183,M,30,6,9,81,-102,Severe
9,2,110,M,57,8,10,106,-4,Mild
15,6,186,F,15,5,11,71,-115,Severe
11,5,137,M,3,5,3,63,-74,Severe
6,0,72,M,48,8,1,97,25,Well
11,1,133,F,98,13,0,156,23,Well
8,11,107,F,47,8,0,96,-11,Severe
18,4,220,F,76,10,10,130,-90,Severe
17,3,207,M,107,13,11,167,-40,Severe
10,4,124,M,27,6,7,79,-45,Severe
5,7,67,F,52,8,5,101,34,Well
14,2,170,M,39,7,5,89,-81,Severe
7,0,84,M,5,5,5,65,-19,Severe
7,4,88,F,14,5,10,70,-18,Severe
15,10,190,M,45,7,10,94,-96,Severe
10,3,123,F,102,13,6,162,39,Well
15,5,185,M,108,14,0,168,-17,Severe
14,2,170,F,19,6,1,73,-97,Severe
9,9,117,F,18,6,1,73,-44,Severe
8,2,98,F,5,5,5,65,-33,Severe
12,7,151,M,7,5,6,66,-85,Severe
9,6,114,M,99,13,1,157,43,Well
6,4,76,F,47,8,0,96,20,Well
11,5,137,F,102,13,6,162,25,Well
14,9,177,M,85,11,9,141,-36,Severe
12,7,151,F,43,7,8,92,-59,Severe
9,2,110,F,61,9,3,111,1,Good
18,2,218,M,3,5,3,63,-155,Severe
14,11,179,F,106,13,10,166,-13,Severe
15,5,185,F,9,5,7,67,-118,Severe
11,3,135,F,101,13,4,160,25,Well
9,11,119,M,25,6,5,77,-42,Severe
5,8,68,F,109,14,1,169,101,Well
17,0,204,F,109,14,1,169,-35,Severe
11,3,135,F,38,7,4,88,-47,Severe
11,8,140,F,40,7,5,89,-51,Severe
6,0,72,M,23,6,4,76,4,Good
17,0,204,F,72,10,4,124,-80,Severe
8,4,100,F,87,11,11,143,43,Well
15,2,182,F,30,6,9,81,-101,Severe
5,3,63,F,48,8,1,97,34,Well
10,1,121,F,15,5,11,71,-50,Severe
18,1,217,M,30,6,9,81,-136,Severe
15,2,182,M,54,8,7,103,-79,Severe
14,1,169,M,20,6,2,74,-95,Severe
8,2,98,F,20,6,2,74,-24,Severe
7,5,89,F,36,7,2,86,-3,Mild
7,3,87,M,69,10,1,121,34,Well
18,1,217,F,20,6,2,74,-143,Severe
18,3,219,M,70,10,2,122,-97,Severe
10,5,125,F,66,9,9,117,-8,Severe
15,2,182,M,50,8,3,99,-83,Severe
7,9,93,M,52,8,5,101,8,Well
10,9,129,M,91,12,4,148,19,Well
12,0,144,M,97,12,11,155,11,Well
12,4,148,M,59,9,1,109,-39,Severe
12,0,144,F,95,12,9,153,9,Well
5,6,66,F,47,8,0,96,30,Well
18,3,219,M,66,9,9,117,-102,Severe
11,9,141,M,20,6,2,74,-67,Severe
15,4,184,M,51,8,4,100,-84,Severe
6,9,81,F,81,11,4,136,55,Well
18,8,224,F,9,5,7,67,-157,Severe
17,6,210,M,6,5,5,65,-145,Severe
14,4,172,F,24,6,5,77,-95,Severe
9,2,110,M,69,10,1,121,11,Well
15,2,182,F,104,13,7,163,-19,Severe
17,9,213,M,83,11,6,138,-75,Severe
18,11,227,F,34,7,0,84,-143,Severe
17,9,213,F,35,7,1,85,-128,Severe
9,11,119,M,51,8,4,100,-19,Severe
15,11,191,F,12,5,9,69,-122,Severe
5,11,71,M,20,6,2,74,3,Good
7,8,92,M,105,13,9,165,73,Well
13,6,162,M,92,12,5,149,-13,Severe
12,4,148,M,15,5,11,71,-77,Severe
5,11,71,F,88,12,0,144,73,Well
8,0,96,F,44,7,9,93,-3,Mild
7,2,86,F,68,10,0,120,34,Well
7,11,95,M,96,12,10,154,59,Well
9,8,116,M,100,13,3,159,43,Well
5,3,63,M,64,9,7,115,52,Well
16,9,201,F,28,6,8,80,-121,Severe
7,10,94,F,3,5,3,63,-31,Severe
10,1,121,F,38,7,4,88,-33,Severe
14,9,177,F,103,13,6,162,-15,Severe
10,10,130,F,44,7,9,93,-37,Severe
7,7,91,F,72,10,4,124,33,Well
12,7,151,M,37,7,3,87,-64,Severe
5,7,67,F,73,10,6,126,59,Well
15,3,183,F,13,5,9,69,-114,Severe
15,1,181,F,45,7,10,94,-87,Severe
10,10,130,M,74,10,7,127,-3,Mild
16,0,192,F,42,7,7,91,-101,Severe
6,3,75,M,98,13,0,156,81,Well
15,9,189,F,58,9,0,108,-81,Severe
8,4,100,F,91,12,4,148,48,Well
14,5,173,M,73,10,6,126,-47,Severe
14,4,172,F,67,9,10,118,-54,Severe
13,3,159,F,83,11,6,138,-21,Severe
6,3,75,M,98,13,0,156,81,Well
15,10,190,F,104,13,7,163,-27,Severe
10,9,129,F,12,5,9,69,-60,Severe
5,0,60,F,67,9,10,118,58,Well
8,8,104,M,36,7,2,86,-18,Severe
17,2,206,M,105,13,9,165,-41,Severe
12,1,145,M,106,13,10,166,21,Well
16,3,195,F,99,13,1,157,-38,Severe
17,5,209,F,14,5,10,70,-139,Severe
13,3,159,F,29,6,8,80,-79,Severe
15,4,184,M,16,5,11,71,-113,Severe
8,7,103,F,90,12,3,147,44,Well
17,8,212,M,89,12,1,145,-67,Severe
9,11,119,F,52,8,5,101,-18,Severe
9,11,119,M,45,7,10,94,-25,Severe
11,2,134,F,65,9,8,116,-18,Severe
5,1,61,F,89,12,1,145,84,Well
10,8,128,M,13,5,9,69,-59,Severe
10,4,124,F,14,5,10,70,-54,Severe
13,9,165,F,2,5,3,63,-102,Severe
15,3,183,M,11,5,8,68,-115,Severe
15,1,181,M,47,8,0,96,-85,Severe
8,3,99,M,23,6,4,76,-23,Severe
6,1,73,M,103,13,6,162,89,Well
8,5,101,F,33,6,11,83,-18,Severe
8,6,102,F,15,5,11,71,-31,Severe
8,6,102,F,7,5,6,66,-36,Severe
7,3,87,F,71,10,3,123,36,Well
13,3,159,F,59,9,1,109,-50,Severe
17,0,204,M,38,7,4,88,-116,Severe
17,3,207,M,59,9,1,109,-98,Severe
6,8,80,M,89,12,1,145,65,Well
14,7,175,M,83,11,6,138,-37,Severe
17,2,206,F,48,8,1,97,-109,Severe
14,11,179,F,107,13,11,167,-12,Severe
11,10,142,M,20,6,2,74,-68,Severe
12,4,148,F,97,12,11,155,7,Well
14,3,171,F,6,5,5,65,-106,Severe
17,11,215,F,66,9,9,117,-98,Severe
13,3,159,M,23,6,4,76,-83,Severe
15,0,180,F,22,6,3,75,-105,Severe
18,7,223,F,18,6,1,73,-150,Severe
10,3,123,M,71,10,3,123,0,Neutral
11,8,140,M,84,11,7,139,-1,Mild
14,3,171,F,96,12,10,154,-17,Severe
15,3,183,F,7,5,6,66,-117,Severe
18,10,226,F,107,13,11,167,-59,Severe
15,1,181,F,29,6,8,80,-101,Severe
7,3,87,F,92,12,5,149,62,Well
9,10,118,M,107,13,11,167,49,Well
15,3,183,F,110,14,3,171,-12,Severe
18,3,219,M,71,10,3,123,-96,Severe
12,11,155,F,88,12,0,144,-11,Severe
18,3,219,F,39,7,5,89,-130,Severe
11,9,141,M,87,11,11,143,2,Good
7,4,88,F,87,11,11,143,55,Well
6,1,73,M,12,5,9,69,-4,Mild
13,9,165,M,88,12,0,144,-21,Severe
12,3,147,F,13,5,9,69,-78,Severe
10,2,122,M,41,7,6,90,-32,Severe
18,1,217,F,101,13,4,160,-57,Severe
17,3,207,M,70,10,2,122,-85,Severe
8,8,104,F,34,7,0,84,-20,Severe
16,7,199,M,102,13,6,162,-37,Severe
11,2,134,F,108,14,0,168,34,Well
11,7,139,F,108,14,0,168,29,Well
10,4,124,M,8,5,6,66,-58,Severe
18,8,224,F,41,7,6,90,-134,Severe
18,4,220,M,11,5,8,68,-152,Severe
7,4,88,M,82,11,5,137,49,Well
5,10,70,M,85,11,9,141,71,Well
17,4,208,F,106,13,10,166,-42,Severe
14,6,174,M,40,7,5,89,-85,Severe
14,6,174,M,76,10,10,130,-44,Severe
16,7,199,F,27,6,7,79,-120,Severe
9,0,108,F,13,5,9,69,-39,Severe
18,8,224,M,77,10,11,131,-93,Severe
6,9,81,F,23,6,4,76,-5,Mild
9,3,111,M,64,9,7,115,4,Good
6,1,73,M,93,12,6,150,77,Well
17,0,204,M,7,5,6,66,-138,Severe
18,3,219,M,11,5,8,68,-151,Severe
8,1,97,F,69,10,1,121,24,Well
11,4,136,M,21,6,2,74,-62,Severe
9,1,109,M,20,6,2,74,-35,Severe
8,9,105,F,29,6,8,80,-25,Severe
15,0,180,F,102,13,6,162,-18,Severe
18,2,218,M,105,13,9,165,-53,Severe
13,9,165,M,92,12,5,149,-16,Severe
6,3,75,M,90,12,3,147,72,Well
17,2,206,F,95,12,9,153,-53,Severe
9,10,118,F,65,9,8,116,-2,Mild
18,9,225,F,46,7,11,95,-130,Severe
17,8,212,M,25,6,5,77,-135,Severe
8,11,107,F,15,5,11,71,-36,Severe
11,3,135,M,98,13,0,156,21,Well
17,10,214,M,94,12,7,151,-63,Severe
13,2,158,F,67,9,10,118,-40,Severe
8,3,99,M,46,7,11,95,-4,Mild
9,0,108,M,50,8,3,99,-9,Severe
13,0,156,M,6,5,5,65,-91,Severe
9,0,108,M,71,10,3,123,15,Well
10,11,131,F,78,11,0,132,1,Good
11,9,141,M,6,5,5,65,-76,Severe
7,8,92,M,102,13,6,162,70,Well
14,3,171,M,59,9,1,109,-62,Severe
12,10,154,M,15,5,11,71,-83,Severe
17,10,214,F,12,5,9,69,-145,Severe
18,1,217,M,44,7,9,93,-124,Severe
13,6,162,F,60,9,2,110,-52,Severe
16,3,195,F,50,8,3,99,-96,Severe
18,3,219,F,85,11,9,141,-78,Severe
12,10,154,F,44,7,9,93,-61,Severe
8,4,100,F,32,6,10,82,-18,Severe
11,3,135,M,89,12,1,145,10,Well
9,9,117,M,85,11,9,141,24,Well
14,5,173,M,89,12,1,145,-28,Severe
13,9,165,F,24,6,5,77,-88,Severe
8,7,103,M,92,12,5,149,46,Well
15,7,187,F,3,5,3,63,-124,Severe
7,8,92,M,6,5,5,65,-27,Severe
10,8,128,F,32,6,10,82,-46,Severe
18,5,221,M,45,7,10,94,-127,Severe
12,2,146,M,60,9,2,110,-36,Severe
17,3,207,F,18,6,1,73,-134,Severe
11,10,142,F,79,11,1,133,-9,Severe
10,10,130,M,38,7,4,88,-42,Severe
10,4,124,F,2,5,3,63,-61,Severe
7,9,93,F,63,9,6,114,21,Well
16,3,195,M,11,5,8,68,-127,Severe
17,1,205,M,99,13,1,157,-48,Severe
8,7,103,M,11,5,8,68,-35,Severe
6,11,83,F,12,5,9,69,-14,Severe
12,7,151,F,15,5,11,71,-80,Severe
13,1,157,F,85,11,9,141,-16,Severe
12,10,154,F,38,7,4,88,-66,Severe
16,0,192,F,21,6,2,74,-118,Severe
14,10,178,M,93,12,6,150,-28,Severe
18,3,219,F,103,13,6,162,-57,Severe
12,10,154,F,31,6,9,81,-73,Severe
6,9,81,F,62,9,4,112,31,Well
9,7,115,F,65,9,8,116,1,Good
5,1,61,F,97,12,11,155,94,Well
13,2,158,F,23,6,4,76,-82,Severe
17,4,208,M,14,5,10,70,-138,Severe
12,1,145,F,105,13,9,165,20,Well
6,7,79,F,49,8,2,98,19,Well
17,9,213,F,17,6,0,72,-141,Severe
17,3,207,F,88,12,0,144,-63,Severe
16,7,199,M,33,6,11,83,-116,Severe
5,5,65,M,25,6,5,77,12,Well
13,5,161,M,68,10,0,120,-41,Severe
6,11,83,F,25,6,5,77,-6,Severe
17,8,212,F,42,7,7,91,-121,Severe
6,9,81,F,7,5,6,66,-15,Severe
8,0,96,F,28,6,8,80,-16,Severe
7,7,91,F,73,10,6,126,35,Well
17,1,205,F,90,12,3,147,-58,Severe
15,0,180,F,35,7,1,85,-95,Severe
15,4,184,M,77,10,11,131,-53,Severe
18,1,217,M,53,8,6,102,-115,Severe
7,10,94,M,60,9,2,110,16,Well
5,9,69,M,4,5,4,64,-5,Mild
6,11,83,F,26,6,6,78,-5,Mild
6,1,73,F,110,14,3,171,98,Well
6,1,73,M,18,6,1,73,0,Neutral
13,11,167,M,89,12,1,145,-22,Severe
8,8,104,F,46,7,11,95,-9,Severe
13,6,162,F,104,13,7,163,1,Good
8,9,105,F,57,8,10,106,1,Good
10,10,130,F,85,11,9,141,11,Well
14,10,178,M,13,5,9,69,-109,Severe
5,9,69,F,89,12,1,145,76,Well
5,6,66,F,77,10,11,131,65,Well
5,3,63,M,88,12,0,144,81,Well
17,2,206,F,106,13,10,166,-40,Severe
16,1,193,M,45,7,10,94,-99,Severe
5,11,71,M,54,8,7,103,32,Well
16,2,194,M,11,5,8,68,-126,Severe
10,5,125,F,74,10,7,127,2,Good
7,6,90,F,13,5,9,69,-21,Severe
17,4,208,F,91,12,4,148,-60,Severe
11,7,139,F,95,12,9,153,14,Well
16,9,201,M,47,8,0,96,-105,Severe
13,7,163,M,75,10,9,129,-34,Severe
8,3,99,M,83,11,6,138,39,Well
11,7,139,M,81,11,4,136,-3,Mild
7,11,95,F,15,5,11,71,-24,Severe
11,6,138,M,69,10,1,121,-17,Severe
12,1,145,F,74,10,7,127,-18,Severe
9,7,115,F,40,7,5,89,-26,Severe
5,6,66,F,41,7,6,90,24,Well
12,6,150,M,87,11,11,143,-7,Severe
7,3,87,F,88,12,0,144,57,Well
11,3,135,F,30,6,9,81,-54,Severe
15,0,180,F,19,6,1,73,-107,Severe
12,9,153,F,17,6,0,72,-81,Severe
7,8,92,F,67,9,10,118,26,Well
6,9,81,M,4,5,4,64,-17,Severe
14,11,179,F,31,6,9,81,-98,Severe
5,10,70,F,12,5,9,69,-1,Mild
10,3,123,F,89,12,1,145,22,Well
6,10,82,F,16,5,11,71,-11,Severe
7,10,94,F,109,14,1,169,75,Well
6,11,83,M,65,9,8,116,33,Well
5,4,64,M,12,5,9,69,5,Good
9,2,110,F,50,8,3,99,-11,Severe
17,5,209,M,45,7,10,94,-115,Severe
11,4,136,F,81,11,4,136,0,Neutral
17,6,210,M,57,8,10,106,-104,Severe
13,9,165,M,74,10,7,127,-38,Severe
7,4,88,F,50,8,3,99,11,Well
18,9,225,M,75,10,9,129,-96,Severe
8,9,105,M,103,13,6,162,57,Well
7,9,93,F,92,12,5,149,56,Well
11,3,135,M,15,5,11,71,-64,Severe
10,7,127,M,13,5,9,69,-58,Severe
9,7,115,M,104,13,7,163,48,Well
18,1,217,M,58,9,0,108,-109,Severe
16,0,192,M,106,13,10,166,-26,Severe
11,11,143,M,37,7,3,87,-56,Severe
18,11,227,F,109,14,1,169,-58,Severe
15,7,187,M,61,9,3,111,-76,Severe
18,0,216,F,96,12,10,154,-62,Severe
7,2,86,F,16,5,11,71,-15,Severe
10,11,131,F,31,6,9,81,-50,Severe
12,6,150,F,75,10,9,129,-21,Severe
9,5,113,F,28,6,8,80,-33,Severe
15,6,186,M,72,10,4,124,-62,Severe
6,6,78,F,26,6,6,78,0,Neutral
13,6,162,M,108,14,0,168,6,Well
6,2,74,F,35,7,1,85,11,Well
12,2,146,F,30,6,9,81,-65,Severe
10,10,130,F,93,12,6,150,20,Well
16,7,199,F,25,6,5,77,-122,Severe
13,9,165,M,51,8,4,100,-65,Severe
6,2,74,M,52,8,5,101,27,Well
10,8,128,F,44,7,9,93,-35,Severe
8,1,97,F,11,5,8,68,-29,Severe
13,7,163,F,26,6,6,78,-85,Severe
18,9,225,F,106,13,10,166,-59,Severe
10,0,120,M,41,7,6,90,-30,Severe
8,3,99,F,90,12,3,147,48,Well
17,10,214,M,59,9,1,109,-105,Severe
7,2,86,F,15,5,11,71,-15,Severe
11,11,143,M,90,12,3,147,4,Good
13,5,161,M,38,7,4,88,-73,Severe
16,6,198,F,60,9,2,110,-88,Severe
12,6,150,M,105,13,9,165,15,Well
13,1,157,M,13,5,9,69,-88,Severe
11,5,137,F,49,8,2,98,-39,Severe
5,2,62,M,12,5,9,69,7,Well
13,3,159,F,95,12,9,153,-6,Severe
11,11,143,M,94,12,7,151,8,Well
17,5,209,F,60,9,2,110,-99,Severe
17,11,215,F,104,13,7,163,-52,Severe
17,10,214,F,87,11,11,143,-71,Severe
10,2,122,M,88,12,0,144,22,Well
14,11,179,F,17,6,0,72,-107,Severe
15,5,185,M,93,12,6,150,-35,Severe
10,9,129,F,4,5,4,64,-65,Severe
5,1,61,M,17,6,0,72,11,Well
7,3,87,F,48,8,1,97,10,Well
17,5,209,M,47,8,0,96,-113,Severe
11,5,137,F,98,13,0,156,19,Well
9,7,115,F,29,6,8,80,-35,Severe
11,10,142,F,7,5,6,66,-76,Severe
16,3,195,F,93,12,6,150,-45,Severe
17,7,211,F,70,10,2,122,-89,Severe
12,10,154,F,52,8,5,101,-53,Severe
17,4,208,F,30,6,9,81,-127,Severe
9,6,114,M,62,9,4,112,-2,Mild
9,4,112,M,95,12,9,153,41,Well
6,5,77,F,89,12,1,145,68,Well
7,8,92,F,65,9,8,116,24,Well
10,5,125,F,22,6,3,75,-50,Severe
11,3,135,F,81,11,4,136,1,Good
8,2,98,F,45,7,10,94,-4,Mild
14,2,170,M,7,5,6,66,-104,Severe
10,1,121,M,46,7,11,95,-26,Severe
15,11,191,F,7,5,6,66,-125,Severe
15,10,190,M,9,5,7,67,-123,Severe
6,7,79,F,42,7,7,91,12,Well
14,7,175,F,102,13,6,162,-13,Severe
10,2,122,F,100,13,3,159,37,Well
5,0,60,M,54,8,7,103,43,Well
7,8,92,F,87,11,11,143,51,Well
12,3,147,M,76,10,10,130,-17,Severe
9,0,108,M,38,7,4,88,-20,Severe
13,11,167,M,15,5,11,71,-96,Severe
11,5,137,M,109,14,1,169,32,Well
10,0,120,M,85,11,9,141,21,Well
8,9,105,F,108,14,0,168,63,Well
17,4,208,F,51,8,4,100,-108,Severe
14,5,173,M,62,9,4,112,-61,Severe
8,9,105,F,48,8,1,97,-8,Severe
6,4,76,F,11,5,8,68,-8,Severe
6,0,72,M,81,11,4,136,64,Well
18,9,225,F,96,12,10,154,-71,Severe
18,11,227,F,84,11,7,139,-88,Severe
12,1,145,F,15,5,11,71,-74,Severe
7,11,95,M,37,7,3,87,-8,Severe
8,6,102,M,28,6,8,80,-22,Severe
10,10,130,F,64,9,7,115,-15,Severe
14,3,171,M,27,6,7,79,-92,Severe
5,3,63,F,94,12,7,151,88,Well
15,5,185,M,63,9,6,114,-71,Severe
12,4,148,F,107,13,11,167,19,Well
11,8,140,F,69,10,1,121,-19,Severe
13,5,161,F,37,7,3,87,-74,Severe
8,0,96,F,5,5,5,65,-31,Severe
18,5,221,M,68,10,0,120,-101,Severe
12,2,146,M,101,13,4,160,14,Well
14,8,176,M,2,5,3,63,-113,Severe
9,5,113,M,90,12,3,147,34,Well
16,8,200,M,64,9,7,115,-85,Severe
17,3,207,F,60,9,2,110,-97,Severe
17,9,213,M,81,11,4,136,-77,Severe
13,10,166,F,20,6,2,74,-92,Severe
8,3,99,F,30,6,9,81,-18,Severe
5,10,70,F,11,5,8,68,-2,Mild
15,1,181,F,64,9,7,115,-66,Severe
11,11,143,F,21,6,2,74,-69,Severe
15,10,190,F,83,11,6,138,-52,Severe
9,9,117,F,68,10,0,120,3,Good
17,0,204,M,50,8,3,99,-105,Severe
7,2,86,M,83,11,6,138,52,Well
14,3,171,F,33,6,11,83,-88,Severe
6,0,72,F,57,8,10,106,34,Well
11,0,132,F,79,11,1,133,1,Good
10,11,131,F,62,9,4,112,-19,Severe
14,1,169,M,94,12,7,151,-18,Severe
7,2,86,F,48,8,1,97,11,Well
13,9,165,F,51,8,4,100,-65,Severe
16,3,195,F,34,7,0,84,-111,Severe
12,9,153,M,40,7,5,89,-64,Severe
8,3,99,F,61,9,3,111,12,Well
8,11,107,M,54,8,7,103,-4,Mild
9,5,113,F,13,5,9,69,-44,Severe
12,4,148,F,36,7,2,86,-62,Severe
18,4,220,M,85,11,9,141,-79,Severe
18,2,218,F,80,11,3,135,-83,Severe
11,0,132,F,64,9,7,115,-17,Severe
18,6,222,F,4,5,4,64,-158,Severe
6,7,79,F,4,5,4,64,-15,Severe
16,7,199,M,100,13,3,159,-40,Severe
9,7,115,M,36,7,2,86,-29,Severe
7,0,84,M,69,10,1,121,37,Well
13,4,160,M,72,10,4,124,-36,Severe
14,6,174,M,101,13,4,160,-14,Severe
11,10,142,F,99,13,1,157,15,Well
12,1,145,F,29,6,8,80,-65,Severe
7,4,88,M,19,6,1,73,-15,Severe
16,4,196,M,110,14,3,171,-25,Severe
5,2,62,M,102,13,6,162,100,Well
13,2,158,M,100,13,3,159,1,Good
11,11,143,M,63,9,6,114,-29,Severe
15,4,184,M,29,6,8,80,-104,Severe
12,5,149,F,5,5,5,65,-84,Severe
8,3,99,M,105,13,9,165,66,Well
8,2,98,M,102,13,6,162,64,Well
10,5,125,M,30,6,9,81,-44,Severe
6,6,78,F,38,7,4,88,10,Well
15,4,184,F,72,10,4,124,-60,Severe
8,4,100,M,54,8,7,103,3,Good
8,9,105,F,17,6,0,72,-33,Severe
8,7,103,F,20,6,2,74,-29,Severe
5,1,61,F,104,13,7,163,102,Well
6,8,80,F,34,7,0,84,4,Good
12,3,147,M,18,6,1,73,-74,Severe
17,3,207,M,98,13,0,156,-51,Severe
6,6,78,F,64,9,7,115,37,Well
6,1,73,M,13,5,9,69,-4,Mild
15,2,182,M,95,12,9,153,-29,Severe
18,7,223,F,75,10,9,129,-94,Severe
7,10,94,M,74,10,7,127,33,Well
12,10,154,F,37,7,3,87,-67,Severe
17,8,212,F,31,6,9,81,-131,Severe
12,5,149,F,109,14,1,169,20,Well
11,3,135,F,18,6,1,73,-62,Severe
8,11,107,M,17,6,0,72,-35,Severe
5,3,63,F,38,7,4,88,25,Well
9,10,118,F,9,5,7,67,-51,Severe
14,10,178,F,88,12,0,144,-34,Severe
10,6,126,M,36,7,2,86,-40,Severe
17,11,215,M,29,6,8,80,-135,Severe
15,3,183,M,47,8,0,96,-87,Severe
8,3,99,F,20,6,2,74,-25,Severe
5,4,64,M,25,6,5,77,13,Well
18,6,222,F,52,8,5,101,-121,Severe
7,2,86,F,70,10,2,122,36,Well
11,3,135,M,52,8,5,101,-34,Severe
5,9,69,F,79,11,1,133,64,Well
16,1,193,M,40,7,5,89,-104,Severe
9,10,118,M,8,5,6,66,-52,Severe
10,0,120,F,87,11,11,143,23,Well
18,5,221,F,79,11,1,133,-88,Severe
13,4,160,M,99,13,1,157,-3,Mild
10,6,126,F,7,5,6,66,-60,Severe
8,4,100,F,7,5,6,66,-34,Severe
14,10,178,F,109,14,1,169,-9,Severe
9,11,119,F,37,7,3,87,-32,Severe
18,7,223,M,65,9,8,116,-107,Severe
9,5,113,M,86,11,10,142,29,Well
7,0,84,M,54,8,7,103,19,Well
9,0,108,M,41,7,6,90,-18,Severe
16,1,193,M,42,7,7,91,-102,Severe
13,10,166,F,66,9,9,117,-49,Severe
15,0,180,F,20,6,2,74,-106,Severe
16,8,200,F,86,11,10,142,-58,Severe
8,8,104,F,92,12,5,149,45,Well
5,8,68,M,96,12,10,154,86,Well
12,11,155,M,27,6,7,79,-76,Severe
9,2,110,F,6,5,5,65,-45,Severe
15,1,181,M,106,13,10,166,-15,Severe
6,3,75,F,93,12,6,150,75,Well
12,0,144,F,105,13,9,165,21,Well
17,3,207,F,50,8,3,99,-108,Severe
6,1,73,F,16,5,11,71,-2,Mild
17,6,210,F,21,6,2,74,-136,Severe
17,2,206,M,94,12,7,151,-55,Severe
10,6,126,F,95,12,9,153,27,Well
8,4,100,M,6,5,5,65,-35,Severe
9,6,114,F,5,5,5,65,-49,Severe
10,7,127,F,12,5,9,69,-58,Severe
5,7,67,M,93,12,6,150,83,Well
7,11,95,F,79,11,1,133,38,Well
5,6,66,F,102,13,6,162,96,Well
14,6,174,F,15,5,11,71,-103,Severe
5,3,63,F,89,12,1,145,82,Well
12,2,146,F,22,6,3,75,-71,Severe
14,11,179,M,92,12,5,149,-30,Severe
18,11,227,F,38,7,4,88,-139,Severe
10,3,123,F,96,12,10,154,31,Well
14,4,172,M,75,10,9,129,-43,Severe
6,11,83,F,2,5,3,63,-20,Severe
12,2,146,M,93,12,6,150,4,Good
14,0,168,F,6,5,5,65,-103,Severe
9,3,111,M,98,13,0,156,45,Well
14,7,175,M,46,7,11,95,-80,Severe
18,0,216,F,62,9,4,112,-104,Severe
14,3,171,F,94,12,7,151,-20,Severe
9,0,108,M,106,13,10,166,58,Well
13,6,162,M,71,10,3,123,-39,Severe
15,8,188,M,14,5,10,70,-118,Severe
8,4,100,F,42,7,7,91,-9,Severe
5,7,67,F,32,6,10,82,15,Well
6,3,75,M,88,12,0,144,69,Well
7,1,85,F,108,14,0,168,83,Well
10,1,121,M,74,10,7,127,6,Well
15,2,182,F,105,13,9,165,-17,Severe
8,3,99,M,11,5,8,68,-31,Severe
16,7,199,M,52,8,5,101,-98,Severe
5,10,70,M,106,13,10,166,96,Well
16,1,193,M,2,5,3,63,-130,Severe
11,3,135,F,79,11,1,133,-2,Mild
10,7,127,M,100,13,3,159,32,Well
7,8,92,M,24,6,5,77,-15,Severe
18,1,217,F,65,9,8,116,-101,Severe
8,3,99,M,32,6,10,82,-17,Severe
8,4,100,F,43,7,8,92,-8,Severe
18,0,216,F,17,6,0,72,-144,Severe
10,0,120,F,51,8,4,100,-20,Severe
18,11,227,F,10,5,7,67,-160,Severe
11,9,141,F,93,12,6,150,9,Well
11,6,138,F,37,7,3,87,-51,Severe
17,3,207,F,99,13,1,157,-50,Severe
7,10,94,M,42,7,7,91,-3,Mild
18,3,219,M,30,6,9,81,-138,Severe
16,1,193,M,10,5,7,67,-126,Severe
12,9,153,M,30,6,9,81,-72,Severe
15,0,180,F,29,6,8,80,-100,Severe
10,3,123,M,74,10,7,127,4,Good
14,8,176,M,62,9,4,112,-64,Severe
14,2,170,M,59,9,1,109,-61,Severe
9,10,118,M,29,6,8,80,-38,Severe
7,6,90,F,110,14,3,171,81,Well
16,8,200,M,44,7,9,93,-107,Severe
12,3,147,M,38,7,4,88,-59,Severe
8,5,101,F,81,11,4,136,35,Well
7,3,87,F,26,6,6,78,-9,Severe
10,10,130,F,57,8,10,106,-24,Severe
10,6,126,M,55,8,8,104,-22,Severe
18,3,219,F,60,9,2,110,-109,Severe
11,5,137,F,103,13,6,162,25,Well
12,2,146,F,39,7,5,89,-57,Severe
5,3,63,M,33,6,11,83,20,Well
5,1,61,M,4,5,4,64,3,Good
15,3,183,F,99,13,1,157,-26,Severe
14,10,178,F,28,6,8,80,-98,Severe
11,1,133,M,68,10,0,120,-13,Severe
12,2,146,M,83,11,6,138,-8,Severe
9,7,115,F,9,5,7,67,-48,Severe
10,11,131,M,91,12,4,148,17,Well
12,9,153,M,83,11,6,138,-15,Severe
15,8,188,M,70,10,2,122,-66,Severe
17,3,207,M,51,8,4,100,-107,Severe
17,3,207,M,87,11,11,143,-64,Severe
7,7,91,F,25,6,5,77,-14,Severe
12,2,146,F,75,10,9,129,-17,Severe
5,3,63,F,110,14,3,171,108,Well
13,8,164,M,3,5,3,63,-101,Severe
6,4,76,F,81,11,4,136,60,Well
16,2,194,M,39,7,5,89,-105,Severe
13,6,162,M,15,5,11,71,-91,Severe
5,3,63,F,65,9,8,116,53,Well
17,3,207,F,30,6,9,81,-126,Severe
8,4,100,F,94,12,7,151,51,Well
10,3,123,M,3,5,3,63,-60,Severe
6,0,72,F,49,8,2,98,26,Well
16,8,200,M,97,12,11,155,-45,Severe
10,6,126,M,12,5,9,69,-57,Severe
10,2,122,F,60,9,2,110,-12,Severe
11,10,142,F,88,12,0,144,2,Good
10,3,123,M,30,6,9,81,-42,Severe
8,0,96,M,6,5,5,65,-31,Severe
13,3,159,F,97,12,11,155,-4,Mild
11,7,139,M,96,12,10,154,15,Well
5,10,70,M,8,5,6,66,-4,Mild
8,3,99,M,7,5,6,66,-33,Severe
10,1,121,M,65,9,8,116,-5,Mild
15,11,191,F,48,8,1,97,-94,Severe
7,5,89,M,32,6,10,82,-7,Severe
15,3,183,F,91,12,4,148,-35,Severe
9,2,110,F,53,8,6,102,-8,Severe
11,9,141,M,79,11,1,133,-8,Severe
18,1,217,F,2,5,3,63,-154,Severe
10,6,126,F,10,5,7,67,-59,Severe
10,9,129,F,29,6,8,80,-49,Severe
13,4,160,M,56,8,9,105,-55,Severe
16,9,201,F,107,13,11,167,-34,Severe
18,1,217,F,54,8,7,103,-114,Severe
15,4,184,F,93,12,6,150,-34,Severe
6,1,73,F,56,8,9,105,32,Well
6,5,77,F,32,6,10,82,5,Good
15,1,181,F,81,11,4,136,-45,Severe
11,7,139,M,12,5,9,69,-70,Severe
18,7,223,F,22,6,3,75,-148,Severe
18,6,222,F,49,8,2,98,-124,Severe
9,8,116,F,56,8,9,105,-11,Severe
11,7,139,F,66,9,9,117,-22,Severe
10,5,125,M,97,12,11,155,30,Well
10,4,124,F,60,9,2,110,-14,Severe
5,9,69,M,54,8,7,103,34,Well
16,5,197,M,12,5,9,69,-128,Severe
8,1,97,F,9,5,7,67,-30,Severe
10,8,128,F,53,8,6,102,-26,Severe
12,5,149,F,3,5,3,63,-86,Severe
6,7,79,M,28,6,8,80,1,Good
11,10,142,F,41,7,6,90,-52,Severe
12,3,147,M,20,6,2,74,-73,Severe
14,0,168,F,52,8,5,101,-67,Severe
9,7,115,M,59,9,1,109,-6,Severe
16,2,194,F,28,6,8,80,-114,Severe
16,11,203,F,57,8,10,106,-97,Severe
17,4,208,M,16,5,11,71,-137,Severe
14,0,168,M,75,10,9,129,-39,Severe
10,5,125,M,57,8,10,106,-19,Severe
9,11,119,F,71,10,3,123,4,Good
5,2,62,F,71,10,3,123,61,Well
14,8,176,F,25,6,5,77,-99,Severe
16,9,201,F,76,10,10,130,-71,Severe
17,11,215,F,96,12,10,154,-61,Severe
17,9,213,M,24,6,5,77,-136,Severe
15,7,187,F,43,7,8,92,-95,Severe
5,11,71,F,9,5,7,67,-4,Mild
14,5,173,F,79,11,1,133,-40,Severe
8,4,100,M,9,5,7,67,-33,Severe
11,5,137,F,76,10,10,130,-7,Severe
14,8,176,M,105,13,9,165,-11,Severe
15,3,183,M,95,12,9,153,-30,Severe
11,2,134,M,68,10,0,120,-14,Severe
5,0,60,F,88,12,0,144,84,Well
11,6,138,F,30,6,9,81,-57,Severe
17,11,215,F,68,10,0,120,-95,Severe
12,8,152,M,31,6,9,81,-71,Severe
7,2,86,F,31,6,9,81,-5,Mild
5,8,68,F,64,9,7,115,47,Well
14,7,175,F,97,12,11,155,-20,Severe
13,3,159,M,99,13,1,157,-2,Mild
18,3,219,F,9,5,7,67,-152,Severe
17,6,210,M,82,11,5,137,-73,Severe
8,2,98,M,65,9,8,116,18,Well
17,2,206,F,38,7,4,88,-118,Severe
11,10,142,M,67,9,10,118,-24,Severe
9,8,116,F,53,8,6,102,-14,Severe
14,0,168,F,104,13,7,163,-5,Mild
5,6,66,F,104,13,7,163,97,Well
14,3,171,F,74,10,7,127,-44,Severe
18,3,219,F,59,9,1,109,-110,Severe
8,6,102,M,31,6,9,81,-21,Severe
11,6,138,M,45,7,10,94,-44,Severe
16,4,196,M,72,10,4,124,-72,Severe
5,0,60,M,3,5,3,63,3,Good
11,6,138,F,71,10,3,123,-15,Severe
11,3,135,M,4,5,4,64,-71,Severe
5,2,62,M,106,13,10,166,104,Well
15,11,191,F,95,12,9,153,-38,Severe
13,0,156,M,43,7,8,92,-64,Severe
7,6,90,M,51,8,4,100,10,Well
11,9,141,F,20,6,2,74,-67,Severe
18,4,220,F,65,9,8,116,-104,Severe
10,11,131,M,63,9,6,114,-17,Severe
13,0,156,F,84,11,7,139,-17,Severe
16,0,192,M,10,5,7,67,-125,Severe
7,8,92,M,61,9,3,111,19,Well
8,0,96,F,75,10,9,129,33,Well
6,2,74,M,13,5,9,69,-5,Mild
9,8,116,M,29,6,8,80,-36,Severe
9,9,117,F,51,8,4,100,-17,Severe
16,5,197,M,55,8,8,104,-93,Severe
17,5,209,M,27,6,7,79,-130,Severe
11,3,135,F,52,8,5,101,-34,Severe
10,3,123,M,56,8,9,105,-18,Severe
13,7,163,M,16,5,11,71,-92,Severe
12,11,155,M,40,7,5,89,-66,Severe
14,2,170,M,100,13,3,159,-11,Severe
11,7,139,M,32,6,10,82,-57,Severe
18,9,225,M,2,5,3,63,-162,Severe
6,3,75,F,45,7,10,94,19,Well
6,5,77,F,76,10,10,130,53,Well
9,11,119,F,22,6,3,75,-44,Severe
12,1,145,F,91,12,4,148,3,Good
9,11,119,F,110,14,3,171,52,Well
7,9,93,M,83,11,6,138,45,Well
14,5,173,M,59,9,1,109,-64,Severe
6,5,77,M,54,8,7,103,26,Well
5,3,63,M,54,8,7,103,40,Well
14,2,170,F,61,9,3,111,-59,Severe
5,1,61,M,69,10,1,121,60,Well
7,9,93,M,41,7,6,90,-3,Mild
18,2,218,M,110,14,3,171,-47,Severe
13,4,160,M,36,7,2,86,-74,Severe
9,1,109,F,90,12,3,147,38,Well
12,4,148,M,94,12,7,151,3,Good
12,4,148,M,63,9,6,114,-34,Severe
10,3,123,F,84,11,7,139,16,Well
9,7,115,F,97,12,11,155,40,Well
9,2,110,F,94,12,7,151,41,Well
18,9,225,M,110,14,3,171,-54,Severe
9,11,119,F,67,9,10,118,-1,Mild
12,3,147,M,64,9,7,115,-32,Severe
6,4,76,F,25,6,5,77,1,Good
9,10,118,F,85,11,9,141,23,Well
14,4,172,M,50,8,3,99,-73,Severe
12,10,154,F,83,11,6,138,-16,Severe
5,3,63,F,68,10,0,120,57,Well
15,4,184,F,20,6,2,74,-110,Severe
5,7,67,F,104,13,7,163,96,Well
11,2,134,M,48,8,1,97,-37,Severe
10,5,125,F,3,5,3,63,-62,Severe
8,10,106,F,62,9,4,112,6,Well
12,10,154,M,110,14,3,171,17,Well
12,3,147,F,77,10,11,131,-16,Severe
10,1,121,M,20,6,2,74,-47,Severe
17,5,209,F,47,8,0,96,-113,Severe
6,0,72,M,18,6,1,73,1,Good
8,3,99,M,23,6,4,76,-23,Severe
12,9,153,M,35,7,1,85,-68,Severe
9,3,111,F,36,7,2,86,-25,Severe
6,8,80,M,30,6,9,81,1,Good
12,11,155,F,60,9,2,110,-45,Severe
10,2,122,M,74,10,7,127,5,Good
18,7,223,F,46,7,11,95,-128,Severe
18,6,222,M,109,14,1,169,-53,Severe
7,9,93,F,6,5,5,65,-28,Severe
13,0,156,F,63,9,6,114,-42,Severe
13,10,166,F,25,6,5,77,-89,Severe
6,5,77,M,75,10,9,129,52,Well
13,2,158,F,31,6,9,81,-77,Severe
6,9,81,M,104,13,7,163,82,Well
7,5,89,M,102,13,6,162,73,Well
18,3,219,M,102,13,6,162,-57,Severe
13,3,159,F,68,10,0,120,-39,Severe
13,0,156,F,81,11,4,136,-20,Severe
10,3,123,M,94,12,7,151,28,Well
7,3,87,F,68,10,0,120,33,Well
16,4,196,F,60,9,2,110,-86,Severe
8,10,106,M,90,12,3,147,41,Well
18,9,225,M,40,7,5,89,-136,Severe
14,3,171,M,84,11,7,139,-32,Severe
12,3,147,M,46,7,11,95,-52,Severe
14,8,176,M,15,5,11,71,-105,Severe
16,4,196,F,94,12,7,151,-45,Severe
7,5,89,M,34,7,0,84,-5,Mild
5,11,71,F,98,13,0,156,85,Well
8,0,96,F,63,9,6,114,18,Well
16,4,196,F,87,11,11,143,-53,Severe
14,0,168,F,46,7,11,95,-73,Severe
17,11,215,F,79,11,1,133,-82,Severe
5,2,62,F,96,12,10,154,92,Well
8,1,97,M,63,9,6,114,17,Well
8,10,106,M,86,11,10,142,36,Well
17,2,206,F,36,7,2,86,-120,Severe
14,2,170,M,90,12,3,147,-23,Severe
9,6,114,M,72,10,4,124,10,Well
16,9,201,M,19,6,1,73,-128,Severe
17,3,207,F,58,9,0,108,-99,Severe
7,9,93,F,39,7,5,89,-4,Mild
17,9,213,F,13,5,9,69,-144,Severe
9,3,111,M,96,12,10,154,43,Well
8,6,102,M,42,7,7,91,-11,Severe
7,11,95,F,33,6,11,83,-12,Severe
5,5,65,M,69,10,1,121,56,Well
9,3,111,F,94,12,7,151,40,Well
7,6,90,F,29,6,8,80,-10,Severe
5,8,68,M,19,6,1,73,5,Good
7,5,89,F,67,9,10,118,29,Well
12,8,152,F,83,11,6,138,-14,Severe
16,8,200,F,3,5,3,63,-137,Severe
9,5,113,M,41,7,6,90,-23,Severe
9,8,116,F,26,6,6,78,-38,Severe
17,4,208,F,72,10,4,124,-84,Severe
15,5,185,F,40,7,5,89,-96,Severe
13,3,159,M,34,7,0,84,-75,Severe
10,0,120,F,101,13,4,160,40,Well
14,3,171,M,3,5,3,63,-108,Severe
18,7,223,F,67,9,10,118,-105,Severe
7,3,87,F,42,7,7,91,4,Good
10,9,129,M,82,11,5,137,8,Well
6,3,75,F,28,6,8,80,5,Good
8,4,100,F,73,10,6,126,26,Well
17,0,204,M,67,9,10,118,-86,Severe
17,10,214,M,105,13,9,165,-49,Severe
6,0,72,F,78,11,0,132,60,Well
14,5,173,F,108,14,0,168,-5,Mild
11,8,140,F,54,8,7,103,-37,Severe
6,6,78,M,79,11,1,133,55,Well
8,2,98,M,68,10,0,120,22,Well
13,3,159,M,20,6,2,74,-85,Severe
11,3,135,M,7,5,6,66,-69,Severe
11,5,137,M,28,6,8,80,-57,Severe
5,11,71,M,90,12,3,147,76,Well
5,8,68,M,66,9,9,117,49,Well
6,2,74,M,24,6,5,77,3,Good
13,9,165,M,73,10,6,126,-39,Severe
11,10,142,F,40,7,5,89,-53,Severe
14,7,175,F,67,9,10,118,-57,Severe
16,7,199,M,81,11,4,136,-63,Severe
11,11,143,M,19,6,1,73,-70,Severe
5,3,63,M,37,7,3,87,24,Well
12,4,148,F,101,13,4,160,12,Well
10,8,128,F,3,5,3,63,-65,Severe
14,11,179,F,10,5,7,67,-112,Severe
17,10,214,F,19,6,1,73,-141,Severe
8,1,97,M,36,7,2,86,-11,Severe
18,7,223,F,84,11,7,139,-84,Severe
7,6,90,F,17,6,0,72,-18,Severe
12,5,149,M,75,10,9,129,-20,Severe
10,7,127,M,6,5,5,65,-62,Severe
7,3,87,F,83,11,6,138,51,Well
14,3,171,M,21,6,2,74,-97,Severe
5,4,64,F,100,13,3,159,95,Well
14,10,178,F,29,6,8,80,-98,Severe
7,1,85,F,21,6,2,74,-11,Severe
18,7,223,M,101,13,4,160,-63,Severe
10,11,131,F,23,6,4,76,-55,Severe
15,3,183,F,52,8,5,101,-82,Severe
17,6,210,F,57,8,10,106,-104,Severe
15,6,186,M,91,12,4,148,-38,Severe
18,5,221,M,36,7,2,86,-135,Severe
9,11,119,M,89,12,1,145,26,Well
17,9,213,F,51,8,4,100,-113,Severe
12,7,151,M,88,12,0,144,-7,Severe
16,7,199,M,45,7,10,94,-105,Severe
7,3,87,F,107,13,11,167,80,Well
13,7,163,F,8,5,6,66,-97,Severe
18,10,226,M,14,5,10,70,-156,Severe
15,9,189,M,71,10,3,123,-66,Severe
11,7,139,M,5,5,5,65,-74,Severe
13,8,164,M,75,10,9,129,-35,Severe
16,2,194,F,109,14,1,169,-25,Severe
12,2,146,M,23,6,4,76,-70,Severe
5,9,69,M,79,11,1,133,64,Well
10,3,123,F,36,7,2,86,-37,Severe
6,5,77,F,17,6,0,72,-5,Mild
17,3,207,M,41,7,6,90,-117,Severe
14,6,174,F,7,5,6,66,-108,Severe
7,9,93,F,72,10,4,124,31,Well
7,4,88,F,32,6,10,82,-6,Severe
6,5,77,F,3,5,3,63,-14,Severe
16,1,193,F,90,12,3,147,-46,Severe
14,2,170,F,85,11,9,141,-29,Severe
18,1,217,F,49,8,2,98,-119,Severe
10,4,124,F,73,10,6,126,2,Good
18,3,219,F,37,7,3,87,-132,Severe
5,11,71,F,79,11,1,133,62,Well
10,5,125,F,32,6,10,82,-43,Severe
16,10,202,F,104,13,7,163,-39,Severe
9,4,112,M,6,5,5,65,-47,Severe
8,10,106,F,28,6,8,80,-26,Severe
7,3,87,M,77,10,11,131,44,Well
12,1,145,M,81,11,4,136,-9,Severe
6,7,79,M,78,11,0,132,53,Well
7,6,90,F,16,5,11,71,-19,Severe
11,6,138,M,51,8,4,100,-38,Severe
15,3,183,M,19,6,1,73,-110,Severe
16,3,195,M,9,5,7,67,-128,Severe
9,2,110,F,81,11,4,136,26,Well
7,3,87,F,62,9,4,112,25,Well
10,3,123,F,21,6,2,74,-49,Severe
10,9,129,F,5,5,5,65,-64,Severe
5,3,63,F,92,12,5,149,86,Well
16,7,199,F,53,8,6,102,-97,Severe
15,5,185,M,4,5,4,64,-121,Severe
13,7,163,M,2,5,3,63,-100,Severe
16,6,198,F,80,11,3,135,-63,Severe
14,6,174,F,71,10,3,123,-51,Severe
17,11,215,M,95,12,9,153,-62,Severe
11,4,136,M,67,9,10,118,-18,Severe
16,3,195,F,35,7,1,85,-110,Severe
12,1,145,F,109,14,1,169,24,Well
12,6,150,M,4,5,4,64,-86,Severe
13,9,165,F,16,5,11,71,-94,Severe
5,3,63,M,99,13,1,157,94,Well
11,8,140,M,101,13,4,160,20,Well
5,9,69,F,22,6,3,75,6,Well
13,3,159,M,46,7,11,95,-64,Severe
13,11,167,M,82,11,5,137,-30,Severe
10,8,128,F,105,13,9,165,37,Well
7,1,85,M,25,6,5,77,-8,Severe
15,10,190,M,25,6,5,77,-113,Severe
7,9,93,M,3,5,3,63,-30,Severe
18,9,225,F,102,13,6,162,-63,Severe
11,0,132,F,51,8,4,100,-32,Severe
6,3,75,F,71,10,3,123,48,Well
8,2,98,M,24,6,5,77,-21,Severe
14,3,171,M,57,8,10,106,-65,Severe
17,2,206,M,10,5,7,67,-139,Severe
11,11,143,F,102,13,6,162,19,Well
5,9,69,M,91,12,4,148,79,Well
10,5,125,M,102,13,6,162,37,Well
12,3,147,M,76,10,10,130,-17,Severe
13,10,166,F,56,8,9,105,-61,Severe
18,11,227,M,58,9,0,108,-119,Severe
17,5,209,M,108,14,0,168,-41,Severe
16,7,199,M,14,5,10,70,-129,Severe
10,3,123,M,69,10,1,121,-2,Mild
9,9,117,F,102,13,6,162,45,Well
10,7,127,F,7,5,6,66,-61,Severe
18,10,226,F,52,8,5,101,-125,Severe
6,10,82,F,67,9,10,118,36,Well
13,0,156,M,12,5,9,69,-87,Severe
6,8,80,F,62,9,4,112,32,Well
7,6,90,M,2,5,3,63,-27,Severe
5,5,65,M,15,5,11,71,6,Well
12,0,144,M,3,5,3,63,-81,Severe
17,5,209,M,26,6,6,78,-131,Severe
16,7,199,F,54,8,7,103,-96,Severe
13,5,161,F,21,6,2,74,-87,Severe
18,5,221,F,43,7,8,92,-129,Severe
5,3,63,M,29,6,8,80,17,Well
14,7,175,M,107,13,11,167,-8,Severe
18,0,216,F,97,12,11,155,-61,Severe
9,1,109,F,32,6,10,82,-27,Severe
18,2,218,M,63,9,6,114,-104,Severe
5,4,64,M,92,12,5,149,85,Well
15,9,189,M,21,6,2,74,-115,Severe
17,3,207,F,22,6,3,75,-132,Severe
13,3,159,M,4,5,4,64,-95,Severe
6,1,73,M,25,6,5,77,4,Good
18,0,216,F,36,7,2,86,-130,Severe
5,3,63,F,58,9,0,108,45,Well
7,2,86,F,37,7,3,87,1,Good
8,1,97,F,83,11,6,138,41,Well
12,10,154,F,36,7,2,86,-68,Severe
10,3,123,M,49,8,2,98,-25,Severe
18,7,223,F,21,6,2,74,-149,Severe
14,3,171,M,62,9,4,112,-59,Severe
17,2,206,M,96,12,10,154,-52,Severe
9,7,115,F,30,6,9,81,-34,Severe
11,6,138,F,75,10,9,129,-9,Severe
17,6,210,M,24,6,5,77,-133,Severe
11,6,138,F,4,5,4,64,-74,Severe
11,3,135,M,45,7,10,94,-41,Severe
16,10,202,M,33,6,11,83,-119,Severe
14,11,179,M,88,12,0,144,-35,Severe
6,7,79,M,76,10,10,130,51,Well
6,9,81,F,100,13,3,159,78,Well
9,4,112,M,79,11,1,133,21,Well
13,3,159,M,85,11,9,141,-18,Severe
18,6,222,M,87,11,11,143,-79,Severe
7,5,89,F,32,6,10,82,-7,Severe
9,8,116,M,52,8,5,101,-15,Severe
14,9,177,F,57,8,10,106,-71,Severe
11,5,137,M,14,5,10,70,-67,Severe
8,7,103,F,36,7,2,86,-17,Severe
6,6,78,M,73,10,6,126,48,Well
15,4,184,F,63,9,6,114,-70,Severe
8,10,106,F,68,10,0,120,14,Well
7,2,86,M,80,11,3,135,49,Well
10,3,123,M,91,12,4,148,25,Well
6,7,79,M,20,6,2,74,-5,Mild
6,4,76,M,106,13,10,166,90,Well
13,2,158,M,46,7,11,95,-63,Severe
6,8,80,M,79,11,1,133,53,Well
7,6,90,M,3,5,3,63,-27,Severe
13,4,160,M,44,7,9,93,-67,Severe
7,8,92,F,6,5,5,65,-27,Severe
17,10,214,F,38,7,4,88,-126,Severe
16,10,202,M,32,6,10,82,-120,Severe
5,6,66,M,98,13,0,156,90,Well
14,6,174,M,103,13,6,162,-12,Severe
11,6,138,M,91,12,4,148,10,Well
10,7,127,F,8,5,6,66,-61,Severe
9,5,113,F,93,12,6,150,37,Well
18,1,217,F,26,6,6,78,-139,Severe
11,7,139,F,25,6,5,77,-62,Severe
9,3,111,M,81,11,4,136,25,Well
14,3,171,F,88,12,0,144,-27,Severe
16,3,195,F,53,8,6,102,-93,Severe
5,9,69,M,108,14,0,168,99,Well
9,4,112,F,19,6,1,73,-39,Severe
12,11,155,F,56,8,9,105,-50,Severe
6,6,78,F,54,8,7,103,25,Well
5,2,62,M,68,10,0,120,58,Well
8,0,96,F,88,12,0,144,48,Well
9,3,111,F,72,10,4,124,13,Well
10,7,127,F,22,6,3,75,-52,Severe
9,5,113,M,99,13,1,157,44,Well
6,3,75,M,55,8,8,104,29,Well
17,11,215,F,41,7,6,90,-125,Severe
13,3,159,F,34,7,0,84,-75,Severe
5,9,69,M,57,8,10,106,37,Well
18,11,227,M,45,7,10,94,-133,Severe
16,3,195,F,36,7,2,86,-109,Severe
9,10,118,F,30,6,9,81,-37,Severe
15,1,181,M,30,6,9,81,-100,Severe
8,8,104,M,60,9,2,110,6,Well
7,4,88,F,84,11,7,139,51,Well
5,3,63,F,37,7,3,87,24,Well
5,3,63,F,106,13,10,166,103,Well
8,2,98,M,90,12,3,147,49,Well
16,2,194,M,46,7,11,95,-99,Severe
11,1,133,F,101,13,4,160,27,Well
18,7,223,M,55,8,8,104,-119,Severe
5,2,62,F,100,13,3,159,97,Well
14,11,179,F,90,12,3,147,-32,Severe
13,10,166,F,95,12,9,153,-13,Severe
7,10,94,F,46,7,11,95,1,Good
15,5,185,F,84,11,7,139,-46,Severe
7,1,85,M,80,11,3,135,50,Well
13,8,164,M,84,11,7,139,-25,Severe
14,5,173,M,87,11,11,143,-30,Severe
6,5,77,F,43,7,8,92,15,Well
16,0,192,M,71,10,3,123,-69,Severe
5,0,60,M,96,12,10,154,94,Well
16,4,196,M,10,5,7,67,-129,Severe
7,8,92,M,16,5,11,71,-21,Severe
12,4,148,M,50,8,3,99,-49,Severe
9,7,115,F,25,6,5,77,-38,Severe
15,7,187,M,31,6,9,81,-106,Severe
14,7,175,M,58,9,0,108,-67,Severe
9,11,119,M,55,8,8,104,-15,Severe
13,5,161,F,60,9,2,110,-51,Severe
15,11,191,M,3,5,3,63,-128,Severe
10,11,131,M,13,5,9,69,-62,Severe
16,1,193,F,37,7,3,87,-106,Severe
18,9,225,F,18,6,1,73,-152,Severe
15,7,187,F,29,6,8,80,-107,Severe
15,5,185,F,71,10,3,123,-62,Severe
13,6,162,M,25,6,5,77,-85,Severe
13,2,158,M,45,7,10,94,-64,Severe
16,11,203,M,68,10,0,120,-83,Severe
7,6,90,M,84,11,7,139,49,Well
5,3,63,F,8,5,6,66,3,Good
8,8,104,F,77,10,11,131,27,Well
12,0,144,F,101,13,4,160,16,Well
9,9,117,F,97,12,11,155,38,Well
14,1,169,F,12,5,9,69,-100,Severe
5,2,62,F,57,8,10,106,44,Well
18,7,223,M,34,7,0,84,-139,Severe
17,7,211,M,96,12,10,154,-57,Severe
13,5,161,F,56,8,9,105,-56,Severe
7,4,88,F,63,9,6,114,26,Well
14,9,177,M,69,10,1,121,-56,Severe
11,1,133,M,39,7,5,89,-44,Severe
16,2,194,M,51,8,4,100,-94,Severe
9,3,111,F,108,14,0,168,57,Well
16,3,195,M,8,5,6,66,-129,Severe
12,0,144,M,105,13,9,165,21,Well
7,10,94,M,79,11,1,133,39,Well
9,3,111,M,53,8,6,102,-9,Severe
10,9,129,M,32,6,10,82,-47,Severe
17,4,208,F,79,11,1,133,-75,Severe
14,10,178,F,62,9,4,112,-66,Severe
16,7,199,M,70,10,2,122,-77,Severe
14,8,176,F,3,5,3,63,-113,Severe
16,3,195,F,83,11,6,138,-57,Severe
6,9,81,M,110,14,3,171,90,Well
15,11,191,M,73,10,6,126,-65,Severe
14,9,177,M,41,7,6,90,-87,Severe
11,1,133,M,41,7,6,90,-43,Severe
11,2,134,F,95,12,9,153,19,Well
14,8,176,F,16,5,11,71,-105,Severe
14,8,176,M,3,5,3,63,-113,Severe
17,6,210,M,49,8,2,98,-112,Severe
16,8,200,M,21,6,2,74,-126,Severe
18,11,227,M,89,12,1,145,-82,Severe
6,7,79,M,63,9,6,114,35,Well
9,3,111,F,89,12,1,145,34,Well
15,8,188,F,96,12,10,154,-34,Severe
16,8,200,F,73,10,6,126,-74,Severe
17,2,206,M,58,9,0,108,-98,Severe
13,11,167,F,62,9,4,112,-55,Severe
11,5,137,F,44,7,9,93,-44,Severe
15,3,183,M,91,12,4,148,-35,Severe
6,1,73,F,22,6,3,75,2,Good
7,5,89,F,12,5,9,69,-20,Severe
11,10,142,M,6,5,5,65,-77,Severe
8,11,107,F,62,9,4,112,5,Good
12,8,152,F,8,5,6,66,-86,Severe
9,3,111,F,56,8,9,105,-6,Severe
8,3,99,M,9,5,7,67,-32,Severe
13,7,163,M,52,8,5,101,-62,Severe
13,1,157,F,60,9,2,110,-47,Severe
9,7,115,F,7,5,6,66,-49,Severe
5,2,62,F,92,12,5,149,87,Well
11,6,138,M,30,6,9,81,-57,Severe
13,11,167,F,109,14,1,169,2,Good
7,3,87,M,66,9,9,117,30,Well
13,11,167,M,105,13,9,165,-2,Mild
15,5,185,F,53,8,6,102,-83,Severe
18,6,222,F,93,12,6,150,-72,Severe
5,11,71,M,61,9,3,111,40,Well
10,4,124,F,50,8,3,99,-25,Severe
16,11,203,F,47,8,0,96,-107,Severe
8,5,101,F,49,8,2,98,-3,Mild
18,10,226,F,71,10,3,123,-103,Severe
6,5,77,M,18,6,1,73,-4,Mild
7,11,95,M,3,5,3,63,-32,Severe
12,1,145,M,63,9,6,114,-31,Severe
13,0,156,M,64,9,7,115,-41,Severe
11,9,141,F,18,6,1,73,-68,Severe
8,11,107,F,32,6,10,82,-25,Severe
18,0,216,M,97,12,11,155,-61,Severe
10,3,123,M,2,5,3,63,-60,Severe
7,5,89,M,61,9,3,111,22,Well
13,3,159,M,70,10,2,122,-37,Severe
7,7,91,M,75,10,9,129,38,Well
16,7,199,F,22,6,3,75,-124,Severe
13,1,157,M,109,14,1,169,12,Well
14,11,179,M,59,9,1,109,-70,Severe
18,3,219,M,52,8,5,101,-118,Severe
14,5,173,M,30,6,9,81,-92,Severe
11,6,138,M,102,13,6,162,24,Well
5,1,61,M,63,9,6,114,53,Well
17,9,213,F,39,7,5,89,-124,Severe
14,5,173,M,35,7,1,85,-88,Severe
11,6,138,F,56,8,9,105,-33,Severe
11,3,135,F,61,9,3,111,-24,Severe
13,7,163,F,103,13,6,162,-1,Mild
6,2,74,M,93,12,6,150,76,Well
11,8,140,F,90,12,3,147,7,Well
9,8,116,F,106,13,10,166,50,Well
6,9,81,M,82,11,5,137,56,Well
16,7,199,M,51,8,4,100,-99,Severe
11,3,135,F,9,5,7,67,-68,Severe
5,9,69,M,97,12,11,155,86,Well
13,3,159,F,23,6,4,76,-83,Severe
9,7,115,M,86,11,10,142,27,Well
16,3,195,M,64,9,7,115,-80,Severe
10,7,127,M,25,6,5,77,-50,Severe
15,0,180,F,4,5,4,64,-116,Severe
8,3,99,M,14,5,10,70,-29,Severe
8,3,99,F,70,10,2,122,23,Well
7,0,84,F,73,10,6,126,42,Well
8,9,105,F,44,7,9,93,-12,Severe
8,1,97,M,27,6,7,79,-18,Severe
18,5,221,F,76,10,10,130,-91,Severe
10,7,127,M,36,7,2,86,-41,Severe
8,3,99,F,99,13,1,157,58,Well
17,6,210,F,19,6,1,73,-137,Severe
7,6,90,M,40,7,5,89,-1,Mild
9,6,114,F,8,5,6,66,-48,Severe
12,0,144,F,87,11,11,143,-1,Mild
16,11,203,F,7,5,6,66,-137,Severe
17,9,213,F,29,6,8,80,-133,Severe
16,1,193,M,102,13,6,162,-31,Severe
12,7,151,M,85,11,9,141,-10,Severe
13,11,167,M,77,10,11,131,-36,Severe
6,3,75,F,72,10,4,124,49,Well
5,3,63,M,80,11,3,135,72,Well
10,6,126,M,28,6,8,80,-46,Severe
15,9,189,F,62,9,4,112,-77,Severe
18,1,217,M,13,5,9,69,-148,Severe
11,4,136,M,76,10,10,130,-6,Severe
9,3,111,F,15,5,11,71,-40,Severe
9,6,114,F,46,7,11,95,-19,Severe
17,3,207,M,55,8,8,104,-103,Severe
10,6,126,F,4,5,4,64,-62,Severe
18,3,219,M,4,5,4,64,-155,Severe
6,11,83,M,10,5,7,67,-16,Severe
9,5,113,M,75,10,9,129,16,Well
17,6,210,F,56,8,9,105,-105,Severe
6,7,79,M,6,5,5,65,-14,Severe
5,11,71,F,47,8,0,96,25,Well
8,4,100,M,74,10,7,127,27,Well
5,8,68,M,4,5,4,64,-4,Mild
9,2,110,M,106,13,10,166,56,Well
18,5,221,M,108,14,0,168,-53,Severe
11,8,140,F,81,11,4,136,-4,Mild
17,2,206,F,86,11,10,142,-64,Severe
13,8,164,F,32,6,10,82,-82,Severe
18,9,225,F,66,9,9,117,-108,Severe
10,3,123,M,12,5,9,69,-54,Severe
8,6,102,F,23,6,4,76,-26,Severe
9,2,110,F,98,13,0,156,46,Well
18,1,217,M,97,12,11,155,-62,Severe
16,11,203,F,4,5,4,64,-139,Severe
17,6,210,F,93,12,6,150,-60,Severe
18,5,221,F,34,7,0,84,-137,Severe
7,8,92,M,12,5,9,69,-23,Severe
7,10,94,F,102,13,6,162,68,Well
5,6,66,M,45,7,10,94,28,Well
12,4,148,F,57,8,10,106,-42,Severe
17,6,210,M,7,5,6,66,-144,Severe
18,7,223,M,18,6,1,73,-150,Severe
8,9,105,F,92,12,5,149,44,Well
18,8,224,M,21,6,2,74,-150,Severe
7,8,92,M,3,5,3,63,-29,Severe
14,9,177,F,6,5,5,65,-112,Severe
15,10,190,M,89,12,1,145,-45,Severe
6,0,72,F,15,5,11,71,-1,Mild
11,8,140,F,34,7,0,84,-56,Severe
14,10,178,F,25,6,5,77,-101,Severe
15,11,191,M,9,5,7,67,-124,Severe
5,1,61,F,107,13,11,167,106,Well
8,2,98,F,58,9,0,108,10,Well
17,6,210,M,20,6,2,74,-136,Severe
12,5,149,M,108,14,0,168,19,Well
17,4,208,F,52,8,5,101,-107,Severe
17,0,204,F,84,11,7,139,-65,Severe
13,1,157,F,56,8,9,105,-52,Severe
6,7,79,M,81,11,4,136,57,Well
5,3,63,F,54,8,7,103,40,Well
5,4,64,F,105,13,9,165,101,Well
12,5,149,M,65,9,8,116,-33,Severe
6,8,80,F,110,14,3,171,91,Well
5,5,65,M,96,12,10,154,89,Well
7,11,95,F,85,11,9,141,46,Well
5,2,62,F,101,13,4,160,98,Well
9,5,113,M,45,7,10,94,-19,Severe
6,3,75,F,99,13,1,157,82,Well
17,4,208,F,68,10,0,120,-88,Severe
9,7,115,M,45,7,10,94,-21,Severe
14,3,171,M,39,7,5,89,-82,Severe
16,3,195,F,61,9,3,111,-84,Severe
13,2,158,M,55,8,8,104,-54,Severe
15,1,181,F,62,9,4,112,-69,Severe
5,1,61,F,63,9,6,114,53,Well
8,2,98,M,10,5,7,67,-31,Severe
8,10,106,F,15,5,11,71,-35,Severe
18,11,227,M,98,13,0,156,-71,Severe
18,2,218,F,37,7,3,87,-131,Severe
15,10,190,F,63,9,6,114,-76,Severe
17,2,206,M,87,11,11,143,-63,Severe
9,11,119,M,81,11,4,136,17,Well
16,8,200,F,64,9,7,115,-85,Severe
18,7,223,F,20,6,2,74,-149,Severe
13,10,166,M,12,5,9,69,-97,Severe
16,1,193,F,35,7,1,85,-108,Severe
12,8,152,M,43,7,8,92,-60,Severe
17,0,204,M,27,6,7,79,-125,Severe
10,8,128,F,93,12,6,150,22,Well
16,4,196,M,40,7,5,89,-107,Severe
12,2,146,M,77,10,11,131,-15,Severe
15,3,183,F,8,5,6,66,-117,Severe
5,3,63,F,15,5,11,71,8,Well
8,5,101,M,109,14,1,169,68,Well
6,6,78,M,99,13,1,157,79,Well
16,5,197,M,40,7,5,89,-108,Severe
15,0,180,F,34,7,0,84,-96,Severe
5,7,67,F,109,14,1,169,102,Well
12,4,148,M,37,7,3,87,-61,Severe
16,7,199,F,97,12,11,155,-44,Severe
7,6,90,M,92,12,5,149,59,Well
7,8,92,M,54,8,7,103,11,Well
16,9,201,F,98,13,0,156,-45,Severe
5,10,70,M,33,6,11,83,13,Well
5,1,61,M,36,7,2,86,25,Well
14,11,179,M,97,12,11,155,-24,Severe
8,3,99,M,82,11,5,137,38,Well
16,3,195,M,77,10,11,131,-64,Severe
5,4,64,F,71,10,3,123,59,Well
18,9,225,M,74,10,7,127,-98,Severe
9,4,112,F,3,5,3,63,-49,Severe
13,11,167,F,42,7,7,91,-76,Severe
13,4,160,F,102,13,6,162,2,Good
13,6,162,F,40,7,5,89,-73,Severe
8,8,104,M,30,6,9,81,-23,Severe
8,10,106,F,103,13,6,162,56,Well
7,1,85,F,60,9,2,110,25,Well
13,0,156,F,47,8,0,96,-60,Severe
10,7,127,F,79,11,1,133,6,Well
18,6,222,M,89,12,1,145,-77,Severe
16,1,193,M,74,10,7,127,-66,Severe
10,9,129,F,73,10,6,126,-3,Mild
14,3,171,F,108,14,0,168,-3,Mild
14,6,174,M,49,8,2,98,-76,Severe
10,11,131,F,35,7,1,85,-46,Severe
16,5,197,M,52,8,5,101,-96,Severe
12,5,149,F,45,7,10,94,-55,Severe
8,4,100,M,69,10,1,121,21,Well
14,7,175,F,10,5,7,67,-108,Severe
9,3,111,F,83,11,6,138,27,Well
17,10,214,M,56,8,9,105,-109,Severe
13,1,157,F,53,8,6,102,-55,Severe
18,5,221,M,92,12,5,149,-72,Severe
13,0,156,M,7,5,6,66,-90,Severe
9,7,115,M,63,9,6,114,-1,Mild
7,5,89,M,38,7,4,88,-1,Mild
5,0,60,F,82,11,5,137,77,Well
11,0,132,F,75,10,9,129,-3,Mild
5,0,60,F,31,6,9,81,21,Well
11,5,137,M,93,12,6,150,13,Well
10,3,123,F,43,7,8,92,-31,Severe
18,2,218,M,25,6,5,77,-141,Severe
9,4,112,M,24,6,5,77,-35,Severe
10,11,131,M,77,10,11,131,0,Neutral
17,3,207,F,6,5,5,65,-142,Severe
9,0,108,M,108,14,0,168,60,Well
8,6,102,M,72,10,4,124,22,Well
6,2,74,F,102,13,6,162,88,Well
6,0,72,F,25,6,5,77,5,Good
13,3,159,F,81,11,4,136,-23,Severe
5,9,69,M,6,5,5,65,-4,Mild
9,11,119,M,72,10,4,124,5,Good
9,11,119,M,36,7,2,86,-33,Severe
6,4,76,F,106,13,10,166,90,Well
9,1,109,F,80,11,3,135,26,Well
10,8,128,F,37,7,3,87,-41,Severe
7,6,90,F,79,11,1,133,43,Well
7,2,86,F,57,8,10,106,20,Well
18,8,224,F,40,7,5,89,-135,Severe
16,1,193,F,36,7,2,86,-107,Severe
13,8,164,M,36,7,2,86,-78,Severe
7,1,85,F,41,7,6,90,5,Good
5,7,67,F,65,9,8,116,49,Well
9,7,115,M,82,11,5,137,22,Well
6,10,82,F,110,14,3,171,89,Well
10,2,122,M,106,13,10,166,44,Well
11,3,135,F,52,8,5,101,-34,Severe
15,3,183,F,40,7,5,89,-94,Severe
16,10,202,M,100,13,3,159,-43,Severe
5,1,61,F,13,5,9,69,8,Well
5,7,67,F,19,6,1,73,6,Well
7,0,84,M,49,8,2,98,14,Well
5,6,66,F,87,11,11,143,77,Well
15,9,189,F,21,6,2,74,-115,Severe
11,2,134,M,33,6,11,83,-51,Severe
5,7,67,F,90,12,3,147,80,Well
9,4,112,M,70,10,2,122,10,Well
15,7,187,M,45,7,10,94,-93,Severe
8,3,99,M,12,5,9,69,-30,Severe
15,9,189,M,101,13,4,160,-29,Severe
8,6,102,F,108,14,0,168,66,Well
18,7,223,M,96,12,10,154,-69,Severe
10,0,120,M,79,11,1,133,13,Well
5,10,70,M,83,11,6,138,68,Well
12,0,144,M,70,10,2,122,-22,Severe
13,10,166,M,18,6,1,73,-93,Severe
9,5,113,F,44,7,9,93,-20,Severe
7,3,87,F,33,6,11,83,-4,Mild
13,1,157,F,51,8,4,100,-57,Severe
6,11,83,F,60,9,2,110,27,Well
11,2,134,F,28,6,8,80,-54,Severe
10,4,124,M,93,12,6,150,26,Well
17,3,207,M,44,7,9,93,-114,Severe
18,2,218,M,57,8,10,106,-112,Severe
17,11,215,M,51,8,4,100,-115,Severe
17,3,207,F,103,13,6,162,-45,Severe
17,3,207,M,50,8,3,99,-108,Severe
6,4,76,F,4,5,4,64,-12,Severe
15,3,183,F,91,12,4,148,-35,Severe
7,2,86,M,27,6,7,79,-7,Severe
13,5,161,F,36,7,2,86,-75,Severe
8,0,96,F,24,6,5,77,-19,Severe
17,10,214,F,4,5,4,64,-150,Severe
13,9,165,M,77,10,11,131,-34,Severe
8,10,106,M,15,5,11,71,-35,Severe
13,1,157,F,106,13,10,166,9,Well
14,1,169,F,18,6,1,73,-96,Severe
14,7,175,F,40,7,5,89,-86,Severe
9,8,116,F,88,12,0,144,28,Well
7,2,86,M,30,6,9,81,-5,Mild
11,9,141,F,27,6,7,79,-62,Severe
17,11,215,F,75,10,9,129,-86,Severe
8,3,99,M,22,6,3,75,-24,Severe
17,5,209,F,10,5,7,67,-142,Severe
11,6,138,F,39,7,5,89,-49,Severe
14,10,178,M,4,5,4,64,-114,Severe
17,3,207,F,45,7,10,94,-113,Severe
6,8,80,M,68,10,0,120,40,Well
13,9,165,F,79,11,1,133,-32,Severe
6,4,76,F,61,9,3,111,35,Well
17,3,207,M,106,13,10,166,-41,Severe
17,1,205,M,30,6,9,81,-124,Severe
17,5,209,M,100,13,3,159,-50,Severe
11,1,133,M,19,6,1,73,-60,Severe
12,1,145,F,3,5,3,63,-82,Severe
13,6,162,M,68,10,0,120,-42,Severe
9,3,111,F,96,12,10,154,43,Well
9,9,117,F,54,8,7,103,-14,Severe
5,9,69,F,69,10,1,121,52,Well
14,1,169,F,51,8,4,100,-69,Severe
12,10,154,F,5,5,5,65,-89,Severe
15,1,181,F,72,10,4,124,-57,Severe
16,9,201,F,92,12,5,149,-52,Severe
10,5,125,F,27,6,7,79,-46,Severe
14,7,175,M,98,13,0,156,-19,Severe
6,8,80,F,15,5,11,71,-9,Severe
13,5,161,M,90,12,3,147,-14,Severe
18,1,217,F,76,10,10,130,-87,Severe
15,7,187,F,21,6,2,74,-113,Severe
5,1,61,F,57,8,10,106,45,Well
7,10,94,F,34,7,0,84,-10,Severe
12,4,148,F,28,6,8,80,-68,Severe
6,5,77,F,7,5,6,66,-11,Severe
10,11,131,F,73,10,6,126,-5,Mild
7,9,93,F,104,13,7,163,70,Well
16,7,199,M,69,10,1,121,-78,Severe
9,0,108,F,106,13,10,166,58,Well
18,4,220,F,22,6,3,75,-145,Severe
11,6,138,M,56,8,9,105,-33,Severe
7,3,87,M,19,6,1,73,-14,Severe
10,10,130,M,30,6,9,81,-49,Severe
17,9,213,M,5,5,5,65,-148,Severe
14,8,176,F,72,10,4,124,-52,Severe
6,0,72,M,62,9,4,112,40,Well
13,1,157,M,32,6,10,82,-75,Severe
9,7,115,F,13,5,9,69,-46,Severe
10,10,130,M,100,13,3,159,29,Well
15,11,191,F,75,10,9,129,-62,Severe
14,8,176,M,64,9,7,115,-61,Severe
7,8,92,M,84,11,7,139,47,Well
7,7,91,M,82,11,5,137,46,Well
11,5,137,M,45,7,10,94,-43,Severe
6,6,78,F,44,7,9,93,15,Well
13,0,156,M,87,11,11,143,-13,Severe
5,1,61,F,83,11,6,138,77,Well
15,6,186,F,83,11,6,138,-48,Severe
12,0,144,F,34,7,0,84,-60,Severe
14,10,178,M,34,7,0,84,-94,Severe
5,0,60,F,36,7,2,86,26,Well
15,3,183,F,17,6,0,72,-111,Severe
16,5,197,F,50,8,3,99,-98,Severe
8,0,96,M,92,12,5,149,53,Well
13,8,164,F,68,10,0,120,-44,Severe
17,4,208,F,21,6,2,74,-134,Severe
12,1,145,F,80,11,3,135,-10,Severe
9,6,114,M,24,6,5,77,-37,Severe
18,2,218,F,77,10,11,131,-87,Severe
15,5,185,M,49,8,2,98,-87,Severe
7,9,93,F,19,6,1,73,-20,Severe
11,7,139,M,102,13,6,162,23,Well
6,0,72,F,27,6,7,79,7,Well
15,6,186,F,110,14,3,171,-15,Severe
7,10,94,F,67,9,10,118,24,Well
13,3,159,F,5,5,5,65,-94,Severe
7,7,91,F,94,12,7,151,60,Well
7,4,88,M,32,6,10,82,-6,Severe
6,2,74,F,51,8,4,100,26,Well
9,7,115,M,51,8,4,100,-15,Severe
17,8,212,M,63,9,6,114,-98,Severe
7,1,85,F,38,7,4,88,3,Good
14,8,176,F,44,7,9,93,-83,Severe
17,2,206,F,79,11,1,133,-73,Severe
13,5,161,M,32,6,10,82,-79,Severe
9,7,115,M,46,7,11,95,-20,Severe
6,8,80,F,71,10,3,123,43,Well
16,3,195,M,13,5,9,69,-126,Severe
14,2,170,F,81,11,4,136,-34,Severe
13,7,163,F,63,9,6,114,-49,Severe
10,3,123,M,47,8,0,96,-27,Severe
18,8,224,F,72,10,4,124,-100,Severe
16,1,193,M,33,6,11,83,-110,Severe
18,10,226,M,82,11,5,137,-89,Severe
12,0,144,F,18,6,1,73,-71,Severe
13,3,159,M,35,7,1,85,-74,Severe
11,11,143,F,91,12,4,148,5,Good
11,3,135,F,89,12,1,145,10,Well
11,9,141,M,3,5,3,63,-78,Severe
17,4,208,M,50,8,3,99,-109,Severe
5,11,71,F,48,8,1,97,26,Well
18,1,217,F,39,7,5,89,-128,Severe
16,8,200,F,96,12,10,154,-46,Severe
8,3,99,F,41,7,6,90,-9,Severe
14,6,174,M,53,8,6,102,-72,Severe
6,3,75,M,33,6,11,83,8,Well
11,3,135,F,78,11,0,132,-3,Mild
9,1,109,F,43,7,8,92,-17,Severe
5,5,65,F,107,13,11,167,102,Well
14,4,172,M,38,7,4,88,-84,Severe
15,2,182,M,21,6,2,74,-108,Severe
12,1,145,F,96,12,10,154,9,Well
6,7,79,F,33,6,11,83,4,Good
17,6,210,M,12,5,9,69,-141,Severe
9,11,119,M,68,10,0,120,1,Good
12,10,154,M,107,13,11,167,13,Well
5,3,63,M,5,5,5,65,2,Good
9,10,118,M,102,13,6,162,44,Well
14,6,174,F,51,8,4,100,-74,Severe
18,10,226,M,37,7,3,87,-139,Severe
14,8,176,F,80,11,3,135,-41,Severe
16,7,199,M,88,12,0,144,-55,Severe
11,4,136,F,102,13,6,162,26,Well
14,6,174,F,72,10,4,124,-50,Severe
16,4,196,F,48,8,1,97,-99,Severe
18,2,218,F,100,13,3,159,-59,Severe
13,8,164,M,87,11,11,143,-21,Severe
11,1,133,M,32,6,10,82,-51,Severe
9,2,110,M,105,13,9,165,55,Well
13,5,161,M,59,9,1,109,-52,Severe
12,4,148,M,100,13,3,159,11,Well
7,11,95,F,83,11,6,138,43,Well
9,8,116,M,66,9,9,117,1,Good
15,7,187,F,35,7,1,85,-102,Severe
7,10,94,M,110,14,3,171,77,Well
13,3,159,M,67,9,10,118,-41,Severe
16,3,195,M,26,6,6,78,-117,Severe
16,11,203,F,68,10,0,120,-83,Severe
9,6,114,M,84,11,7,139,25,Well
8,7,103,M,72,10,4,124,21,Well
17,8,212,M,74,10,7,127,-85,Severe
10,4,124,F,44,7,9,93,-31,Severe
6,7,79,M,31,6,9,81,2,Good
14,4,172,F,35,7,1,85,-87,Severe
9,9,117,M,109,14,1,169,52,Well
14,0,168,M,15,5,11,71,-97,Severe
14,1,169,F,46,7,11,95,-74,Severe
14,6,174,M,70,10,2,122,-52,Severe
18,3,219,F,75,10,9,129,-90,Severe
5,6,66,F,67,9,10,118,52,Well
13,0,156,F,43,7,8,92,-64,Severe
11,5,137,M,68,10,0,120,-17,Severe
7,3,87,M,17,6,0,72,-15,Severe
13,11,167,M,58,9,0,108,-59,Severe
12,4,148,F,48,8,1,97,-51,Severe
9,2,110,M,86,11,10,142,32,Well
15,2,182,M,28,6,8,80,-102,Severe
5,6,66,M,59,9,1,109,43,Well
13,4,160,M,69,10,1,121,-39,Severe
9,3,111,M,72,10,4,124,13,Well
13,9,165,F,31,6,9,81,-84,Severe
5,3,63,M,15,5,11,71,8,Well
10,3,123,M,18,6,1,73,-50,Severe
8,11,107,F,48,8,1,97,-10,Severe
17,3,207,M,94,12,7,151,-56,Severe
5,2,62,M,61,9,3,111,49,Well
13,6,162,F,3,5,3,63,-99,Severe
12,0,144,F,89,12,1,145,1,Good
15,0,180,M,62,9,4,112,-68,Severe
11,10,142,M,85,11,9,141,-1,Mild
17,10,214,M,42,7,7,91,-123,Severe
5,9,69,F,44,7,9,93,24,Well
14,1,169,M,39,7,5,89,-80,Severe
6,9,81,F,35,7,1,85,4,Good
14,11,179,F,98,13,0,156,-23,Severe
15,6,186,F,100,13,3,159,-27,Severe
10,3,123,F,5,5,5,65,-58,Severe
17,1,205,M,60,9,2,110,-95,Severe
8,10,106,F,83,11,6,138,32,Well
5,7,67,M,13,5,9,69,2,Good
9,2,110,F,87,11,11,143,33,Well
17,3,207,M,58,9,0,108,-99,Severe
18,6,222,F,9,5,7,67,-155,Severe
8,5,101,M,75,10,9,129,28,Well
5,10,70,F,99,13,1,157,87,Well
14,1,169,M,102,13,6,162,-7,Severe
15,6,186,M,3,5,3,63,-123,Severe
10,6,126,F,100,13,3,159,33,Well
10,3,123,M,79,11,1,133,10,Well
8,9,105,F,84,11,7,139,34,Well
13,1,157,M,58,9,0,108,-49,Severe
16,4,196,F,108,14,0,168,-28,Severe
9,0,108,F,16,5,11,71,-37,Severe
14,1,169,F,74,10,7,127,-42,Severe
5,8,68,F,56,8,9,105,37,Well
14,8,176,F,94,12,7,151,-25,Severe
10,3,123,F,15,5,11,71,-52,Severe
12,0,144,F,5,5,5,65,-79,Severe
8,7,103,M,67,9,10,118,15,Well
17,4,208,F,73,10,6,126,-82,Severe
15,8,188,M,22,6,3,75,-113,Severe
11,10,142,F,76,10,10,130,-12,Severe
6,0,72,F,79,11,1,133,61,Well
6,7,79,F,62,9,4,112,33,Well
7,10,94,F,21,6,2,74,-20,Severe
10,6,126,F,66,9,9,117,-9,Severe
14,2,170,M,21,6,2,74,-96,Severe
18,0,216,F,55,8,8,104,-112,Severe
11,3,135,M,63,9,6,114,-21,Severe
15,8,188,M,100,13,3,159,-29,Severe
15,8,188,F,30,6,9,81,-107,Severe
18,8,224,F,5,5,5,65,-159,Severe
18,10,226,M,84,11,7,139,-87,Severe
9,11,119,F,42,7,7,91,-28,Severe
14,3,171,M,48,8,1,97,-74,Severe
9,4,112,M,37,7,3,87,-25,Severe
8,3,99,M,100,13,3,159,60,Well
18,6,222,M,75,10,9,129,-93,Severe
11,0,132,M,109,14,1,169,37,Well
14,8,176,F,55,8,8,104,-72,Severe
12,7,151,M,95,12,9,153,2,Good
15,1,181,F,83,11,6,138,-43,Severe
18,9,225,M,21,6,2,74,-151,Severe
9,11,119,M,9,5,7,67,-52,Severe
6,11,83,F,8,5,6,66,-17,Severe
6,11,83,F,97,12,11,155,72,Well
10,5,125,M,46,7,11,95,-30,Severe
12,6,150,M,89,12,1,145,-5,Mild
5,3,63,F,76,10,10,130,67,Well
8,5,101,M,98,13,0,156,55,Well
10,3,123,M,106,13,10,166,43,Well
8,1,97,F,54,8,7,103,6,Well
16,11,203,F,48,8,1,97,-106,Severe
5,4,64,F,63,9,6,114,50,Well
6,1,73,F,69,10,1,121,48,Well
16,8,200,M,78,11,0,132,-68,Severe
13,3,159,F,56,8,9,105,-54,Severe
11,8,140,F,67,9,10,118,-22,Severe
15,3,183,F,101,13,4,160,-23,Severe
15,7,187,F,52,8,5,101,-86,Severe
17,10,214,M,84,11,7,139,-75,Severe
6,4,76,F,48,8,1,97,21,Well
8,9,105,M,87,11,11,143,38,Well
6,0,72,M,86,11,10,142,70,Well
13,11,167,F,6,5,5,65,-102,Severe
14,10,178,M,3,5,3,63,-115,Severe
5,6,66,M,26,6,6,78,12,Well
13,0,156,F,18,6,1,73,-83,Severe
8,6,102,F,4,5,4,64,-38,Severe
12,3,147,M,75,10,9,129,-18,Severe
10,1,121,F,55,8,8,104,-17,Severe
15,11,191,F,99,13,1,157,-34,Severe
5,4,64,M,64,9,7,115,51,Well
9,3,111,F,79,11,1,133,22,Well
12,11,155,M,86,11,10,142,-13,Severe
10,1,121,M,66,9,9,117,-4,Mild
12,3,147,F,32,6,10,82,-65,Severe
11,11,143,M,12,5,9,69,-74,Severe
9,7,115,F,22,6,3,75,-40,Severe
5,2,62,F,72,10,4,124,62,Well
10,2,122,M,39,7,5,89,-33,Severe
12,2,146,M,52,8,5,101,-45,Severe
7,0,84,F,31,6,9,81,-3,Mild
12,1,145,M,110,14,3,171,26,Well
5,0,60,F,41,7,6,90,30,Well
16,4,196,M,57,8,10,106,-90,Severe
11,9,141,F,36,7,2,86,-55,Severe
8,5,101,M,23,6,4,76,-25,Severe
9,11,119,M,84,11,7,139,20,Well
5,2,62,F,77,10,11,131,69,Well
5,8,68,M,103,13,6,162,94,Well
6,3,75,F,55,8,8,104,29,Well
12,11,155,F,101,13,4,160,5,Good
7,2,86,F,53,8,6,102,16,Well
6,6,78,M,22,6,3,75,-3,Mild
13,2,158,F,15,5,11,71,-87,Severe
6,2,74,F,55,8,8,104,30,Well
14,8,176,F,110,14,3,171,-5,Mild
8,5,101,F,42,7,7,91,-10,Severe
17,9,213,F,47,8,0,96,-117,Severe
17,10,214,M,63,9,6,114,-100,Severe
15,6,186,M,106,13,10,166,-20,Severe
17,6,210,F,110,14,3,171,-39,Severe
14,5,173,M,19,6,1,73,-100,Severe
12,3,147,F,64,9,7,115,-32,Severe
7,9,93,F,2,5,3,63,-30,Severe
13,2,158,F,97,12,11,155,-3,Mild
14,1,169,F,64,9,7,115,-54,Severe
8,7,103,F,67,9,10,118,15,Well
18,5,221,M,54,8,7,103,-118,Severe
7,7,91,F,110,14,3,171,80,Well
6,0,72,M,50,8,3,99,27,Well
13,2,158,F,47,8,0,96,-62,Severe
14,4,172,F,43,7,8,92,-80,Severe
9,5,113,F,104,13,7,163,50,Well
11,10,142,F,24,6,5,77,-65,Severe
13,6,162,M,30,6,9,81,-81,Severe
13,7,163,M,27,6,7,79,-84,Severe
9,0,108,F,98,13,0,156,48,Well
17,1,205,F,66,9,9,117,-88,Severe
11,1,133,F,85,11,9,141,8,Well
10,4,124,F,29,6,8,80,-44,Severe
6,2,74,M,63,9,6,114,40,Well
6,4,76,M,32,6,10,82,6,Well
12,8,152,M,100,13,3,159,7,Well
13,7,163,F,90,12,3,147,-16,Severe
18,8,224,M,12,5,9,69,-155,Severe
13,5,161,F,58,9,0,108,-53,Severe
18,3,219,M,59,9,1,109,-110,Severe
9,1,109,F,82,11,5,137,28,Well
18,8,224,F,58,9,0,108,-116,Severe
15,11,191,M,29,6,8,80,-111,Severe
10,4,124,M,48,8,1,97,-27,Severe
7,0,84,F,16,5,11,71,-13,Severe
17,9,213,M,87,11,11,143,-70,Severe
15,4,184,F,47,8,0,96,-88,Severe
15,9,189,F,16,5,11,71,-118,Severe
7,4,88,M,88,12,0,144,56,Well
17,6,210,M,92,12,5,149,-61,Severe
17,6,210,M,85,11,9,141,-69,Severe
16,11,203,M,50,8,3,99,-104,Severe
18,3,219,F,23,6,4,76,-143,Severe
18,4,220,M,41,7,6,90,-130,Severe
7,3,87,M,43,7,8,92,5,Good
16,8,200,M,92,12,5,149,-51,Severe
6,1,73,M,61,9,3,111,38,Well
12,2,146,F,9,5,7,67,-79,Severe
7,8,92,M,17,6,0,72,-20,Severe
13,5,161,M,19,6,1,73,-88,Severe
6,7,79,F,70,10,2,122,43,Well
7,1,85,M,62,9,4,112,27,Well
7,3,87,F,58,9,0,108,21,Well
13,0,156,M,40,7,5,89,-67,Severe
11,4,136,F,26,6,6,78,-58,Severe
13,3,159,F,40,7,5,89,-70,Severe
15,4,184,F,109,14,1,169,-15,Severe
16,0,192,M,50,8,3,99,-93,Severe
6,3,75,F,2,5,3,63,-12,Severe
14,7,175,M,17,6,0,72,-103,Severe
5,3,63,M,44,7,9,93,30,Well
6,1,73,F,19,6,1,73,0,Neutral
9,3,111,M,38,7,4,88,-23,Severe
14,8,176,M,82,11,5,137,-39,Severe
16,10,202,M,23,6,4,76,-126,Severe
7,8,92,M,63,9,6,114,22,Well
11,0,132,M,78,11,0,132,0,Neutral
9,6,114,M,4,5,4,64,-50,Severe
13,1,157,M,82,11,5,137,-20,Severe
8,8,104,M,81,11,4,136,32,Well
7,1,85,M,31,6,9,81,-4,Mild
6,5,77,M,59,9,1,109,32,Well
13,8,164,F,74,10,7,127,-37,Severe
9,5,113,F,8,5,6,66,-47,Severe
15,10,190,F,13,5,9,69,-121,Severe
16,5,197,M,67,9,10,118,-79,Severe
18,5,221,M,66,9,9,117,-104,Severe
16,9,201,F,97,12,11,155,-46,Severe
6,6,78,M,21,6,2,74,-4,Mild
10,0,120,F,89,12,1,145,25,Well
13,8,164,F,90,12,3,147,-17,Severe
12,1,145,F,24,6,5,77,-68,Severe
10,11,131,F,3,5,3,63,-68,Severe
16,3,195,F,96,12,10,154,-41,Severe
7,8,92,F,28,6,8,80,-12,Severe
9,3,111,F,40,7,5,89,-22,Severe
9,9,117,F,57,8,10,106,-11,Severe
17,3,207,F,64,9,7,115,-92,Severe
7,6,90,F,34,7,0,84,-6,Severe
10,3,123,F,18,6,1,73,-50,Severe
11,4,136,F,80,11,3,135,-1,Mild
8,10,106,F,57,8,10,106,0,Neutral
9,8,116,M,85,11,9,141,25,Well
14,5,173,F,16,5,11,71,-102,Severe
14,1,169,F,26,6,6,78,-91,Severe
14,0,168,F,3,5,3,63,-105,Severe
11,5,137,M,56,8,9,105,-32,Severe
12,3,147,F,12,5,9,69,-78,Severe
11,8,140,M,87,11,11,143,3,Good
5,3,63,M,93,12,6,150,87,Well
15,11,191,M,45,7,10,94,-97,Severe
13,3,159,F,64,9,7,115,-44,Severe
18,0,216,F,88,12,0,144,-72,Severe
5,3,63,M,108,14,0,168,105,Well
16,2,194,F,26,6,6,78,-116,Severe
12,2,146,F,94,12,7,151,5,Good
18,1,217,F,78,11,0,132,-85,Severe
17,3,207,M,90,12,3,147,-60,Severe
16,0,192,F,27,6,7,79,-113,Severe
18,8,224,F,44,7,9,93,-131,Severe
8,10,106,F,51,8,4,100,-6,Severe
17,3,207,F,56,8,9,105,-102,Severe
9,3,111,M,34,7,0,84,-27,Severe
5,1,61,F,91,12,4,148,87,Well
6,1,73,M,79,11,1,133,60,Well
6,3,75,F,81,11,4,136,61,Well
16,6,198,F,102,13,6,162,-36,Severe
16,2,194,M,80,11,3,135,-59,Severe
14,11,179,M,22,6,3,75,-104,Severe
18,11,227,M,68,10,0,120,-107,Severe
13,6,162,F,106,13,10,166,4,Good
15,3,183,M,56,8,9,105,-78,Severe
17,8,212,M,97,12,11,155,-57,Severe
11,2,134,F,109,14,1,169,35,Well
16,0,192,F,103,13,6,162,-30,Severe
5,5,65,M,33,6,11,83,18,Well
7,7,91,M,45,7,10,94,3,Good
18,10,226,M,6,5,5,65,-161,Severe
8,11,107,F,26,6,6,78,-29,Severe
14,10,178,F,81,11,4,136,-42,Severe
5,9,69,F,37,7,3,87,18,Well
14,7,175,F,101,13,4,160,-15,Severe
13,3,159,F,61,9,3,111,-48,Severe
12,4,148,M,79,11,1,133,-15,Severe
11,11,143,F,81,11,4,136,-7,Severe
7,7,91,M,40,7,5,89,-2,Mild
9,9,117,M,7,5,6,66,-51,Severe
16,10,202,M,43,7,8,92,-110,Severe
17,4,208,F,59,9,1,109,-99,Severe
17,0,204,M,78,11,0,132,-72,Severe
9,6,114,M,66,9,9,117,3,Good
6,8,80,F,103,13,6,162,82,Well
11,5,137,F,110,14,3,171,34,Well
16,0,192,M,7,5,6,66,-126,Severe
5,4,64,F,80,11,3,135,71,Well
13,10,166,M,43,7,8,92,-74,Severe
14,1,169,F,94,12,7,151,-18,Severe
12,2,146,M,51,8,4,100,-46,Severe
7,6,90,M,47,8,0,96,6,Well
15,3,183,M,16,5,11,71,-112,Severe
6,9,81,M,78,11,0,132,51,Well
14,0,168,M,101,13,4,160,-8,Severe
11,7,139,M,16,5,11,71,-68,Severe
9,3,111,F,10,5,7,67,-44,Severe
9,9,117,F,59,9,1,109,-8,Severe
14,2,170,M,20,6,2,74,-96,Severe
18,5,221,M,105,13,9,165,-56,Severe
17,2,206,M,74,10,7,127,-79,Severe
5,8,68,M,109,14,1,169,101,Well
12,5,149,M,9,5,7,67,-82,Severe
13,2,158,M,58,9,0,108,-50,Severe
11,3,135,F,34,7,0,84,-51,Severe
8,3,99,F,100,13,3,159,60,Well
7,3,87,M,41,7,6,90,3,Good
11,5,137,M,22,6,3,75,-62,Severe
10,11,131,M,5,5,5,65,-66,Severe
10,5,125,F,82,11,5,137,12,Well
15,3,183,M,76,10,10,130,-53,Severe
6,2,74,M,71,10,3,123,49,Well
16,0,192,F,3,5,3,63,-129,Severe
8,1,97,F,90,12,3,147,50,Well
10,0,120,M,54,8,7,103,-17,Severe
9,10,118,M,80,11,3,135,17,Well
9,1,109,F,40,7,5,89,-20,Severe
11,4,136,F,67,9,10,118,-18,Severe
16,9,201,M,75,10,9,129,-72,Severe
11,0,132,F,29,6,8,80,-52,Severe
6,11,83,M,50,8,3,99,16,Well
17,6,210,M,44,7,9,93,-117,Severe
15,0,180,M,102,13,6,162,-18,Severe
6,2,74,M,44,7,9,93,19,Well
17,11,215,F,61,9,3,111,-104,Severe
13,9,165,F,22,6,3,75,-90,Severe
18,6,222,F,87,11,11,143,-79,Severe
13,11,167,F,99,13,1,157,-10,Severe
18,11,227,F,102,13,6,162,-65,Severe
12,2,146,M,44,7,9,93,-53,Severe
6,9,81,M,34,7,0,84,3,Good
12,10,154,M,16,5,11,71,-83,Severe
15,6,186,M,53,8,6,102,-84,Severe
11,9,141,M,85,11,9,141,0,Neutral
16,9,201,F,55,8,8,104,-97,Severe
8,7,103,F,27,6,7,79,-24,Severe
12,0,144,F,107,13,11,167,23,Well
18,10,226,M,3,5,3,63,-163,Severe
18,5,221,M,89,12,1,145,-76,Severe
8,10,106,F,9,5,7,67,-39,Severe
12,9,153,F,39,7,5,89,-64,Severe
11,11,143,M,57,8,10,106,-37,Severe
13,11,167,F,46,7,11,95,-72,Severe
9,6,114,F,9,5,7,67,-47,Severe
15,5,185,M,37,7,3,87,-98,Severe
12,3,147,F,94,12,7,151,4,Good
17,3,207,F,51,8,4,100,-107,Severe
5,3,63,F,63,9,6,114,51,Well
9,1,109,M,67,9,10,118,9,Well
7,11,95,M,73,10,6,126,31,Well
8,8,104,M,100,13,3,159,55,Well
9,3,111,M,19,6,1,73,-38,Severe
18,2,218,M,106,13,10,166,-52,Severe
14,7,175,F,6,5,5,65,-110,Severe
15,0,180,M,98,13,0,156,-24,Severe
12,3,147,F,37,7,3,87,-60,Severe
10,11,131,F,80,11,3,135,4,Good
10,3,123,M,54,8,7,103,-20,Severe
16,1,193,M,106,13,10,166,-27,Severe
5,3,63,M,60,9,2,110,47,Well
5,7,67,M,89,12,1,145,78,Well
11,4,136,F,43,7,8,92,-44,Severe
17,4,208,F,11,5,8,68,-140,Severe
11,10,142,F,80,11,3,135,-7,Severe
13,0,156,F,109,14,1,169,13,Well
16,3,195,F,51,8,4,100,-95,Severe
8,5,101,M,92,12,5,149,48,Well
8,5,101,F,45,7,10,94,-7,Severe
16,9,201,M,10,5,7,67,-134,Severe
8,2,98,M,3,5,3,63,-35,Severe
8,6,102,M,53,8,6,102,0,Neutral
17,9,213,F,62,9,4,112,-101,Severe
14,3,171,F,41,7,6,90,-81,Severe
5,11,71,M,76,10,10,130,59,Well
8,3,99,M,107,13,11,167,68,Well
5,1,61,F,36,7,2,86,25,Well
11,9,141,F,101,13,4,160,19,Well
10,8,128,M,10,5,7,67,-61,Severe
8,0,96,M,82,11,5,137,41,Well
17,0,204,F,49,8,2,98,-106,Severe
10,11,131,F,86,11,10,142,11,Well
6,6,78,M,11,5,8,68,-10,Severe
8,2,98,F,52,8,5,101,3,Good
10,2,122,F,38,7,4,88,-34,Severe
14,7,175,M,110,14,3,171,-4,Mild
12,1,145,M,77,10,11,131,-14,Severe
6,0,72,M,95,12,9,153,81,Well
8,3,99,F,8,5,6,66,-33,Severe
6,5,77,M,91,12,4,148,71,Well
7,3,87,M,7,5,6,66,-21,Severe
17,3,207,F,49,8,2,98,-109,Severe
10,1,121,M,67,9,10,118,-3,Mild
15,5,185,M,80,11,3,135,-50,Severe
9,6,114,F,81,11,4,136,22,Well
17,1,205,F,36,7,2,86,-119,Severe
6,10,82,M,41,7,6,90,8,Well
8,5,101,M,40,7,5,89,-12,Severe
8,3,99,M,69,10,1,121,22,Well
14,3,171,M,29,6,8,80,-91,Severe
14,3,171,M,31,6,9,81,-90,Severe
17,4,208,M,38,7,4,88,-120,Severe
9,4,112,M,14,5,10,70,-42,Severe
18,8,224,M,74,10,7,127,-97,Severe
13,3,159,M,36,7,2,86,-73,Severe
17,10,214,M,71,10,3,123,-91,Severe
11,8,140,M,7,5,6,66,-74,Severe
9,9,117,M,41,7,6,90,-27,Severe
9,4,112,M,57,8,10,106,-6,Severe
16,8,200,M,96,12,10,154,-46,Severe
17,7,211,M,59,9,1,109,-102,Severe
11,7,139,F,84,11,7,139,0,Neutral
15,8,188,M,108,14,0,168,-20,Severe
18,6,222,M,50,8,3,99,-123,Severe
10,11,131,F,90,12,3,147,16,Well
17,8,212,F,3,5,3,63,-149,Severe
7,3,87,F,18,6,1,73,-14,Severe
15,1,181,M,27,6,7,79,-102,Severe
18,8,224,M,59,9,1,109,-115,Severe
10,11,131,F,71,10,3,123,-8,Severe
13,4,160,F,78,11,0,132,-28,Severe
12,3,147,M,40,7,5,89,-58,Severe
6,2,74,F,68,10,0,120,46,Well
9,10,118,F,43,7,8,92,-26,Severe
17,10,214,F,70,10,2,122,-92,Severe
16,8,200,M,85,11,9,141,-59,Severe
17,2,206,M,69,10,1,121,-85,Severe
17,3,207,M,98,13,0,156,-51,Severe
17,2,206,M,47,8,0,96,-110,Severe
5,0,60,F,14,5,10,70,10,Well
6,8,80,F,52,8,5,101,21,Well
8,5,101,F,25,6,5,77,-24,Severe
7,9,93,M,22,6,3,75,-18,Severe
13,0,156,M,104,13,7,163,7,Well
5,5,65,F,25,6,5,77,12,Well
8,7,103,M,83,11,6,138,35,Well
18,3,219,F,45,7,10,94,-125,Severe
12,3,147,M,36,7,2,86,-61,Severe
12,1,145,M,108,14,0,168,23,Well
18,7,223,M,30,6,9,81,-142,Severe
15,2,182,M,105,13,9,165,-17,Severe
17,6,210,F,86,11,10,142,-68,Severe
9,5,113,M,84,11,7,139,26,Well
6,3,75,M,31,6,9,81,6,Well
17,0,204,M,83,11,6,138,-66,Severe
14,4,172,F,11,5,8,68,-104,Severe
16,9,201,F,63,9,6,114,-87,Severe
15,3,183,F,90,12,3,147,-36,Severe
10,10,130,M,107,13,11,167,37,Well
5,9,69,F,104,13,7,163,94,Well
6,3,75,F,83,11,6,138,63,Well
6,7,79,F,77,10,11,131,52,Well
14,0,168,M,106,13,10,166,-2,Mild
11,0,132,M,4,5,4,64,-68,Severe
17,5,209,M,6,5,5,65,-144,Severe
16,0,192,M,41,7,6,90,-102,Severe
9,10,118,M,77,10,11,131,13,Well
17,8,212,M,27,6,7,79,-133,Severe
15,3,183,F,74,10,7,127,-56,Severe
6,4,76,F,56,8,9,105,29,Well
14,11,179,M,63,9,6,114,-65,Severe
15,3,183,F,16,5,11,71,-112,Severe
11,9,141,M,93,12,6,150,9,Well
7,7,91,M,50,8,3,99,8,Well
18,4,220,F,23,6,4,76,-144,Severe
14,10,178,F,3,5,3,63,-115,Severe
13,3,159,F,57,8,10,106,-53,Severe
13,8,164,F,107,13,11,167,3,Good
8,1,97,M,38,7,4,88,-9,Severe
12,10,154,M,67,9,10,118,-36,Severe
7,2,86,F,92,12,5,149,63,Well
9,5,113,F,69,10,1,121,8,Well
9,6,114,M,6,5,5,65,-49,Severe
8,4,100,F,59,9,1,109,9,Well
8,10,106,F,59,9,1,109,3,Good
17,8,212,M,67,9,10,118,-94,Severe
9,1,109,F,108,14,0,168,59,Well
14,7,175,F,7,5,6,66,-109,Severe
13,3,159,M,8,5,6,66,-93,Severe
5,0,60,F,16,5,11,71,11,Well
14,0,168,F,106,13,10,166,-2,Mild
8,2,98,M,88,12,0,144,46,Well
5,3,63,F,25,6,5,77,14,Well
12,5,149,F,58,9,0,108,-41,Severe
18,3,219,F,74,10,7,127,-92,Severe
5,7,67,M,94,12,7,151,84,Well
7,1,85,M,37,7,3,87,2,Good
11,0,132,F,60,9,2,110,-22,Severe
11,11,143,M,31,6,9,81,-62,Severe
15,8,188,F,37,7,3,87,-101,Severe
10,8,128,F,62,9,4,112,-16,Severe
17,2,206,F,24,6,5,77,-129,Severe
15,2,182,M,19,6,1,73,-109,Severe
16,2,194,M,13,5,9,69,-125,Severe
18,9,225,M,66,9,9,117,-108,Severe
13,5,161,M,67,9,10,118,-43,Severe
15,10,190,F,52,8,5,101,-89,Severe
18,11,227,M,65,9,8,116,-111,Severe
12,7,151,F,98,13,0,156,5,Good
13,5,161,F,75,10,9,129,-32,Severe
16,8,200,M,81,11,4,136,-64,Severe
12,0,144,M,65,9,8,116,-28,Severe
15,1,181,F,52,8,5,101,-80,Severe
10,10,130,M,56,8,9,105,-25,Severe
15,9,189,F,5,5,5,65,-124,Severe
15,2,182,F,103,13,6,162,-20,Severe
5,2,62,M,80,11,3,135,73,Well
10,3,123,F,39,7,5,89,-34,Severe
15,8,188,F,20,6,2,74,-114,Severe
10,5,125,M,73,10,6,126,1,Good
10,10,130,M,16,5,11,71,-59,Severe
10,2,122,M,19,6,1,73,-49,Severe
8,6,102,F,71,10,3,123,21,Well
11,3,135,M,68,10,0,120,-15,Severe
7,7,91,M,12,5,9,69,-22,Severe
9,3,111,F,49,8,2,98,-13,Severe
17,4,208,M,51,8,4,100,-108,Severe
7,9,93,M,77,10,11,131,38,Well
11,4,136,F,94,12,7,151,15,Well
16,10,202,F,72,10,4,124,-78,Severe
11,0,132,M,102,13,6,162,30,Well
15,7,187,M,84,11,7,139,-48,Severe
5,11,71,F,44,7,9,93,22,Well
9,3,111,M,4,5,4,64,-47,Severe
6,9,81,F,15,5,11,71,-10,Severe
6,0,72,F,30,6,9,81,9,Well
17,9,213,F,8,5,6,66,-147,Severe
11,8,140,M,76,10,10,130,-10,Severe
10,0,120,F,43,7,8,92,-28,Severe
12,4,148,M,16,5,11,71,-77,Severe
16,1,193,F,81,11,4,136,-57,Severe
7,10,94,F,53,8,6,102,8,Well
11,8,140,M,35,7,1,85,-55,Severe
12,6,150,F,70,10,2,122,-28,Severe
18,1,217,M,36,7,2,86,-131,Severe
17,1,205,M,4,5,4,64,-141,Severe
11,1,133,F,32,6,10,82,-51,Severe
8,11,107,M,7,5,6,66,-41,Severe
5,2,62,F,52,8,5,101,39,Well
14,8,176,F,59,9,1,109,-67,Severe
17,3,207,F,58,9,0,108,-99,Severe
11,10,142,M,4,5,4,64,-78,Severe
6,3,75,F,82,11,5,137,62,Well
14,3,171,F,77,10,11,131,-40,Severe
15,4,184,M,12,5,9,69,-115,Severe
11,7,139,M,70,10,2,122,-17,Severe
6,11,83,F,13,5,9,69,-14,Severe
7,0,84,F,78,11,0,132,48,Well
12,5,149,F,93,12,6,150,1,Good
13,10,166,M,99,13,1,157,-9,Severe
6,3,75,M,107,13,11,167,92,Well
5,10,70,F,107,13,11,167,97,Well
7,9,93,M,63,9,6,114,21,Well
15,4,184,F,7,5,6,66,-118,Severe
9,10,118,M,50,8,3,99,-19,Severe
14,6,174,F,106,13,10,166,-8,Severe
5,6,66,M,17,6,0,72,6,Well
13,4,160,F,36,7,2,86,-74,Severe
13,3,159,F,86,11,10,142,-17,Severe
10,9,129,M,16,5,11,71,-58,Severe
14,10,178,M,46,7,11,95,-83,Severe
5,10,70,F,82,11,5,137,67,Well
12,3,147,M,8,5,6,66,-81,Severe
5,10,70,F,26,6,6,78,8,Well
12,4,148,M,105,13,9,165,17,Well
16,10,202,M,54,8,7,103,-99,Severe
11,7,139,M,33,6,11,83,-56,Severe
8,3,99,M,86,11,10,142,43,Well
9,6,114,M,43,7,8,92,-22,Severe
14,1,169,M,83,11,6,138,-31,Severe
16,8,200,M,41,7,6,90,-110,Severe
8,11,107,F,103,13,6,162,55,Well
11,5,137,F,68,10,0,120,-17,Severe
5,5,65,M,56,8,9,105,40,Well
7,3,87,F,79,11,1,133,46,Well
12,5,149,M,62,9,4,112,-37,Severe
12,9,153,F,26,6,6,78,-75,Severe
18,3,219,F,57,8,10,106,-113,Severe
15,10,190,F,86,11,10,142,-48,Severe
11,8,140,M,103,13,6,162,22,Well
11,8,140,M,24,6,5,77,-63,Severe
14,0,168,M,13,5,9,69,-99,Severe
10,5,125,F,16,5,11,71,-54,Severe
18,3,219,F,31,6,9,81,-138,Severe
10,7,127,M,75,10,9,129,2,Good
17,8,212,M,41,7,6,90,-122,Severe
15,2,182,M,10,5,7,67,-115,Severe
5,10,70,F,9,5,7,67,-3,Mild
7,1,85,M,81,11,4,136,51,Well
14,9,177,M,22,6,3,75,-102,Severe
11,9,141,M,109,14,1,169,28,Well
18,5,221,M,47,8,0,96,-125,Severe
13,2,158,F,65,9,8,116,-42,Severe
13,9,165,F,25,6,5,77,-88,Severe
11,4,136,M,102,13,6,162,26,Well
16,3,195,F,5,5,5,65,-130,Severe
14,3,171,F,33,6,11,83,-88,Severe
15,5,185,M,53,8,6,102,-83,Severe
13,9,165,M,52,8,5,101,-64,Severe
13,0,156,F,50,8,3,99,-57,Severe
15,4,184,M,63,9,6,114,-70,Severe
12,0,144,M,86,11,10,142,-2,Mild
11,9,141,M,35,7,1,85,-56,Severe
9,0,108,M,73,10,6,126,18,Well
5,10,70,F,103,13,6,162,92,Well
16,3,195,F,43,7,8,92,-103,Severe
5,2,62,F,51,8,4,100,38,Well
6,2,74,F,64,9,7,115,41,Well
11,2,134,F,67,9,10,118,-16,Severe
17,5,209,F,43,7,8,92,-117,Severe
16,6,198,F,94,12,7,151,-47,Severe
14,4,172,M,89,12,1,145,-27,Severe
6,10,82,F,47,8,0,96,14,Well
12,7,151,M,106,13,10,166,15,Well
5,1,61,M,92,12,5,149,88,Well
17,10,214,M,79,11,1,133,-81,Severe
6,1,73,F,10,5,7,67,-6,Severe
14,9,177,F,20,6,2,74,-103,Severe
10,9,129,F,21,6,2,74,-55,Severe
8,10,106,M,69,10,1,121,15,Well
16,7,199,F,90,12,3,147,-52,Severe
6,11,83,M,8,5,6,66,-17,Severe
6,4,76,F,75,10,9,129,53,Well
10,1,121,F,62,9,4,112,-9,Severe
8,1,97,F,96,12,10,154,57,Well
14,4,172,M,19,6,1,73,-99,Severe
6,3,75,F,104,13,7,163,88,Well
8,7,103,M,69,10,1,121,18,Well
7,4,88,M,21,6,2,74,-14,Severe
13,8,164,F,96,12,10,154,-10,Severe
7,5,89,F,17,6,0,72,-17,Severe
10,4,124,F,94,12,7,151,27,Well
12,7,151,M,53,8,6,102,-49,Severe
12,6,150,M,84,11,7,139,-11,Severe
10,1,121,M,85,11,9,141,20,Well
14,0,168,F,94,12,7,151,-17,Severe
18,4,220,F,28,6,8,80,-140,Severe
6,3,75,F,44,7,9,93,18,Well
8,3,99,M,26,6,6,78,-21,Severe
6,1,73,M,59,9,1,109,36,Well
8,5,101,F,51,8,4,100,-1,Mild
17,5,209,M,106,13,10,166,-43,Severe
10,11,131,F,104,13,7,163,32,Well
6,4,76,F,87,11,11,143,67,Well
9,3,111,F,54,8,7,103,-8,Severe
12,3,147,F,20,6,2,74,-73,Severe
14,7,175,M,36,7,2,86,-89,Severe
7,0,84,F,12,5,9,69,-15,Severe
17,0,204,F,33,6,11,83,-121,Severe
10,5,125,F,5,5,5,65,-60,Severe
8,1,97,M,109,14,1,169,72,Well
5,4,64,F,107,13,11,167,103,Well
11,1,133,M,10,5,7,67,-66,Severe
18,10,226,M,2,5,3,63,-163,Severe
16,4,196,M,65,9,8,116,-80,Severe
6,7,79,F,24,6,5,77,-2,Mild
13,5,161,F,41,7,6,90,-71,Severe
13,2,158,F,64,9,7,115,-43,Severe
7,8,92,F,109,14,1,169,77,Well
12,1,145,F,53,8,6,102,-43,Severe
15,6,186,M,88,12,0,144,-42,Severe
5,0,60,M,74,10,7,127,67,Well
10,7,127,M,67,9,10,118,-9,Severe
12,11,155,M,101,13,4,160,5,Good
5,0,60,M,29,6,8,80,20,Well
11,6,138,M,110,14,3,171,33,Well
9,11,119,M,6,5,5,65,-54,Severe
17,9,213,M,65,9,8,116,-97,Severe
5,1,61,F,9,5,7,67,6,Well
15,10,190,F,62,9,4,112,-78,Severe
5,3,63,F,51,8,4,100,37,Well
16,6,198,M,21,6,2,74,-124,Severe
15,5,185,F,6,5,5,65,-120,Severe
6,5,77,M,21,6,2,74,-3,Mild
10,8,128,M,22,6,3,75,-53,Severe
15,3,183,M,21,6,2,74,-109,Severe
7,7,91,M,35,7,1,85,-6,Severe
9,5,113,F,90,12,3,147,34,Well
18,11,227,F,104,13,7,163,-64,Severe
5,2,62,M,39,7,5,89,27,Well
15,2,182,F,73,10,6,126,-56,Severe
12,1,145,F,102,13,6,162,17,Well
5,9,69,F,14,5,10,70,1,Good
14,4,172,F,57,8,10,106,-66,Severe
12,3,147,F,101,13,4,160,13,Well
18,1,217,F,35,7,1,85,-132,Severe
18,3,219,F,55,8,8,104,-115,Severe
15,0,180,F,5,5,5,65,-115,Severe
16,1,193,F,105,13,9,165,-28,Severe
18,7,223,F,32,6,10,82,-141,Severe
5,9,69,M,2,5,3,63,-6,Severe
11,4,136,F,46,7,11,95,-41,Severe
6,8,80,F,72,10,4,124,44,Well
5,6,66,M,34,7,0,84,18,Well
9,2,110,F,7,5,6,66,-44,Severe
6,3,75,F,38,7,4,88,13,Well
10,8,128,F,27,6,7,79,-49,Severe
14,1,169,F,81,11,4,136,-33,Severe
9,3,111,F,59,9,1,109,-2,Mild
13,11,167,M,53,8,6,102,-65,Severe
15,3,183,M,33,6,11,83,-100,Severe
11,11,143,M,41,7,6,90,-53,Severe
11,2,134,M,98,13,0,156,22,Well
18,3,219,F,110,14,3,171,-48,Severe
14,3,171,F,11,5,8,68,-103,Severe
12,3,147,F,27,6,7,79,-68,Severe
16,3,195,M,33,6,11,83,-112,Severe
16,0,192,F,66,9,9,117,-75,Severe
5,8,68,M,61,9,3,111,43,Well
13,3,159,M,85,11,9,141,-18,Severe
8,6,102,F,109,14,1,169,67,Well
12,2,146,M,3,5,3,63,-83,Severe
14,7,175,F,68,10,0,120,-55,Severe
7,7,91,F,42,7,7,91,0,Neutral
6,7,79,F,46,7,11,95,16,Well
14,5,173,F,104,13,7,163,-10,Severe
15,10,190,M,94,12,7,151,-39,Severe
6,3,75,M,77,10,11,131,56,Well
17,6,210,M,102,13,6,162,-48,Severe
12,8,152,F,91,12,4,148,-4,Mild
10,7,127,F,95,12,9,153,26,Well
15,10,190,F,9,5,7,67,-123,Severe
5,8,68,M,23,6,4,76,8,Well
18,0,216,F,20,6,2,74,-142,Severe
14,6,174,M,9,5,7,67,-107,Severe
11,6,138,M,101,13,4,160,22,Well
5,3,63,F,108,14,0,168,105,Well
15,6,186,M,98,13,0,156,-30,Severe
7,1,85,M,45,7,10,94,9,Well
13,5,161,M,96,12,10,154,-7,Severe
15,6,186,F,103,13,6,162,-24,Severe
10,3,123,M,82,11,5,137,14,Well
7,3,87,F,17,6,0,72,-15,Severe
15,2,182,F,15,5,11,71,-111,Severe
14,10,178,M,45,7,10,94,-84,Severe
17,8,212,F,20,6,2,74,-138,Severe
5,3,63,F,82,11,5,137,74,Well
5,10,70,F,77,10,11,131,61,Well
13,4,160,M,89,12,1,145,-15,Severe
18,7,223,F,12,5,9,69,-154,Severe
16,5,197,M,73,10,6,126,-71,Severe
10,11,131,F,97,12,11,155,24,Well
14,3,171,F,40,7,5,89,-82,Severe
13,2,158,M,2,5,3,63,-95,Severe
15,10,190,F,37,7,3,87,-103,Severe
11,10,142,F,6,5,5,65,-77,Severe
10,0,120,M,56,8,9,105,-15,Severe
8,8,104,M,73,10,6,126,22,Well
15,1,181,F,15,5,11,71,-110,Severe
10,11,131,F,36,7,2,86,-45,Severe
10,3,123,M,55,8,8,104,-19,Severe
8,3,99,M,109,14,1,169,70,Well
18,11,227,M,20,6,2,74,-153,Severe
12,3,147,M,106,13,10,166,19,Well
13,5,161,M,64,9,7,115,-46,Severe
7,5,89,M,99,13,1,157,68,Well
18,10,226,M,93,12,6,150,-76,Severe
8,6,102,F,31,6,9,81,-21,Severe
6,4,76,M,89,12,1,145,69,Well
14,8,176,F,6,5,5,65,-111,Severe
5,2,62,M,110,14,3,171,109,Well
13,11,167,M,93,12,6,150,-17,Severe
7,10,94,F,4,5,4,64,-30,Severe
11,2,134,F,85,11,9,141,7,Well
18,2,218,M,87,11,11,143,-75,Severe
11,5,137,M,98,13,0,156,19,Well
17,3,207,F,32,6,10,82,-125,Severe
8,9,105,F,24,6,5,77,-28,Severe
8,11,107,M,100,13,3,159,52,Well
8,3,99,M,28,6,8,80,-19,Severe
6,11,83,M,18,6,1,73,-10,Severe
11,8,140,M,95,12,9,153,13,Well
14,0,168,M,10,5,7,67,-101,Severe
17,2,206,M,85,11,9,141,-65,Severe
14,7,175,F,90,12,3,147,-28,Severe
5,7,67,M,99,13,1,157,90,Well
17,2,206,M,18,6,1,73,-133,Severe
8,7,103,M,59,9,1,109,6,Well
16,4,196,F,72,10,4,124,-72,Severe
12,8,152,M,47,8,0,96,-56,Severe
16,3,195,M,110,14,3,171,-24,Severe
14,1,169,M,64,9,7,115,-54,Severe
11,3,135,M,40,7,5,89,-46,Severe
11,7,139,M,39,7,5,89,-50,Severe
17,6,210,M,64,9,7,115,-95,Severe
6,3,75,M,20,6,2,74,-1,Mild
11,1,133,F,61,9,3,111,-22,Severe
16,9,201,M,55,8,8,104,-97,Severe
10,9,129,F,8,5,6,66,-63,Severe
5,5,65,M,98,13,0,156,91,Well
5,8,68,M,68,10,0,120,52,Well
11,5,137,M,92,12,5,149,12,Well
12,5,149,F,72,10,4,124,-25,Severe
8,4,100,F,89,12,1,145,45,Well
17,9,213,M,110,14,3,171,-42,Severe
17,0,204,F,88,12,0,144,-60,Severe
7,4,88,M,46,7,11,95,7,Well
8,3,99,F,36,7,2,86,-13,Severe
16,8,200,M,79,11,1,133,-67,Severe
5,2,62,M,8,5,6,66,4,Good
18,2,218,M,24,6,5,77,-141,Severe
18,8,224,M,31,6,9,81,-143,Severe
11,10,142,M,22,6,3,75,-67,Severe
16,0,192,F,40,7,5,89,-103,Severe
17,9,213,M,35,7,1,85,-128,Severe
13,11,167,F,53,8,6,102,-65,Severe
7,3,87,M,4,5,4,64,-23,Severe
6,4,76,M,104,13,7,163,87,Well
13,3,159,M,52,8,5,101,-58,Severe
17,9,213,M,38,7,4,88,-125,Severe
14,3,171,F,39,7,5,89,-82,Severe
11,10,142,F,18,6,1,73,-69,Severe
16,9,201,F,9,5,7,67,-134,Severe
10,6,126,M,56,8,9,105,-21,Severe
11,5,137,M,15,5,11,71,-66,Severe
16,11,203,F,23,6,4,76,-127,Severe
10,6,126,M,74,10,7,127,1,Good
11,9,141,M,56,8,9,105,-36,Severe
7,10,94,F,77,10,11,131,37,Well
18,6,222,F,15,5,11,71,-151,Severe
8,5,101,F,16,5,11,71,-30,Severe
18,1,217,F,17,6,0,72,-145,Severe
11,6,138,F,20,6,2,74,-64,Severe
16,5,197,F,59,9,1,109,-88,Severe
14,10,178,F,96,12,10,154,-24,Severe
6,0,72,F,80,11,3,135,63,Well
14,10,178,M,27,6,7,79,-99,Severe
14,11,179,M,25,6,5,77,-102,Severe
11,2,134,F,104,13,7,163,29,Well
18,1,217,M,82,11,5,137,-80,Severe
9,9,117,F,84,11,7,139,22,Well
18,10,226,F,24,6,5,77,-149,Severe
17,0,204,M,89,12,1,145,-59,Severe
14,11,179,M,10,5,7,67,-112,Severe
15,3,183,F,80,11,3,135,-48,Severe
11,8,140,F,73,10,6,126,-14,Severe
15,5,185,M,35,7,1,85,-100,Severe
13,6,162,M,9,5,7,67,-95,Severe
8,7,103,F,78,11,0,132,29,Well
7,2,86,F,98,13,0,156,70,Well
17,11,215,M,91,12,4,148,-67,Severe
13,6,162,M,56,8,9,105,-57,Severe
12,10,154,F,102,13,6,162,8,Well
8,3,99,M,44,7,9,93,-6,Severe
8,9,105,M,8,5,6,66,-39,Severe
9,0,108,F,79,11,1,133,25,Well
17,0,204,F,18,6,1,73,-131,Severe
6,4,76,M,95,12,9,153,77,Well
17,9,213,M,96,12,10,154,-59,Severe
11,8,140,M,104,13,7,163,23,Well
15,3,183,M,34,7,0,84,-99,Severe
8,6,102,F,59,9,1,109,7,Well
8,2,98,M,37,7,3,87,-11,Severe
17,2,206,F,64,9,7,115,-91,Severe
8,10,106,F,14,5,10,70,-36,Severe
13,8,164,M,20,6,2,74,-90,Severe
18,11,227,M,56,8,9,105,-122,Severe
17,2,206,M,62,9,4,112,-94,Severe
14,1,169,M,92,12,5,149,-20,Severe
10,4,124,F,54,8,7,103,-21,Severe
17,8,212,F,72,10,4,124,-88,Severe
10,6,126,M,93,12,6,150,24,Well
17,3,207,F,24,6,5,77,-130,Severe
9,8,116,M,51,8,4,100,-16,Severe
14,5,173,M,72,10,4,124,-49,Severe
18,1,217,M,34,7,0,84,-133,Severe
18,3,219,F,32,6,10,82,-137,Severe
9,2,110,F,95,12,9,153,43,Well
11,9,141,M,110,14,3,171,30,Well
13,0,156,M,30,6,9,81,-75,Severe
12,8,152,M,25,6,5,77,-75,Severe
17,10,214,F,29,6,8,80,-134,Severe
18,5,221,M,76,10,10,130,-91,Severe
10,6,126,M,80,11,3,135,9,Well
5,10,70,F,30,6,9,81,11,Well
6,0,72,M,77,10,11,131,59,Well
9,3,111,F,18,6,1,73,-38,Severe
6,7,79,F,84,11,7,139,60,Well
10,11,131,M,2,5,3,63,-68,Severe
10,2,122,M,49,8,2,98,-24,Severe
13,2,158,F,17,6,0,72,-86,Severe
18,2,218,M,72,10,4,124,-94,Severe
17,4,208,M,47,8,0,96,-112,Severe
15,7,187,F,53,8,6,102,-85,Severe
7,2,86,M,82,11,5,137,51,Well
5,0,60,M,22,6,3,75,15,Well
12,11,155,M,58,9,0,108,-47,Severe
7,5,89,M,90,12,3,147,58,Well
12,8,152,F,104,13,7,163,11,Well
10,8,128,F,108,14,0,168,40,Well
13,7,163,F,89,12,1,145,-18,Severe
16,3,195,M,19,6,1,73,-122,Severe
6,2,74,F,78,11,0,132,58,Well
18,0,216,F,102,13,6,162,-54,Severe
6,8,80,M,66,9,9,117,37,Well
10,1,121,F,88,12,0,144,23,Well
9,7,115,M,85,11,9,141,26,Well
12,3,147,M,70,10,2,122,-25,Severe
17,4,208,F,67,9,10,118,-90,Severe
18,9,225,F,74,10,7,127,-98,Severe
10,8,128,M,21,6,2,74,-54,Severe
17,0,204,F,87,11,11,143,-61,Severe
8,6,102,F,24,6,5,77,-25,Severe
18,11,227,F,8,5,6,66,-161,Severe
11,4,136,M,93,12,6,150,14,Well
18,10,226,M,33,6,11,83,-143,Severe
8,0,96,F,80,11,3,135,39,Well
13,8,164,M,15,5,11,71,-93,Severe
6,5,77,F,16,5,11,71,-6,Severe
15,7,187,F,89,12,1,145,-42,Severe
8,11,107,F,85,11,9,141,34,Well
16,5,197,F,24,6,5,77,-120,Severe
13,4,160,M,86,11,10,142,-18,Severe
9,8,116,F,13,5,9,69,-47,Severe
11,10,142,F,27,6,7,79,-63,Severe
14,8,176,F,67,9,10,118,-58,Severe
5,9,69,M,106,13,10,166,97,Well
10,8,128,F,22,6,3,75,-53,Severe
5,5,65,M,5,5,5,65,0,Neutral
7,9,93,M,74,10,7,127,34,Well
13,5,161,M,109,14,1,169,8,Well
9,2,110,M,38,7,4,88,-22,Severe
8,9,105,M,83,11,6,138,33,Well
10,11,131,F,19,6,1,73,-58,Severe
18,5,221,M,18,6,1,73,-148,Severe
7,5,89,F,34,7,0,84,-5,Mild
6,3,75,F,108,14,0,168,93,Well
17,10,214,F,88,12,0,144,-70,Severe
6,8,80,F,45,7,10,94,14,Well
16,4,196,M,84,11,7,139,-57,Severe
9,2,110,F,99,13,1,157,47,Well
8,11,107,F,101,13,4,160,53,Well
12,1,145,F,64,9,7,115,-30,Severe
9,0,108,M,81,11,4,136,28,Well
6,6,78,F,74,10,7,127,49,Well
12,3,147,F,40,7,5,89,-58,Severe
12,0,144,M,104,13,7,163,19,Well
10,0,120,F,75,10,9,129,9,Well
13,3,159,M,10,5,7,67,-92,Severe
11,5,137,F,8,5,6,66,-71,Severe
18,9,225,M,60,9,2,110,-115,Severe
18,3,219,F,52,8,5,101,-118,Severe
5,5,65,M,103,13,6,162,97,Well
13,3,159,M,104,13,7,163,4,Good
6,0,72,F,69,10,1,121,49,Well
13,8,164,F,21,6,2,74,-90,Severe
5,10,70,F,76,10,10,130,60,Well
7,5,89,F,60,9,2,110,21,Well
15,5,185,M,5,5,5,65,-120,Severe
10,2,122,M,107,13,11,167,45,Well
10,10,130,M,87,11,11,143,13,Well
12,7,151,M,64,9,7,115,-36,Severe
16,10,202,M,35,7,1,85,-117,Severe
11,10,142,M,24,6,5,77,-65,Severe
6,8,80,F,33,6,11,83,3,Good
14,1,169,M,42,7,7,91,-78,Severe
13,5,161,F,19,6,1,73,-88,Severe
14,11,179,M,41,7,6,90,-89,Severe
8,1,97,F,86,11,10,142,45,Well
9,2,110,F,8,5,6,66,-44,Severe
7,5,89,M,87,11,11,143,54,Well
14,9,177,F,19,6,1,73,-104,Severe
16,10,202,F,8,5,6,66,-136,Severe
17,7,211,F,55,8,8,104,-107,Severe
18,11,227,M,25,6,5,77,-150,Severe
15,10,190,F,101,13,4,160,-30,Severe
17,0,204,F,23,6,4,76,-128,Severe
13,9,165,F,99,13,1,157,-8,Severe
18,0,216,M,106,13,10,166,-50,Severe
13,3,159,F,48,8,1,97,-62,Severe
9,7,115,F,6,5,5,65,-50,Severe
18,0,216,F,35,7,1,85,-131,Severe
7,8,92,F,25,6,5,77,-15,Severe
17,3,207,M,82,11,5,137,-70,Severe
9,8,116,M,75,10,9,129,13,Well
17,3,207,F,104,13,7,163,-44,Severe
15,1,181,M,6,5,5,65,-116,Severe
8,9,105,M,35,7,1,85,-20,Severe
14,2,170,F,14,5,10,70,-100,Severe
15,2,182,M,60,9,2,110,-72,Severe
16,8,200,M,37,7,3,87,-113,Severe
9,7,115,M,53,8,6,102,-13,Severe
12,5,149,F,33,6,11,83,-66,Severe
18,11,227,M,84,11,7,139,-88,Severe
11,9,141,M,95,12,9,153,12,Well
10,3,123,F,73,10,6,126,3,Good
14,5,173,F,62,9,4,112,-61,Severe
9,5,113,F,33,6,11,83,-30,Severe
8,3,99,M,30,6,9,81,-18,Severe
14,7,175,F,66,9,9,117,-58,Severe
14,2,170,M,70,10,2,122,-48,Severe
15,6,186,F,64,9,7,115,-71,Severe
9,5,113,F,52,8,5,101,-12,Severe
14,8,176,M,52,8,5,101,-75,Severe
10,11,131,F,77,10,11,131,0,Neutral
11,2,134,M,9,5,7,67,-67,Severe
18,1,217,M,56,8,9,105,-112,Severe
10,11,131,F,101,13,4,160,29,Well
16,4,196,F,40,7,5,89,-107,Severe
15,4,184,M,44,7,9,93,-91,Severe
10,0,120,F,109,14,1,169,49,Well
7,4,88,F,42,7,7,91,3,Good
18,11,227,F,61,9,3,111,-116,Severe
5,4,64,M,84,11,7,139,75,Well
9,9,117,M,90,12,3,147,30,Well
13,8,164,F,20,6,2,74,-90,Severe
9,4,112,F,30,6,9,81,-31,Severe
16,0,192,F,28,6,8,80,-112,Severe
17,3,207,F,33,6,11,83,-124,Severe
10,1,121,M,70,10,2,122,1,Good
17,1,205,F,65,9,8,116,-89,Severe
6,3,75,M,7,5,6,66,-9,Severe
8,3,99,M,65,9,8,116,17,Well
17,10,214,M,23,6,4,76,-138,Severe
18,4,220,F,59,9,1,109,-111,Severe
6,3,75,M,3,5,3,63,-12,Severe
17,4,208,F,40,7,5,89,-119,Severe
9,3,111,M,78,11,0,132,21,Well
14,9,177,M,104,13,7,163,-14,Severe
7,1,85,M,83,11,6,138,53,Well
15,7,187,F,66,9,9,117,-70,Severe
14,10,178,F,58,9,0,108,-70,Severe
10,11,131,M,72,10,4,124,-7,Severe
8,7,103,M,36,7,2,86,-17,Severe
11,7,139,M,49,8,2,98,-41,Severe
15,10,190,M,55,8,8,104,-86,Severe
6,10,82,M,77,10,11,131,49,Well
16,2,194,M,84,11,7,139,-55,Severe
9,5,113,F,109,14,1,169,56,Well
6,10,82,M,63,9,6,114,32,Well
16,6,198,M,85,11,9,141,-57,Severe
7,4,88,F,64,9,7,115,27,Well
16,1,193,F,22,6,3,75,-118,Severe
13,6,162,M,63,9,6,114,-48,Severe
9,10,118,M,54,8,7,103,-15,Severe
8,5,101,M,39,7,5,89,-12,Severe
6,8,80,F,27,6,7,79,-1,Mild
18,11,227,F,56,8,9,105,-122,Severe
5,9,69,F,20,6,2,74,5,Good
17,0,204,M,45,7,10,94,-110,Severe
7,3,87,M,30,6,9,81,-6,Severe
13,4,160,M,71,10,3,123,-37,Severe
10,1,121,F,110,14,3,171,50,Well
5,3,63,F,14,5,10,70,7,Well
10,3,123,M,77,10,11,131,8,Well
7,7,91,F,43,7,8,92,1,Good
14,10,178,M,12,5,9,69,-109,Severe
14,4,172,M,14,5,10,70,-102,Severe
9,8,116,M,64,9,7,115,-1,Mild
9,10,118,F,66,9,9,117,-1,Mild
18,2,218,M,82,11,5,137,-81,Severe
7,9,93,F,70,10,2,122,29,Well
14,4,172,M,61,9,3,111,-61,Severe
15,8,188,M,99,13,1,157,-31,Severe
6,10,82,M,50,8,3,99,17,Well
9,3,111,M,40,7,5,89,-22,Severe
17,1,205,F,2,5,3,63,-142,Severe
12,6,150,M,33,6,11,83,-67,Severe
5,10,70,M,59,9,1,109,39,Well
16,10,202,M,30,6,9,81,-121,Severe
13,2,158,F,16,5,11,71,-87,Severe
6,4,76,M,85,11,9,141,65,Well
17,8,212,M,84,11,7,139,-73,Severe
6,3,75,F,56,8,9,105,30,Well
12,5,149,F,103,13,6,162,13,Well
13,5,161,F,8,5,6,66,-95,Severe
5,4,64,M,37,7,3,87,23,Well
17,10,214,M,30,6,9,81,-133,Severe
15,8,188,M,102,13,6,162,-26,Severe
12,8,152,M,76,10,10,130,-22,Severe
15,4,184,M,6,5,5,65,-119,Severe
9,6,114,F,100,13,3,159,45,Well
6,8,80,M,37,7,3,87,7,Well
5,9,69,M,7,5,6,66,-3,Mild
5,0,60,F,105,13,9,165,105,Well
12,4,148,M,62,9,4,112,-36,Severe
10,8,128,M,18,6,1,73,-55,Severe
12,10,154,M,61,9,3,111,-43,Severe
12,5,149,F,108,14,0,168,19,Well
6,8,80,F,5,5,5,65,-15,Severe
17,9,213,M,103,13,6,162,-51,Severe
9,4,112,F,100,13,3,159,47,Well
6,3,75,M,101,13,4,160,85,Well
6,3,75,F,38,7,4,88,13,Well
15,7,187,F,25,6,5,77,-110,Severe
12,11,155,F,66,9,9,117,-38,Severe
16,1,193,M,25,6,5,77,-116,Severe
12,9,153,M,88,12,0,144,-9,Severe
7,7,91,F,66,9,9,117,26,Well
10,1,121,M,100,13,3,159,38,Well
17,4,208,M,58,9,0,108,-100,Severe
15,0,180,F,60,9,2,110,-70,Severe
5,1,61,F,25,6,5,77,16,Well
15,8,188,M,11,5,8,68,-120,Severe
6,4,76,M,96,12,10,154,78,Well
14,11,179,M,105,13,9,165,-14,Severe
5,1,61,F,38,7,4,88,27,Well
12,11,155,M,11,5,8,68,-87,Severe
12,3,147,M,51,8,4,100,-47,Severe
9,1,109,F,69,10,1,121,12,Well
6,9,81,F,5,5,5,65,-16,Severe
10,3,123,M,95,12,9,153,30,Well
15,7,187,M,86,11,10,142,-45,Severe
10,8,128,M,45,7,10,94,-34,Severe
8,0,96,M,61,9,3,111,15,Well
15,7,187,F,77,10,11,131,-56,Severe
5,2,62,M,71,10,3,123,61,Well
5,6,66,M,64,9,7,115,49,Well
6,2,74,F,106,13,10,166,92,Well
6,10,82,M,15,5,11,71,-11,Severe
6,5,77,M,4,5,4,64,-13,Severe
7,5,89,M,93,12,6,150,61,Well
18,4,220,F,100,13,3,159,-61,Severe
11,0,132,F,23,6,4,76,-56,Severe
8,8,104,M,42,7,7,91,-13,Severe
7,6,90,M,24,6,5,77,-13,Severe
15,9,189,F,63,9,6,114,-75,Severe
9,10,118,M,65,9,8,116,-2,Mild
5,6,66,F,31,6,9,81,15,Well
10,1,121,M,63,9,6,114,-7,Severe
13,2,158,F,35,7,1,85,-73,Severe
12,2,146,F,58,9,0,108,-38,Severe
14,2,170,F,90,12,3,147,-23,Severe
6,3,75,F,57,8,10,106,31,Well
7,11,95,M,108,14,0,168,73,Well
14,7,175,F,4,5,4,64,-111,Severe
6,4,76,F,38,7,4,88,12,Well
14,11,179,F,3,5,3,63,-116,Severe
10,4,124,F,99,13,1,157,33,Well
11,1,133,F,19,6,1,73,-60,Severe
8,7,103,M,33,6,11,83,-20,Severe
5,0,60,M,15,5,11,71,11,Well
10,10,130,F,39,7,5,89,-41,Severe
13,2,158,F,75,10,9,129,-29,Severe
5,1,61,M,79,11,1,133,72,Well
10,6,126,M,48,8,1,97,-29,Severe
8,3,99,M,88,12,0,144,45,Well
14,5,173,M,13,5,9,69,-104,Severe
15,11,191,M,48,8,1,97,-94,Severe
8,4,100,M,60,9,2,110,10,Well
12,3,147,M,11,5,8,68,-79,Severe
12,5,149,M,84,11,7,139,-10,Severe
13,9,165,M,48,8,1,97,-68,Severe
13,4,160,F,80,11,3,135,-25,Severe
17,6,210,M,110,14,3,171,-39,Severe
13,8,164,M,6,5,5,65,-99,Severe
15,9,189,F,48,8,1,97,-92,Severe
8,3,99,F,39,7,5,89,-10,Severe
6,4,76,M,53,8,6,102,26,Well
12,3,147,M,110,14,3,171,24,Well
6,3,75,M,84,11,7,139,64,Well
14,9,177,F,17,6,0,72,-105,Severe
11,11,143,F,30,6,9,81,-62,Severe
6,5,77,F,58,9,0,108,31,Well
9,0,108,F,91,12,4,148,40,Well
8,6,102,F,60,9,2,110,8,Well
12,8,152,F,58,9,0,108,-44,Severe
13,2,158,F,76,10,10,130,-28,Severe
6,3,75,F,100,13,3,159,84,Well
5,9,69,M,84,11,7,139,70,Well
8,8,104,M,71,10,3,123,19,Well
11,1,133,M,53,8,6,102,-31,Severe
12,10,154,F,59,9,1,109,-45,Severe
6,4,76,M,80,11,3,135,59,Well
17,4,208,M,36,7,2,86,-122,Severe
5,8,68,M,110,14,3,171,103,Well
17,1,205,F,70,10,2,122,-83,Severe
12,6,150,M,49,8,2,98,-52,Severe
6,6,78,F,76,10,10,130,52,Well
7,10,94,F,48,8,1,97,3,Good
18,6,222,F,61,9,3,111,-111,Severe
14,6,174,F,105,13,9,165,-9,Severe
12,1,145,F,8,5,6,66,-79,Severe
17,0,204,F,42,7,7,91,-113,Severe
10,4,124,F,58,9,0,108,-16,Severe
14,7,175,F,62,9,4,112,-63,Severe
18,5,221,M,31,6,9,81,-140,Severe
17,0,204,M,9,5,7,67,-137,Severe
10,3,123,F,6,5,5,65,-58,Severe
11,3,135,F,104,13,7,163,28,Well
16,2,194,M,58,9,0,108,-86,Severe
17,10,214,M,107,13,11,167,-47,Severe
10,8,128,F,109,14,1,169,41,Well
9,0,108,F,18,6,1,73,-35,Severe
7,7,91,F,59,9,1,109,18,Well
12,1,145,M,76,10,10,130,-15,Severe
9,4,112,F,108,14,0,168,56,Well
12,6,150,M,52,8,5,101,-49,Severe
16,2,194,M,82,11,5,137,-57,Severe
9,11,119,F,4,5,4,64,-55,Severe
9,5,113,F,83,11,6,138,25,Well
15,3,183,M,9,5,7,67,-116,Severe
6,11,83,F,91,12,4,148,65,Well
7,11,95,M,11,5,8,68,-27,Severe
12,0,144,M,56,8,9,105,-39,Severe
11,7,139,F,83,11,6,138,-1,Mild
18,11,227,M,54,8,7,103,-124,Severe
11,10,142,F,68,10,0,120,-22,Severe
17,11,215,M,98,13,0,156,-59,Severe
5,3,63,F,65,9,8,116,53,Well
11,2,134,M,77,10,11,131,-3,Mild
14,2,170,F,8,5,6,66,-104,Severe
6,10,82,M,76,10,10,130,48,Well
13,10,166,F,84,11,7,139,-27,Severe
17,0,204,M,80,11,3,135,-69,Severe
5,3,63,F,4,5,4,64,1,Good
16,5,197,M,102,13,6,162,-35,Severe
12,10,154,M,109,14,1,169,15,Well
14,6,174,M,67,9,10,118,-56,Severe
10,9,129,M,55,8,8,104,-25,Severe
12,3,147,M,48,8,1,97,-50,Severe
18,10,226,M,32,6,10,82,-144,Severe
17,9,213,F,15,5,11,71,-142,Severe
6,0,72,F,54,8,7,103,31,Well
10,11,131,M,97,12,11,155,24,Well
10,10,130,M,52,8,5,101,-29,Severe
5,2,62,M,86,11,10,142,80,Well
13,6,162,F,73,10,6,126,-36,Severe
14,11,179,F,71,10,3,123,-56,Severe
16,1,193,F,60,9,2,110,-83,Severe
12,3,147,F,31,6,9,81,-66,Severe
6,9,81,M,92,12,5,149,68,Well
6,6,78,F,45,7,10,94,16,Well
12,9,153,F,45,7,10,94,-59,Severe
6,11,83,F,50,8,3,99,16,Well
11,3,135,M,39,7,5,89,-46,Severe
16,11,203,F,82,11,5,137,-66,Severe
10,2,122,F,81,11,4,136,14,Well
7,6,90,M,103,13,6,162,72,Well
16,6,198,F,76,10,10,130,-68,Severe
15,6,186,M,96,12,10,154,-32,Severe
11,11,143,M,56,8,9,105,-38,Severe
16,7,199,F,93,12,6,150,-49,Severe
7,0,84,M,36,7,2,86,2,Good
17,7,211,M,95,12,9,153,-58,Severe
13,3,159,M,110,14,3,171,12,Well
5,9,69,M,64,9,7,115,46,Well
5,2,62,M,56,8,9,105,43,Well
8,10,106,M,108,14,0,168,62,Well
6,0,72,M,98,13,0,156,84,Well
6,1,73,M,107,13,11,167,94,Well
5,3,63,F,52,8,5,101,38,Well
6,9,81,F,48,8,1,97,16,Well
10,11,131,M,76,10,10,130,-1,Mild
14,3,171,F,53,8,6,102,-69,Severe
15,3,183,M,106,13,10,166,-17,Severe
9,9,117,F,95,12,9,153,36,Well
8,8,104,M,21,6,2,74,-30,Severe
6,1,73,M,102,13,6,162,89,Well
6,10,82,F,73,10,6,126,44,Well
6,5,77,M,29,6,8,80,3,Good
17,3,207,M,3,5,3,63,-144,Severe
9,5,113,M,95,12,9,153,40,Well
14,8,176,F,109,14,1,169,-7,Severe
15,7,187,F,80,11,3,135,-52,Severe
15,0,180,M,57,8,10,106,-74,Severe
10,1,121,M,25,6,5,77,-44,Severe
7,11,95,M,14,5,10,70,-25,Severe
7,3,87,M,102,13,6,162,75,Well
16,5,197,F,96,12,10,154,-43,Severe
8,5,101,F,18,6,1,73,-28,Severe
10,10,130,F,32,6,10,82,-48,Severe
6,8,80,F,49,8,2,98,18,Well
16,3,195,F,92,12,5,149,-46,Severe
17,5,209,M,40,7,5,89,-120,Severe
10,0,120,M,13,5,9,69,-51,Severe
5,10,70,F,110,14,3,171,101,Well
15,4,184,F,69,10,1,121,-63,Severe
5,6,66,M,94,12,7,151,85,Well
17,0,204,F,96,12,10,154,-50,Severe
9,3,111,M,23,6,4,76,-35,Severe
13,8,164,F,37,7,3,87,-77,Severe
12,3,147,F,28,6,8,80,-67,Severe
17,9,213,M,74,10,7,127,-86,Severe
15,7,187,F,97,12,11,155,-32,Severe
7,3,87,F,32,6,10,82,-5,Mild
8,2,98,F,77,10,11,131,33,Well
7,3,87,M,45,7,10,94,7,Well
17,0,204,F,103,13,6,162,-42,Severe
7,0,84,F,8,5,6,66,-18,Severe
8,3,99,F,105,13,9,165,66,Well
8,11,107,F,80,11,3,135,28,Well
7,6,90,F,69,10,1,121,31,Well
5,3,63,M,89,12,1,145,82,Well
9,3,111,M,43,7,8,92,-19,Severe
10,0,120,M,17,6,0,72,-48,Severe
5,7,67,M,82,11,5,137,70,Well
13,1,157,M,87,11,11,143,-14,Severe
11,3,135,M,4,5,4,64,-71,Severe
7,11,95,F,98,13,0,156,61,Well
18,5,221,M,9,5,7,67,-154,Severe
14,2,170,F,6,5,5,65,-105,Severe
16,3,195,F,47,8,0,96,-99,Severe
7,2,86,M,33,6,11,83,-3,Mild
18,11,227,M,91,12,4,148,-79,Severe
10,5,125,M,23,6,4,76,-49,Severe
10,3,123,M,41,7,6,90,-33,Severe
18,2,218,F,43,7,8,92,-126,Severe
18,1,217,M,32,6,10,82,-135,Severe
9,3,111,F,73,10,6,126,15,Well
13,8,164,F,18,6,1,73,-91,Severe
6,3,75,M,19,6,1,73,-2,Mild
6,4,76,M,54,8,7,103,27,Well
12,11,155,M,70,10,2,122,-33,Severe
15,1,181,M,14,5,10,70,-111,Severe
11,3,135,F,39,7,5,89,-46,Severe
8,4,100,F,107,13,11,167,67,Well
12,3,147,M,70,10,2,122,-25,Severe
5,0,60,M,4,5,4,64,4,Good
9,3,111,M,45,7,10,94,-17,Severe
7,11,95,M,50,8,3,99,4,Good
11,0,132,F,99,13,1,157,25,Well
7,2,86,F,42,7,7,91,5,Good
16,6,198,F,85,11,9,141,-57,Severe
7,2,86,F,60,9,2,110,24,Well
12,9,153,M,20,6,2,74,-79,Severe
14,0,168,M,105,13,9,165,-3,Mild
16,4,196,M,44,7,9,93,-103,Severe
7,0,84,M,42,7,7,91,7,Well
13,8,164,M,28,6,8,80,-84,Severe
13,1,157,F,72,10,4,124,-33,Severe
5,6,66,M,4,5,4,64,-2,Mild
5,8,68,M,35,7,1,85,17,Well
5,2,62,F,28,6,8,80,18,Well
11,5,137,F,3,5,3,63,-74,Severe
5,3,63,M,55,8,8,104,41,Well
5,8,68,M,25,6,5,77,9,Well
15,11,191,F,6,5,5,65,-126,Severe
10,9,129,M,22,6,3,75,-54,Severe
5,11,71,F,21,6,2,74,3,Good
17,9,213,M,55,8,8,104,-109,Severe
8,5,101,F,99,13,1,157,56,Well
17,3,207,F,14,5,10,70,-137,Severe
6,3,75,F,37,7,3,87,12,Well
13,0,156,F,21,6,2,74,-82,Severe
13,4,160,F,47,8,0,96,-64,Severe
7,1,85,F,98,13,0,156,71,Well
18,10,226,F,16,5,11,71,-155,Severe
16,0,192,M,91,12,4,148,-44,Severe
8,1,97,F,58,9,0,108,11,Well
10,8,128,F,42,7,7,91,-37,Severe
12,5,149,F,44,7,9,93,-56,Severe
8,4,100,M,105,13,9,165,65,Well
5,3,63,M,7,5,6,66,3,Good
13,4,160,M,5,5,5,65,-95,Severe
15,11,191,M,81,11,4,136,-55,Severe
13,1,157,F,15,5,11,71,-86,Severe
17,3,207,M,84,11,7,139,-68,Severe
5,7,67,M,68,10,0,120,53,Well
6,10,82,M,26,6,6,78,-4,Mild
8,8,104,F,56,8,9,105,1,Good
18,3,219,F,73,10,6,126,-93,Severe
6,2,74,F,63,9,6,114,40,Well
6,6,78,F,105,13,9,165,87,Well
5,5,65,F,81,11,4,136,71,Well
15,1,181,M,75,10,9,129,-52,Severe
14,7,175,F,43,7,8,92,-83,Severe
10,0,120,F,41,7,6,90,-30,Severe
5,4,64,F,12,5,9,69,5,Good
17,0,204,M,37,7,3,87,-117,Severe
8,2,98,M,31,6,9,81,-17,Severe
14,0,168,M,54,8,7,103,-65,Severe
8,9,105,F,10,5,7,67,-38,Severe
15,2,182,M,49,8,2,98,-84,Severe
14,4,172,M,99,13,1,157,-15,Severe
5,11,71,M,58,9,0,108,37,Well
18,6,222,F,10,5,7,67,-155,Severe
16,3,195,M,109,14,1,169,-26,Severe
6,11,83,M,6,5,5,65,-18,Severe
11,8,140,F,41,7,6,90,-50,Severe
9,9,117,M,29,6,8,80,-37,Severe
10,11,131,M,29,6,8,80,-51,Severe
10,2,122,M,73,10,6,126,4,Good
13,9,165,F,48,8,1,97,-68,Severe
16,3,195,M,103,13,6,162,-33,Severe
12,1,145,M,8,5,6,66,-79,Severe
16,3,195,F,54,8,7,103,-92,Severe
8,5,101,M,64,9,7,115,14,Well
11,0,132,F,59,9,1,109,-23,Severe
10,0,120,F,7,5,6,66,-54,Severe
18,8,224,M,44,7,9,93,-131,Severe
5,0,60,F,63,9,6,114,54,Well
13,1,157,F,36,7,2,86,-71,Severe
6,7,79,M,69,10,1,121,42,Well
14,5,173,F,99,13,1,157,-16,Severe
5,5,65,F,33,6,11,83,18,Well
8,9,105,M,100,13,3,159,54,Well
15,0,180,F,107,13,11,167,-13,Severe
18,8,224,M,50,8,3,99,-125,Severe
12,6,150,F,11,5,8,68,-82,Severe
13,3,159,F,5,5,5,65,-94,Severe
15,3,183,F,96,12,10,154,-29,Severe
11,0,132,M,67,9,10,118,-14,Severe
14,9,177,M,2,5,3,63,-114,Severe
14,9,177,F,110,14,3,171,-6,Severe
17,3,207,F,26,6,6,78,-129,Severe
6,5,77,F,82,11,5,137,60,Well
14,7,175,F,20,6,2,74,-101,Severe
10,1,121,M,99,13,1,157,36,Well
16,6,198,M,81,11,4,136,-62,Severe
6,0,72,M,37,7,3,87,15,Well
18,1,217,F,90,12,3,147,-70,Severe
15,9,189,F,19,6,1,73,-116,Severe
12,6,150,F,55,8,8,104,-46,Severe
5,2,62,F,62,9,4,112,50,Well
12,1,145,F,56,8,9,105,-40,Severe
12,1,145,F,68,10,0,120,-25,Severe
15,0,180,F,69,10,1,121,-59,Severe
11,11,143,F,101,13,4,160,17,Well
5,10,70,F,35,7,1,85,15,Well
14,5,173,M,85,11,9,141,-32,Severe
15,3,183,F,42,7,7,91,-92,Severe
14,2,170,F,50,8,3,99,-71,Severe
12,0,144,M,57,8,10,106,-38,Severe
14,6,174,F,73,10,6,126,-48,Severe
9,8,116,M,15,5,11,71,-45,Severe
12,8,152,F,80,11,3,135,-17,Severe
6,4,76,M,25,6,5,77,1,Good
7,4,88,M,37,7,3,87,-1,Mild
16,4,196,F,84,11,7,139,-57,Severe
17,8,212,M,37,7,3,87,-125,Severe
8,5,101,F,6,5,5,65,-36,Severe
8,8,104,F,97,12,11,155,51,Well
10,7,127,F,11,5,8,68,-59,Severe
8,0,96,M,78,11,0,132,36,Well
16,9,201,M,41,7,6,90,-111,Severe
12,6,150,M,62,9,4,112,-38,Severe
7,11,95,F,66,9,9,117,22,Well
12,9,153,F,60,9,2,110,-43,Severe
9,3,111,F,93,12,6,150,39,Well
14,0,168,F,99,13,1,157,-11,Severe
13,10,166,F,67,9,10,118,-48,Severe
11,3,135,F,100,13,3,159,24,Well
9,8,116,M,10,5,7,67,-49,Severe
16,10,202,F,102,13,6,162,-40,Severe
8,4,100,M,41,7,6,90,-10,Severe
16,3,195,M,94,12,7,151,-44,Severe
11,8,140,M,96,12,10,154,14,Well
7,0,84,M,48,8,1,97,13,Well
6,3,75,M,70,10,2,122,47,Well
14,2,170,F,82,11,5,137,-33,Severe
5,6,66,F,11,5,8,68,2,Good
8,3,99,F,55,8,8,104,5,Good
12,3,147,M,22,6,3,75,-72,Severe
8,0,96,M,20,6,2,74,-22,Severe
7,7,91,F,27,6,7,79,-12,Severe
18,5,221,M,37,7,3,87,-134,Severe
13,6,162,F,57,8,10,106,-56,Severe
17,5,209,M,30,6,9,81,-128,Severe
15,1,181,M,79,11,1,133,-48,Severe
18,6,222,M,96,12,10,154,-68,Severe
10,6,126,F,88,12,0,144,18,Well
7,4,88,F,38,7,4,88,0,Neutral
15,6,186,F,43,7,8,92,-94,Severe
14,1,169,M,95,12,9,153,-16,Severe
10,11,131,M,104,13,7,163,32,Well
14,6,174,M,38,7,4,88,-86,Severe
13,10,166,F,33,6,11,83,-83,Severe
5,1,61,M,34,7,0,84,23,Well
8,9,105,M,94,12,7,151,46,Well
14,0,168,F,4,5,4,64,-104,Severe
18,11,227,M,61,9,3,111,-116,Severe
14,6,174,M,68,10,0,120,-54,Severe
16,0,192,F,70,10,2,122,-70,Severe
7,0,84,M,10,5,7,67,-17,Severe
14,3,171,M,42,7,7,91,-80,Severe
12,3,147,F,61,9,3,111,-36,Severe
13,1,157,F,88,12,0,144,-13,Severe
10,0,120,F,72,10,4,124,4,Good
16,11,203,F,55,8,8,104,-99,Severe
11,2,134,F,57,8,10,106,-28,Severe
13,3,159,M,92,12,5,149,-10,Severe
12,0,144,F,63,9,6,114,-30,Severe
8,3,99,M,3,5,3,63,-36,Severe
7,3,87,M,6,5,5,65,-22,Severe
15,7,187,F,90,12,3,147,-40,Severe
11,8,140,M,79,11,1,133,-7,Severe
11,11,143,M,38,7,4,88,-55,Severe
14,8,176,F,11,5,8,68,-108,Severe
14,3,171,M,83,11,6,138,-33,Severe
14,6,174,F,94,12,7,151,-23,Severe
8,6,102,F,12,5,9,69,-33,Severe
6,8,80,M,100,13,3,159,79,Well
10,3,123,M,87,11,11,143,20,Well
10,3,123,F,101,13,4,160,37,Well
8,0,96,M,104,13,7,163,67,Well
8,0,96,F,45,7,10,94,-2,Mild
18,10,226,F,2,5,3,63,-163,Severe
6,11,83,F,58,9,0,108,25,Well
13,0,156,F,15,5,11,71,-85,Severe
8,11,107,M,18,6,1,73,-34,Severe
7,11,95,M,91,12,4,148,53,Well
11,8,140,F,53,8,6,102,-38,Severe
11,6,138,M,53,8,6,102,-36,Severe
11,11,143,M,51,8,4,100,-43,Severe
6,6,78,M,86,11,10,142,64,Well
18,10,226,F,68,10,0,120,-106,Severe
14,8,176,F,93,12,6,150,-26,Severe
6,2,74,M,2,5,3,63,-11,Severe
12,7,151,M,52,8,5,101,-50,Severe
12,8,152,M,102,13,6,162,10,Well
13,11,167,F,50,8,3,99,-68,Severe
6,6,78,M,27,6,7,79,1,Good
5,4,64,F,48,8,1,97,33,Well
16,7,199,M,38,7,4,88,-111,Severe
8,7,103,F,93,12,6,150,47,Well
10,9,129,F,109,14,1,169,40,Well
7,3,87,M,11,5,8,68,-19,Severe
5,6,66,F,4,5,4,64,-2,Mild
9,3,111,F,22,6,3,75,-36,Severe
5,4,64,M,67,9,10,118,54,Well
6,8,80,M,26,6,6,78,-2,Mild
11,3,135,M,34,7,0,84,-51,Severe
12,10,154,M,26,6,6,78,-76,Severe
10,6,126,M,78,11,0,132,6,Well
17,1,205,M,102,13,6,162,-43,Severe
6,4,76,M,72,10,4,124,48,Well
5,0,60,F,92,12,5,149,89,Well
7,9,93,F,110,14,3,171,78,Well
6,11,83,M,15,5,11,71,-12,Severe
16,1,193,F,32,6,10,82,-111,Severe
15,3,183,M,4,5,4,64,-119,Severe
15,7,187,M,3,5,3,63,-124,Severe
8,11,107,M,49,8,2,98,-9,Severe
16,3,195,M,81,11,4,136,-59,Severe
18,3,219,F,52,8,5,101,-118,Severe
16,0,192,F,52,8,5,101,-91,Severe
14,3,171,F,50,8,3,99,-72,Severe
9,11,119,F,23,6,4,76,-43,Severe
10,0,120,M,89,12,1,145,25,Well
15,1,181,F,92,12,5,149,-32,Severe
8,10,106,F,43,7,8,92,-14,Severe
9,0,108,F,34,7,0,84,-24,Severe
18,1,217,M,59,9,1,109,-108,Severe
18,2,218,M,55,8,8,104,-114,Severe
12,0,144,F,45,7,10,94,-50,Severe
17,3,207,M,97,12,11,155,-52,Severe
17,6,210,F,106,13,10,166,-44,Severe
8,2,98,M,51,8,4,100,2,Good
16,7,199,M,15,5,11,71,-128,Severe
16,5,197,M,98,13,0,156,-41,Severe
16,9,201,M,51,8,4,100,-101,Severe
16,3,195,F,40,7,5,89,-106,Severe
17,11,215,F,91,12,4,148,-67,Severe
16,1,193,F,48,8,1,97,-96,Severe
5,10,70,F,2,5,3,63,-7,Severe
15,4,184,M,13,5,9,69,-115,Severe
16,2,194,F,80,11,3,135,-59,Severe
11,9,141,F,54,8,7,103,-38,Severe
11,4,136,F,27,6,7,79,-57,Severe
6,8,80,M,108,14,0,168,88,Well
5,11,71,M,4,5,4,64,-7,Severe
17,0,204,M,18,6,1,73,-131,Severe
13,2,158,M,68,10,0,120,-38,Severe
17,2,206,M,76,10,10,130,-76,Severe
14,11,179,M,35,7,1,85,-94,Severe
7,9,93,M,10,5,7,67,-26,Severe
7,2,86,M,56,8,9,105,19,Well
15,1,181,F,101,13,4,160,-21,Severe
16,3,195,M,79,11,1,133,-62,Severe
18,6,222,F,56,8,9,105,-117,Severe
13,3,159,M,10,5,7,67,-92,Severe
8,11,107,F,49,8,2,98,-9,Severe
17,1,205,M,54,8,7,103,-102,Severe
9,9,117,M,37,7,3,87,-30,Severe
13,10,166,F,23,6,4,76,-90,Severe
5,5,65,F,38,7,4,88,23,Well
18,3,219,F,80,11,3,135,-84,Severe
9,0,108,M,67,9,10,118,10,Well
5,3,63,F,74,10,7,127,64,Well
17,2,206,M,102,13,6,162,-44,Severe
18,10,226,F,47,8,0,96,-130,Severe
8,6,102,F,72,10,4,124,22,Well
12,8,152,M,75,10,9,129,-23,Severe
5,1,61,F,101,13,4,160,99,Well
9,3,111,F,87,11,11,143,32,Well
11,1,133,F,43,7,8,92,-41,Severe
5,6,66,F,48,8,1,97,31,Well
17,9,213,M,6,5,5,65,-148,Severe
16,9,201,F,90,12,3,147,-54,Severe
16,2,194,F,82,11,5,137,-57,Severe
10,3,123,F,85,11,9,141,18,Well
8,3,99,F,63,9,6,114,15,Well
16,3,195,F,85,11,9,141,-54,Severe
6,5,77,M,40,7,5,89,12,Well
11,0,132,F,53,8,6,102,-30,Severe
15,2,182,M,5,5,5,65,-117,Severe
8,6,102,M,51,8,4,100,-2,Mild
12,2,146,M,30,6,9,81,-65,Severe
14,3,171,F,2,5,3,63,-108,Severe
15,8,188,F,104,13,7,163,-25,Severe
11,1,133,F,109,14,1,169,36,Well
11,1,133,F,81,11,4,136,3,Good
11,11,143,M,64,9,7,115,-28,Severe
8,6,102,F,100,13,3,159,57,Well
6,5,77,M,33,6,11,83,6,Well
14,8,176,F,62,9,4,112,-64,Severe
13,8,164,M,70,10,2,122,-42,Severe
6,11,83,F,19,6,1,73,-10,Severe
15,8,188,M,80,11,3,135,-53,Severe
15,8,188,F,80,11,3,135,-53,Severe
16,8,200,M,27,6,7,79,-121,Severe
14,6,174,F,59,9,1,109,-65,Severe
18,4,220,M,102,13,6,162,-58,Severe
5,11,71,F,18,6,1,73,2,Good
12,3,147,M,53,8,6,102,-45,Severe
5,6,66,M,43,7,8,92,26,Well
10,1,121,M,26,6,6,78,-43,Severe
7,3,87,F,46,7,11,95,8,Well
12,8,152,F,46,7,11,95,-57,Severe
17,10,214,F,63,9,6,114,-100,Severe
9,11,119,M,54,8,7,103,-16,Severe
6,1,73,M,96,12,10,154,81,Well
9,0,108,M,70,10,2,122,14,Well
16,8,200,F,63,9,6,114,-86,Severe
5,3,63,M,107,13,11,167,104,Well
14,10,178,F,9,5,7,67,-111,Severe
10,7,127,F,74,10,7,127,0,Neutral
14,10,178,M,42,7,7,91,-87,Severe
15,6,186,F,77,10,11,131,-55,Severe
14,0,168,F,58,9,0,108,-60,Severe
9,2,110,M,48,8,1,97,-13,Severe
18,7,223,F,108,14,0,168,-55,Severe
11,8,140,F,14,5,10,70,-70,Severe
18,5,221,M,77,10,11,131,-90,Severe
18,10,226,M,71,10,3,123,-103,Severe
9,9,117,M,38,7,4,88,-29,Severe
8,3,99,M,53,8,6,102,3,Good
12,4,148,F,83,11,6,138,-10,Severe
8,10,106,F,11,5,8,68,-38,Severe
15,6,186,F,84,11,7,139,-47,Severe
17,7,211,F,87,11,11,143,-68,Severe
14,3,171,M,67,9,10,118,-53,Severe
11,5,137,F,59,9,1,109,-28,Severe
15,2,182,M,106,13,10,166,-16,Severe
17,3,207,F,99,13,1,157,-50,Severe
15,5,185,F,31,6,9,81,-104,Severe
8,10,106,M,72,10,4,124,18,Well
8,7,103,F,19,6,1,73,-30,Severe
6,1,73,M,30,6,9,81,8,Well
11,5,137,M,75,10,9,129,-8,Severe
10,0,120,M,18,6,1,73,-47,Severe
9,9,117,F,14,5,10,70,-47,Severe
13,4,160,F,62,9,4,112,-48,Severe
12,3,147,M,17,6,0,72,-75,Severe
17,2,206,F,26,6,6,78,-128,Severe
16,5,197,F,90,12,3,147,-50,Severe
13,11,167,M,98,13,0,156,-11,Severe
11,3,135,M,23,6,4,76,-59,Severe
17,3,207,M,85,11,9,141,-66,Severe
9,7,115,M,42,7,7,91,-24,Severe
9,8,116,F,66,9,9,117,1,Good
7,7,91,F,18,6,1,73,-18,Severe
17,2,206,F,44,7,9,93,-113,Severe
9,5,113,M,33,6,11,83,-30,Severe
15,0,180,F,98,13,0,156,-24,Severe
5,1,61,F,35,7,1,85,24,Well
8,0,96,F,39,7,5,89,-7,Severe
14,11,179,M,101,13,4,160,-19,Severe
17,4,208,F,61,9,3,111,-97,Severe
9,10,118,M,48,8,1,97,-21,Severe
9,4,112,F,41,7,6,90,-22,Severe
14,3,171,F,84,11,7,139,-32,Severe
18,5,221,M,5,5,5,65,-156,Severe
15,9,189,M,80,11,3,135,-54,Severe
10,10,130,F,50,8,3,99,-31,Severe
6,0,72,M,66,9,9,117,45,Well
8,7,103,F,45,7,10,94,-9,Severe
7,7,91,F,47,8,0,96,5,Good
5,11,71,F,60,9,2,110,39,Well
7,0,84,M,38,7,4,88,4,Good
15,0,180,M,27,6,7,79,-101,Severe
12,4,148,F,33,6,11,83,-65,Severe
14,3,171,M,107,13,11,167,-4,Mild
16,0,192,M,77,10,11,131,-61,Severe
6,9,81,M,67,9,10,118,37,Well
16,0,192,F,71,10,3,123,-69,Severe
8,3,99,F,107,13,11,167,68,Well
5,10,70,F,90,12,3,147,77,Well
6,10,82,M,20,6,2,74,-8,Severe
10,4,124,F,66,9,9,117,-7,Severe
18,7,223,F,93,12,6,150,-73,Severe
15,3,183,M,70,10,2,122,-61,Severe
7,11,95,F,12,5,9,69,-26,Severe
13,8,164,F,57,8,10,106,-58,Severe
15,5,185,F,5,5,5,65,-120,Severe
17,3,207,F,59,9,1,109,-98,Severe
12,7,151,M,32,6,10,82,-69,Severe
18,9,225,M,44,7,9,93,-132,Severe
10,11,131,F,5,5,5,65,-66,Severe
8,3,99,F,95,12,9,153,54,Well
7,6,90,M,19,6,1,73,-17,Severe
10,10,130,M,37,7,3,87,-43,Severe
18,3,219,M,13,5,9,69,-150,Severe
15,5,185,F,87,11,11,143,-42,Severe
5,3,63,M,99,13,1,157,94,Well
18,0,216,F,44,7,9,93,-123,Severe
17,8,212,M,88,12,0,144,-68,Severe
13,11,167,M,34,7,0,84,-83,Severe
10,1,121,F,35,7,1,85,-36,Severe
11,7,139,F,22,6,3,75,-64,Severe
13,11,167,F,71,10,3,123,-44,Severe
14,6,174,M,2,5,3,63,-111,Severe
6,6,78,M,42,7,7,91,13,Well
11,8,140,F,9,5,7,67,-73,Severe
7,0,84,M,63,9,6,114,30,Well
12,3,147,M,10,5,7,67,-80,Severe
15,8,188,M,60,9,2,110,-78,Severe
10,3,123,F,66,9,9,117,-6,Severe
7,5,89,M,14,5,10,70,-19,Severe
15,1,181,M,83,11,6,138,-43,Severe
6,8,80,M,33,6,11,83,3,Good
7,9,93,F,54,8,7,103,10,Well
11,5,137,M,11,5,8,68,-69,Severe
12,6,150,F,76,10,10,130,-20,Severe
17,7,211,F,108,14,0,168,-43,Severe
15,6,186,M,104,13,7,163,-23,Severe
15,3,183,M,42,7,7,91,-92,Severe
13,4,160,M,24,6,5,77,-83,Severe
18,1,217,M,77,10,11,131,-86,Severe
9,10,118,M,70,10,2,122,4,Good
17,4,208,M,57,8,10,106,-102,Severe
14,1,169,F,33,6,11,83,-86,Severe
15,8,188,F,40,7,5,89,-99,Severe
7,9,93,F,71,10,3,123,30,Well
11,2,134,M,90,12,3,147,13,Well
11,5,137,F,54,8,7,103,-34,Severe
9,4,112,F,82,11,5,137,25,Well
17,7,211,F,62,9,4,112,-99,Severe
5,5,65,F,29,6,8,80,15,Well
8,11,107,F,69,10,1,121,14,Well
16,1,193,M,5,5,5,65,-128,Severe
13,4,160,F,11,5,8,68,-92,Severe
6,7,79,F,26,6,6,78,-1,Mild
8,5,101,F,13,5,9,69,-32,Severe
7,3,87,F,28,6,8,80,-7,Severe
18,8,224,M,39,7,5,89,-135,Severe
12,11,155,F,9,5,7,67,-88,Severe
8,3,99,F,83,11,6,138,39,Well
12,2,146,F,2,5,3,63,-83,Severe
7,0,84,M,71,10,3,123,39,Well
16,8,200,M,31,6,9,81,-119,Severe
16,1,193,M,12,5,9,69,-124,Severe
5,6,66,M,30,6,9,81,15,Well
15,2,182,M,104,13,7,163,-19,Severe
17,1,205,F,61,9,3,111,-94,Severe
14,4,172,M,83,11,6,138,-34,Severe
17,8,212,M,5,5,5,65,-147,Severe
14,3,171,M,90,12,3,147,-24,Severe
18,2,218,M,49,8,2,98,-120,Severe
12,3,147,M,6,5,5,65,-82,Severe
15,4,184,F,24,6,5,77,-107,Severe
17,11,215,F,51,8,4,100,-115,Severe
12,3,147,F,85,11,9,141,-6,Severe
12,7,151,M,71,10,3,123,-28,Severe
14,8,176,M,58,9,0,108,-68,Severe
13,7,163,F,86,11,10,142,-21,Severe
9,3,111,F,42,7,7,91,-20,Severe
5,7,67,F,101,13,4,160,93,Well
15,3,183,M,104,13,7,163,-20,Severe
5,5,65,M,7,5,6,66,1,Good
11,9,141,M,77,10,11,131,-10,Severe
15,7,187,F,70,10,2,122,-65,Severe
17,6,210,M,97,12,11,155,-55,Severe
18,0,216,F,43,7,8,92,-124,Severe
11,0,132,M,110,14,3,171,39,Well
14,6,174,M,84,11,7,139,-35,Severe
16,3,195,M,72,10,4,124,-71,Severe
8,8,104,F,17,6,0,72,-32,Severe
16,6,198,M,62,9,4,112,-86,Severe
15,2,182,M,90,12,3,147,-35,Severe
5,3,63,M,7,5,6,66,3,Good
11,9,141,M,38,7,4,88,-53,Severe
5,0,60,F,65,9,8,116,56,Well
15,3,183,M,97,12,11,155,-28,Severe
13,3,159,F,49,8,2,98,-61,Severe
14,11,179,F,45,7,10,94,-85,Severe
15,6,186,M,18,6,1,73,-113,Severe
12,8,152,F,14,5,10,70,-82,Severe
10,6,126,M,33,6,11,83,-43,Severe
9,9,117,M,77,10,11,131,14,Well
15,4,184,M,64,9,7,115,-69,Severe
10,6,126,F,17,6,0,72,-54,Severe
8,9,105,F,22,6,3,75,-30,Severe
5,3,63,M,91,12,4,148,85,Well
18,4,220,M,86,11,10,142,-78,Severe
14,3,171,F,104,13,7,163,-8,Severe
15,1,181,F,67,9,10,118,-63,Severe
13,2,158,F,11,5,8,68,-90,Severe
13,3,159,F,17,6,0,72,-87,Severe
10,1,121,M,84,11,7,139,18,Well
6,8,80,M,85,11,9,141,61,Well
15,1,181,M,78,11,0,132,-49,Severe
10,10,130,F,11,5,8,68,-62,Severe
9,3,111,M,74,10,7,127,16,Well
12,9,153,M,45,7,10,94,-59,Severe
13,3,159,M,82,11,5,137,-22,Severe
12,2,146,F,18,6,1,73,-73,Severe
13,8,164,M,59,9,1,109,-55,Severe
13,1,157,M,37,7,3,87,-70,Severe
6,1,73,F,31,6,9,81,8,Well
14,10,178,F,16,5,11,71,-107,Severe
13,11,167,F,21,6,2,74,-93,Severe
10,3,123,F,67,9,10,118,-5,Mild
16,3,195,M,27,6,7,79,-116,Severe
12,6,150,F,92,12,5,149,-1,Mild
12,5,149,F,102,13,6,162,13,Well
18,9,225,F,35,7,1,85,-140,Severe
17,0,204,F,22,6,3,75,-129,Severe
18,5,221,M,44,7,9,93,-128,Severe
14,9,177,F,42,7,7,91,-86,Severe
9,7,115,M,81,11,4,136,21,Well
17,5,209,F,89,12,1,145,-64,Severe
13,0,156,F,55,8,8,104,-52,Severe
16,9,201,M,81,11,4,136,-65,Severe
9,1,109,F,62,9,4,112,3,Good
13,1,157,F,34,7,0,84,-73,Severe
6,6,78,M,23,6,4,76,-2,Mild
15,0,180,F,86,11,10,142,-38,Severe
7,6,90,F,98,13,0,156,66,Well
8,7,103,F,8,5,6,66,-37,Severe
18,2,218,F,21,6,2,74,-144,Severe
12,0,144,M,38,7,4,88,-56,Severe
9,1,109,F,86,11,10,142,33,Well
12,9,153,F,95,12,9,153,0,Neutral
6,3,75,M,14,5,10,70,-5,Mild
14,3,171,M,34,7,0,84,-87,Severe
10,6,126,F,15,5,11,71,-55,Severe
8,8,104,F,95,12,9,153,49,Well
18,9,225,M,72,10,4,124,-101,Severe
8,5,101,M,90,12,3,147,46,Well
16,0,192,F,13,5,9,69,-123,Severe
14,9,177,M,80,11,3,135,-42,Severe
14,9,177,F,55,8,8,104,-73,Severe
17,1,205,F,102,13,6,162,-43,Severe
15,8,188,F,69,10,1,121,-67,Severe
16,11,203,F,77,10,11,131,-72,Severe
7,2,86,M,96,12,10,154,68,Well
17,4,208,F,20,6,2,74,-134,Severe
14,10,178,F,21,6,2,74,-104,Severe
16,11,203,F,103,13,6,162,-41,Severe
5,3,63,M,90,12,3,147,84,Well
16,5,197,M,56,8,9,105,-92,Severe
14,3,171,F,48,8,1,97,-74,Severe
7,8,92,F,4,5,4,64,-28,Severe
13,0,156,M,50,8,3,99,-57,Severe
14,3,171,F,106,13,10,166,-5,Mild
17,6,210,F,27,6,7,79,-131,Severe
12,7,151,M,51,8,4,100,-51,Severe
8,9,105,M,33,6,11,83,-22,Severe
14,7,175,F,82,11,5,137,-38,Severe
8,1,97,F,78,11,0,132,35,Well
5,9,69,M,85,11,9,141,72,Well
12,0,144,M,67,9,10,118,-26,Severe
6,1,73,F,106,13,10,166,93,Well
18,10,226,M,5,5,5,65,-161,Severe
16,7,199,M,10,5,7,67,-132,Severe
15,3,183,M,43,7,8,92,-91,Severe
9,2,110,M,73,10,6,126,16,Well
6,3,75,F,15,5,11,71,-4,Mild
15,3,183,M,86,11,10,142,-41,Severe
5,4,64,M,88,12,0,144,80,Well
5,9,69,M,37,7,3,87,18,Well
16,1,193,M,11,5,8,68,-125,Severe
5,4,64,M,20,6,2,74,10,Well
11,3,135,F,76,10,10,130,-5,Mild
15,10,190,M,98,13,0,156,-34,Severe
15,9,189,M,47,8,0,96,-93,Severe
5,3,63,F,49,8,2,98,35,Well
15,3,183,F,57,8,10,106,-77,Severe
16,6,198,F,35,7,1,85,-113,Severe
9,7,115,M,65,9,8,116,1,Good
16,8,200,M,98,13,0,156,-44,Severe
14,9,177,M,84,11,7,139,-38,Severe
12,6,150,M,2,5,3,63,-87,Severe
16,9,201,F,62,9,4,112,-89,Severe
10,1,121,M,90,12,3,147,26,Well
8,0,96,F,87,11,11,143,47,Well
12,6,150,M,47,8,0,96,-54,Severe
18,10,226,M,101,13,4,160,-66,Severe
12,11,155,M,95,12,9,153,-2,Mild
12,0,144,F,73,10,6,126,-18,Severe
11,9,141,F,110,14,3,171,30,Well
14,9,177,M,67,9,10,118,-59,Severe
8,2,98,M,41,7,6,90,-8,Severe
16,9,201,F,3,5,3,63,-138,Severe
14,5,173,F,21,6,2,74,-99,Severe
7,11,95,M,102,13,6,162,67,Well
18,3,219,M,25,6,5,77,-142,Severe
12,3,147,M,98,13,0,156,9,Well
9,3,111,M,61,9,3,111,0,Neutral
6,4,76,M,100,13,3,159,83,Well
9,7,115,M,20,6,2,74,-41,Severe
18,1,217,M,70,10,2,122,-95,Severe
17,8,212,F,70,10,2,122,-90,Severe
16,0,192,M,29,6,8,80,-112,Severe
6,1,73,F,13,5,9,69,-4,Mild
9,10,118,M,41,7,6,90,-28,Severe
6,11,83,M,99,13,1,157,74,Well
6,11,83,F,96,12,10,154,71,Well
17,4,208,M,90,12,3,147,-61,Severe
6,4,76,M,7,5,6,66,-10,Severe
6,2,74,F,4,5,4,64,-10,Severe
6,5,77,F,36,7,2,86,9,Well
9,3,111,F,4,5,4,64,-47,Severe
11,3,135,F,25,6,5,77,-58,Severe
7,9,93,F,15,5,11,71,-22,Severe
15,0,180,F,105,13,9,165,-15,Severe
18,2,218,F,110,14,3,171,-47,Severe
15,3,183,F,92,12,5,149,-34,Severe
16,8,200,F,68,10,0,120,-80,Severe
16,3,195,M,39,7,5,89,-106,Severe
11,2,134,M,83,11,6,138,4,Good
18,9,225,F,95,12,9,153,-72,Severe
13,8,164,F,83,11,6,138,-26,Severe
12,3,147,F,35,7,1,85,-62,Severe
11,9,141,F,106,13,10,166,25,Well
13,5,161,M,16,5,11,71,-90,Severe
13,8,164,F,85,11,9,141,-23,Severe
11,10,142,F,109,14,1,169,27,Well
11,7,139,M,56,8,9,105,-34,Severe
15,1,181,F,9,5,7,67,-114,Severe
7,2,86,F,19,6,1,73,-13,Severe
6,7,79,M,15,5,11,71,-8,Severe
16,0,192,M,56,8,9,105,-87,Severe
16,3,195,M,23,6,4,76,-119,Severe
10,1,121,F,34,7,0,84,-37,Severe
17,10,214,M,14,5,10,70,-144,Severe
17,1,205,M,52,8,5,101,-104,Severe
10,1,121,F,97,12,11,155,34,Well
5,10,70,F,55,8,8,104,34,Well
13,3,159,M,12,5,9,69,-90,Severe
14,2,170,M,54,8,7,103,-67,Severe
17,3,207,M,51,8,4,100,-107,Severe
11,0,132,F,81,11,4,136,4,Good
15,11,191,F,105,13,9,165,-26,Severe
9,1,109,M,107,13,11,167,58,Well
7,5,89,M,63,9,6,114,25,Well
13,4,160,F,21,6,2,74,-86,Severe
12,1,145,M,96,12,10,154,9,Well
18,3,219,M,88,12,0,144,-75,Severe
10,2,122,F,45,7,10,94,-28,Severe
5,8,68,F,9,5,7,67,-1,Mild
9,3,111,M,62,9,4,112,1,Good
11,10,142,M,56,8,9,105,-37,Severe
8,2,98,F,110,14,3,171,73,Well
9,11,119,F,29,6,8,80,-39,Severe
9,2,110,M,7,5,6,66,-44,Severe
12,9,153,M,61,9,3,111,-42,Severe
15,3,183,M,103,13,6,162,-21,Severe
15,1,181,M,31,6,9,81,-100,Severe
14,7,175,F,64,9,7,115,-60,Severe
7,10,94,M,93,12,6,150,56,Well
17,3,207,F,107,13,11,167,-40,Severe
15,4,184,F,44,7,9,93,-91,Severe
10,3,123,M,48,8,1,97,-26,Severe
10,3,123,F,99,13,1,157,34,Well
12,11,155,F,68,10,0,120,-35,Severe
7,10,94,F,60,9,2,110,16,Well
6,7,79,M,30,6,9,81,2,Good
17,6,210,M,87,11,11,143,-67,Severe
17,5,209,F,5,5,5,65,-144,Severe
9,11,119,M,73,10,6,126,7,Well
12,3,147,F,73,10,6,126,-21,Severe
5,3,63,F,105,13,9,165,102,Well
7,9,93,M,50,8,3,99,6,Well
16,2,194,M,9,5,7,67,-127,Severe
14,11,179,F,35,7,1,85,-94,Severe
18,8,224,M,26,6,6,78,-146,Severe
15,1,181,F,90,12,3,147,-34,Severe
14,3,171,M,65,9,8,116,-55,Severe
15,6,186,M,27,6,7,79,-107,Severe
16,0,192,F,22,6,3,75,-117,Severe
9,9,117,M,79,11,1,133,16,Well
8,11,107,M,4,5,4,64,-43,Severe
8,1,97,F,2,5,3,63,-34,Severe
9,9,117,F,104,13,7,163,46,Well
18,6,222,M,84,11,7,139,-83,Severe
6,4,76,F,12,5,9,69,-7,Severe
6,4,76,M,109,14,1,169,93,Well
12,6,150,F,101,13,4,160,10,Well
13,3,159,F,41,7,6,90,-69,Severe
15,9,189,M,8,5,6,66,-123,Severe
13,1,157,F,32,6,10,82,-75,Severe
12,7,151,M,59,9,1,109,-42,Severe
16,2,194,F,19,6,1,73,-121,Severe
16,5,197,F,39,7,5,89,-108,Severe
15,4,184,M,87,11,11,143,-41,Severe
14,7,175,M,39,7,5,89,-86,Severe
10,3,123,M,102,13,6,162,39,Well
16,8,200,M,42,7,7,91,-109,Severe
5,8,68,M,2,5,3,63,-5,Mild
16,6,198,F,97,12,11,155,-43,Severe
6,7,79,F,67,9,10,118,39,Well
8,8,104,F,44,7,9,93,-11,Severe
17,10,214,M,12,5,9,69,-145,Severe
17,3,207,M,47,8,0,96,-111,Severe
14,4,172,F,38,7,4,88,-84,Severe
17,1,205,M,5,5,5,65,-140,Severe
7,10,94,F,100,13,3,159,65,Well
13,3,159,F,87,11,11,143,-16,Severe
10,5,125,F,26,6,6,78,-47,Severe
6,6,78,F,78,11,0,132,54,Well
15,2,182,M,73,10,6,126,-56,Severe
9,3,111,M,70,10,2,122,11,Well
10,6,126,M,108,14,0,168,42,Well
10,7,127,F,96,12,10,154,27,Well
11,9,141,M,16,5,11,71,-70,Severe
5,2,62,M,81,11,4,136,74,Well
15,1,181,M,80,11,3,135,-46,Severe
18,10,226,F,9,5,7,67,-159,Severe
6,3,75,M,13,5,9,69,-6,Severe
7,3,87,F,52,8,5,101,14,Well
17,1,205,F,67,9,10,118,-87,Severe
16,6,198,M,16,5,11,71,-127,Severe
13,3,159,M,27,6,7,79,-80,Severe
17,3,207,F,29,6,8,80,-127,Severe
5,10,70,F,34,7,0,84,14,Well
11,3,135,M,28,6,8,80,-55,Severe
10,11,131,M,41,7,6,90,-41,Severe
15,3,183,M,51,8,4,100,-83,Severe
7,9,93,M,65,9,8,116,23,Well
12,3,147,M,16,5,11,71,-76,Severe
14,4,172,F,64,9,7,115,-57,Severe
8,6,102,M,18,6,1,73,-29,Severe
17,4,208,F,63,9,6,114,-94,Severe
13,3,159,M,48,8,1,97,-62,Severe
12,3,147,F,97,12,11,155,8,Well
13,11,167,M,7,5,6,66,-101,Severe
12,7,151,F,11,5,8,68,-83,Severe
13,4,160,M,13,5,9,69,-91,Severe
11,11,143,M,97,12,11,155,12,Well
16,3,195,M,28,6,8,80,-115,Severe
10,1,121,M,73,10,6,126,5,Good
10,6,126,M,73,10,6,126,0,Neutral
5,11,71,F,70,10,2,122,51,Well
16,4,196,M,15,5,11,71,-125,Severe
12,8,152,F,101,13,4,160,8,Well
13,5,161,M,57,8,10,106,-55,Severe
11,11,143,F,52,8,5,101,-42,Severe
18,3,219,M,108,14,0,168,-51,Severe
6,3,75,F,60,9,2,110,35,Well
16,7,199,M,24,6,5,77,-122,Severe
16,7,199,F,87,11,11,143,-56,Severe
8,6,102,F,83,11,6,138,36,Well
8,5,101,F,66,9,9,117,16,Well
10,9,129,M,42,7,7,91,-38,Severe
16,4,196,F,3,5,3,63,-133,Severe
7,4,88,M,8,5,6,66,-22,Severe
17,3,207,F,49,8,2,98,-109,Severe
6,5,77,M,66,9,9,117,40,Well
16,9,201,F,70,10,2,122,-79,Severe
17,11,215,F,50,8,3,99,-116,Severe
18,6,222,M,30,6,9,81,-141,Severe
5,10,70,F,62,9,4,112,42,Well
7,0,84,M,45,7,10,94,10,Well
7,2,86,F,29,6,8,80,-6,Severe
8,2,98,F,16,5,11,71,-27,Severe
13,1,157,F,78,11,0,132,-25,Severe
6,4,76,M,64,9,7,115,39,Well
17,3,207,M,44,7,9,93,-114,Severe
14,2,170,F,22,6,3,75,-95,Severe
13,5,161,F,32,6,10,82,-79,Severe
17,11,215,M,67,9,10,118,-97,Severe
18,0,216,F,64,9,7,115,-101,Severe
9,3,111,M,21,6,2,74,-37,Severe
17,3,207,F,33,6,11,83,-124,Severe
15,0,180,F,32,6,10,82,-98,Severe
17,0,204,M,29,6,8,80,-124,Severe
5,7,67,F,75,10,9,129,62,Well
18,3,219,M,105,13,9,165,-54,Severe
7,3,87,M,47,8,0,96,9,Well
16,7,199,M,105,13,9,165,-34,Severe
14,6,174,F,78,11,0,132,-42,Severe
10,4,124,F,31,6,9,81,-43,Severe
8,7,103,M,94,12,7,151,48,Well
13,5,161,F,110,14,3,171,10,Well
6,4,76,M,44,7,9,93,17,Well
12,8,152,F,92,12,5,149,-3,Mild
17,8,212,F,66,9,9,117,-95,Severe
18,3,219,F,41,7,6,90,-129,Severe
13,6,162,M,76,10,10,130,-32,Severe
12,10,154,M,43,7,8,92,-62,Severe
17,7,211,F,92,12,5,149,-62,Severe
6,0,72,F,41,7,6,90,18,Well
16,0,192,M,65,9,8,116,-76,Severe
17,4,208,M,82,11,5,137,-71,Severe
17,2,206,F,45,7,10,94,-112,Severe
10,9,129,F,49,8,2,98,-31,Severe
11,4,136,F,100,13,3,159,23,Well
9,10,118,F,63,9,6,114,-4,Mild
10,6,126,M,50,8,3,99,-27,Severe
18,3,219,M,105,13,9,165,-54,Severe
18,2,218,F,22,6,3,75,-143,Severe
6,10,82,F,19,6,1,73,-9,Severe
9,0,108,M,59,9,1,109,1,Good
5,11,71,F,103,13,6,162,91,Well
18,5,221,M,102,13,6,162,-59,Severe
17,1,205,F,71,10,3,123,-82,Severe
17,6,210,M,32,6,10,82,-128,Severe
5,6,66,F,75,10,9,129,63,Well
16,11,203,F,14,5,10,70,-133,Severe
11,9,141,M,59,9,1,109,-32,Severe
9,3,111,M,87,11,11,143,32,Well
9,5,113,M,85,11,9,141,28,Well
13,9,165,M,29,6,8,80,-85,Severe
14,11,179,F,60,9,2,110,-69,Severe
6,10,82,F,62,9,4,112,30,Well
5,9,69,F,108,14,0,168,99,Well
13,3,159,F,58,9,0,108,-51,Severe
14,0,168,M,51,8,4,100,-68,Severe
11,9,141,M,89,12,1,145,4,Good
7,9,93,M,8,5,6,66,-27,Severe
6,3,75,F,77,10,11,131,56,Well
6,0,72,M,105,13,9,165,93,Well
10,8,128,M,17,6,0,72,-56,Severe
8,11,107,F,30,6,9,81,-26,Severe
8,2,98,F,26,6,6,78,-20,Severe
8,6,102,M,101,13,4,160,58,Well
12,5,149,M,51,8,4,100,-49,Severe
14,3,171,F,109,14,1,169,-2,Mild
12,5,149,M,49,8,2,98,-51,Severe
10,3,123,F,96,12,10,154,31,Well
5,11,71,M,21,6,2,74,3,Good
16,11,203,F,2,5,3,63,-140,Severe
17,6,210,F,100,13,3,159,-51,Severe
15,9,189,M,82,11,5,137,-52,Severe
13,11,167,M,6,5,5,65,-102,Severe
10,6,126,F,8,5,6,66,-60,Severe
9,11,119,M,27,6,7,79,-40,Severe
8,5,101,F,62,9,4,112,11,Well
13,3,159,F,97,12,11,155,-4,Mild
18,11,227,M,38,7,4,88,-139,Severe
7,9,93,F,47,8,0,96,3,Good
15,7,187,F,46,7,11,95,-92,Severe
13,7,163,M,72,10,4,124,-39,Severe
6,1,73,M,106,13,10,166,93,Well
15,7,187,M,49,8,2,98,-89,Severe
7,7,91,M,81,11,4,136,45,Well
10,0,120,M,96,12,10,154,34,Well
8,8,104,M,25,6,5,77,-27,Severe
10,7,127,M,61,9,3,111,-16,Severe
9,10,118,M,13,5,9,69,-49,Severe
5,9,69,F,24,6,5,77,8,Well
15,3,183,M,82,11,5,137,-46,Severe
11,9,141,F,76,10,10,130,-11,Severe
18,3,219,M,7,5,6,66,-153,Severe
13,7,163,F,87,11,11,143,-20,Severe
11,6,138,F,11,5,8,68,-70,Severe
17,1,205,M,45,7,10,94,-111,Severe
10,2,122,F,95,12,9,153,31,Well
9,8,116,M,98,13,0,156,40,Well
13,7,163,F,2,5,3,63,-100,Severe
6,1,73,M,7,5,6,66,-7,Severe
9,4,112,F,69,10,1,121,9,Well
5,10,70,M,17,6,0,72,2,Good
17,6,210,M,103,13,6,162,-48,Severe
7,4,88,F,74,10,7,127,39,Well
10,1,121,M,80,11,3,135,14,Well
17,1,205,F,91,12,4,148,-57,Severe
17,0,204,M,23,6,4,76,-128,Severe
6,11,83,F,48,8,1,97,14,Well
10,5,125,M,90,12,3,147,22,Well
11,8,140,F,20,6,2,74,-66,Severe
7,1,85,M,40,7,5,89,4,Good
16,2,194,F,74,10,7,127,-67,Severe
15,6,186,F,94,12,7,151,-35,Severe
10,9,129,F,25,6,5,77,-52,Severe
10,7,127,F,42,7,7,91,-36,Severe
11,4,136,M,36,7,2,86,-50,Severe
7,9,93,F,101,13,4,160,67,Well
13,1,157,F,41,7,6,90,-67,Severe
7,10,94,F,5,5,5,65,-29,Severe
7,10,94,M,45,7,10,94,0,Neutral
5,11,71,F,43,7,8,92,21,Well
18,2,218,F,74,10,7,127,-91,Severe
7,11,95,M,88,12,0,144,49,Well
11,5,137,M,26,6,6,78,-59,Severe
10,1,121,F,82,11,5,137,16,Well
11,10,142,F,100,13,3,159,17,Well
7,1,85,M,20,6,2,74,-11,Severe
6,7,79,M,110,14,3,171,92,Well
12,4,148,M,19,6,1,73,-75,Severe
16,4,196,F,49,8,2,98,-98,Severe
6,3,75,M,71,10,3,123,48,Well
12,1,145,F,12,5,9,69,-76,Severe
10,7,127,M,104,13,7,163,36,Well
10,10,130,M,11,5,8,68,-62,Severe
8,0,96,M,33,6,11,83,-13,Severe
12,8,152,M,110,14,3,171,19,Well
6,3,75,F,99,13,1,157,82,Well
16,10,202,F,68,10,0,120,-82,Severe
5,6,66,M,110,14,3,171,105,Well
7,6,90,F,62,9,4,112,22,Well
14,1,169,F,54,8,7,103,-66,Severe
6,1,73,F,91,12,4,148,75,Well
10,11,131,M,38,7,4,88,-43,Severe
17,10,214,M,2,5,3,63,-151,Severe
12,0,144,F,29,6,8,80,-64,Severe
15,6,186,F,106,13,10,166,-20,Severe
12,7,151,F,94,12,7,151,0,Neutral
10,8,128,F,64,9,7,115,-13,Severe
5,8,68,F,12,5,9,69,1,Good
8,10,106,F,53,8,6,102,-4,Mild
16,10,202,F,14,5,10,70,-132,Severe
12,5,149,F,18,6,1,73,-76,Severe
12,5,149,F,54,8,7,103,-46,Severe
12,2,146,F,68,10,0,120,-26,Severe
17,5,209,M,11,5,8,68,-141,Severe
8,3,99,M,94,12,7,151,52,Well
7,3,87,M,9,5,7,67,-20,Severe
12,0,144,M,26,6,6,78,-66,Severe
6,3,75,M,36,7,2,86,11,Well
10,7,127,M,17,6,0,72,-55,Severe
15,10,190,F,69,10,1,121,-69,Severe
14,9,177,M,17,6,0,72,-105,Severe
18,8,224,F,77,10,11,131,-93,Severe
13,3,159,F,36,7,2,86,-73,Severe
12,9,153,F,21,6,2,74,-79,Severe
10,11,131,M,30,6,9,81,-50,Severe
8,10,106,F,37,7,3,87,-19,Severe
12,5,149,F,73,10,6,126,-23,Severe
5,8,68,F,105,13,9,165,97,Well
17,11,215,F,6,5,5,65,-150,Severe
17,9,213,M,93,12,6,150,-63,Severe
7,4,88,F,105,13,9,165,77,Well
7,1,85,F,53,8,6,102,17,Well
5,2,62,F,14,5,10,70,8,Well
13,10,166,F,21,6,2,74,-92,Severe
5,9,69,F,85,11,9,141,72,Well
7,8,92,M,34,7,0,84,-8,Severe
6,0,72,F,61,9,3,111,39,Well
17,6,210,M,53,8,6,102,-108,Severe
18,4,220,F,85,11,9,141,-79,Severe
17,5,209,M,21,6,2,74,-135,Severe
7,1,85,F,42,7,7,91,6,Well
17,3,207,F,72,10,4,124,-83,Severe
18,1,217,M,51,8,4,100,-117,Severe
12,9,153,M,65,9,8,116,-37,Severe
9,5,113,M,18,6,1,73,-40,Severe
18,7,223,F,35,7,1,85,-138,Severe
17,7,211,F,91,12,4,148,-63,Severe
11,11,143,F,31,6,9,81,-62,Severe
13,3,159,M,59,9,1,109,-50,Severe
8,11,107,M,13,5,9,69,-38,Severe
13,7,163,M,23,6,4,76,-87,Severe
16,0,192,F,11,5,8,68,-124,Severe
15,5,185,M,2,5,3,63,-122,Severe
9,1,109,F,106,13,10,166,57,Well
13,5,161,F,34,7,0,84,-77,Severe
5,8,68,M,5,5,5,65,-3,Mild
8,9,105,F,4,5,4,64,-41,Severe
11,10,142,F,82,11,5,137,-5,Mild
7,7,91,M,65,9,8,116,25,Well
13,7,163,M,49,8,2,98,-65,Severe
17,3,207,F,75,10,9,129,-78,Severe
11,2,134,F,45,7,10,94,-40,Severe
18,3,219,M,23,6,4,76,-143,Severe
9,0,108,M,62,9,4,112,4,Good
10,2,122,F,32,6,10,82,-40,Severe
14,4,172,F,28,6,8,80,-92,Severe
18,3,219,M,75,10,9,129,-90,Severe
11,7,139,F,109,14,1,169,30,Well
7,8,92,F,5,5,5,65,-27,Severe
16,1,193,M,51,8,4,100,-93,Severe
9,4,112,F,98,13,0,156,44,Well
8,4,100,F,9,5,7,67,-33,Severe
10,9,129,M,61,9,3,111,-18,Severe
15,3,183,M,69,10,1,121,-62,Severe
15,10,190,M,10,5,7,67,-123,Severe
7,10,94,F,75,10,9,129,35,Well
5,6,66,M,48,8,1,97,31,Well
15,4,184,F,27,6,7,79,-105,Severe
13,6,162,M,78,11,0,132,-30,Severe
9,8,116,F,83,11,6,138,22,Well
5,8,68,F,100,13,3,159,91,Well
14,1,169,M,90,12,3,147,-22,Severe
8,6,102,F,84,11,7,139,37,Well
9,0,108,M,92,12,5,149,41,Well
7,7,91,F,108,14,0,168,77,Well
12,3,147,F,23,6,4,76,-71,Severe
10,1,121,M,19,6,1,73,-48,Severe
8,2,98,M,74,10,7,127,29,Well
10,1,121,F,3,5,3,63,-58,Severe
11,0,132,F,21,6,2,74,-58,Severe
14,4,172,M,96,12,10,154,-18,Severe
5,2,62,M,84,11,7,139,77,Well
7,1,85,M,65,9,8,116,31,Well
10,3,123,F,101,13,4,160,37,Well
6,3,75,F,46,7,11,95,20,Well
9,0,108,F,108,14,0,168,60,Well
11,11,143,F,72,10,4,124,-19,Severe
18,0,216,F,58,9,0,108,-108,Severe
8,3,99,F,74,10,7,127,28,Well
16,4,196,F,33,6,11,83,-113,Severe
14,3,171,M,87,11,11,143,-28,Severe
7,11,95,M,23,6,4,76,-19,Severe
12,0,144,M,53,8,6,102,-42,Severe
10,9,129,M,39,7,5,89,-40,Severe
18,1,217,M,68,10,0,120,-97,Severe
16,10,202,M,73,10,6,126,-76,Severe
13,3,159,M,83,11,6,138,-21,Severe
5,11,71,F,110,14,3,171,100,Well
9,8,116,M,5,5,5,65,-51,Severe
13,2,158,F,62,9,4,112,-46,Severe
17,4,208,M,72,10,4,124,-84,Severe
12,8,152,F,10,5,7,67,-85,Severe
8,11,107,F,16,5,11,71,-36,Severe
5,9,69,F,100,13,3,159,90,Well
13,3,159,F,52,8,5,101,-58,Severe
13,1,157,F,66,9,9,117,-40,Severe
13,0,156,M,54,8,7,103,-53,Severe
11,8,140,M,30,6,9,81,-59,Severe
8,8,104,M,102,13,6,162,58,Well
5,0,60,F,58,9,0,108,48,Well
5,3,63,M,79,11,1,133,70,Well
11,4,136,F,105,13,9,165,29,Well
8,0,96,F,66,9,9,117,21,Well
17,7,211,F,22,6,3,75,-136,Severe
13,0,156,F,75,10,9,129,-27,Severe
6,7,79,F,31,6,9,81,2,Good
17,5,209,F,97,12,11,155,-54,Severe
14,0,168,M,95,12,9,153,-15,Severe
16,2,194,F,102,13,6,162,-32,Severe
11,1,133,M,99,13,1,157,24,Well
9,9,117,M,81,11,4,136,19,Well
7,6,90,F,57,8,10,106,16,Well
13,6,162,F,86,11,10,142,-20,Severe
17,7,211,F,71,10,3,123,-88,Severe
6,6,78,F,15,5,11,71,-7,Severe
11,8,140,F,35,7,1,85,-55,Severe
18,2,218,M,12,5,9,69,-149,Severe
7,0,84,F,61,9,3,111,27,Well
9,4,112,M,42,7,7,91,-21,Severe
14,7,175,M,48,8,1,97,-78,Severe
5,7,67,F,78,11,0,132,65,Well
16,6,198,F,87,11,11,143,-55,Severe
18,3,219,F,53,8,6,102,-117,Severe
18,3,219,F,72,10,4,124,-95,Severe
5,3,63,M,75,10,9,129,66,Well
17,4,208,M,86,11,10,142,-66,Severe
11,7,139,F,73,10,6,126,-13,Severe
10,3,123,F,72,10,4,124,1,Good
16,2,194,M,25,6,5,77,-117,Severe
5,8,68,F,54,8,7,103,35,Well
15,10,190,F,70,10,2,122,-68,Severe
17,6,210,F,46,7,11,95,-115,Severe
10,1,121,F,39,7,5,89,-32,Severe
18,8,224,M,7,5,6,66,-158,Severe
7,6,90,F,33,6,11,83,-7,Severe
13,5,161,F,2,5,3,63,-98,Severe
7,0,84,F,29,6,8,80,-4,Mild
18,2,218,F,2,5,3,63,-155,Severe
9,4,112,M,21,6,2,74,-38,Severe
10,10,130,F,20,6,2,74,-56,Severe
14,7,175,M,33,6,11,83,-92,Severe
9,9,117,M,86,11,10,142,25,Well
9,9,117,M,4,5,4,64,-53,Severe
14,2,170,F,108,14,0,168,-2,Mild
17,5,209,M,60,9,2,110,-99,Severe
11,1,133,M,84,11,7,139,6,Well
9,8,116,F,52,8,5,101,-15,Severe
13,10,166,M,79,11,1,133,-33,Severe
14,7,175,F,109,14,1,169,-6,Severe
13,11,167,M,9,5,7,67,-100,Severe
17,5,209,F,82,11,5,137,-72,Severe
18,0,216,M,55,8,8,104,-112,Severe
5,1,61,F,103,13,6,162,101,Well
5,7,67,F,110,14,3,171,104,Well
8,3,99,M,2,5,3,63,-36,Severe
10,3,123,M,99,13,1,157,34,Well
8,2,98,F,106,13,10,166,68,Well
5,3,63,M,21,6,2,74,11,Well
16,0,192,F,25,6,5,77,-115,Severe
13,0,156,M,44,7,9,93,-63,Severe
13,10,166,F,18,6,1,73,-93,Severe
13,4,160,M,28,6,8,80,-80,Severe
18,4,220,F,14,5,10,70,-150,Severe
12,10,154,F,56,8,9,105,-49,Severe
10,9,129,F,35,7,1,85,-44,Severe
16,4,196,M,16,5,11,71,-125,Severe
15,3,183,M,57,8,10,106,-77,Severe
11,1,133,F,55,8,8,104,-29,Severe
7,1,85,F,71,10,3,123,38,Well
7,2,86,F,93,12,6,150,64,Well
10,1,121,M,103,13,6,162,41,Well
17,8,212,M,77,10,11,131,-81,Severe
9,2,110,M,28,6,8,80,-30,Severe
15,5,185,M,72,10,4,124,-61,Severe
16,9,201,F,106,13,10,166,-35,Severe
18,0,216,F,10,5,7,67,-149,Severe
9,3,111,M,29,6,8,80,-31,Severe
6,11,83,F,78,11,0,132,49,Well
11,10,142,F,91,12,4,148,6,Well
12,1,145,F,23,6,4,76,-69,Severe
11,11,143,M,62,9,4,112,-31,Severe
18,6,222,M,107,13,11,167,-55,Severe
10,5,125,M,20,6,2,74,-51,Severe
12,8,152,F,98,13,0,156,4,Good
10,5,125,F,65,9,8,116,-9,Severe
15,7,187,F,33,6,11,83,-104,Severe
9,3,111,F,31,6,9,81,-30,Severe
11,1,133,F,89,12,1,145,12,Well
6,3,75,M,94,12,7,151,76,Well
16,7,199,F,47,8,0,96,-103,Severe
17,3,207,F,53,8,6,102,-105,Severe
14,3,171,F,106,13,10,166,-5,Mild
12,2,146,F,55,8,8,104,-42,Severe
12,7,151,F,90,12,3,147,-4,Mild
8,3,99,M,57,8,10,106,7,Well
17,0,204,M,60,9,2,110,-94,Severe
10,1,121,F,41,7,6,90,-31,Severe
5,10,70,F,105,13,9,165,95,Well
5,9,69,F,35,7,1,85,16,Well
9,9,117,M,96,12,10,154,37,Well
8,2,98,M,40,7,5,89,-9,Severe
16,4,196,M,78,11,0,132,-64,Severe
6,4,76,M,98,13,0,156,80,Well
10,7,127,M,81,11,4,136,9,Well
15,11,191,M,98,13,0,156,-35,Severe
13,11,167,M,88,12,0,144,-23,Severe
10,7,127,F,72,10,4,124,-3,Mild
10,11,131,M,59,9,1,109,-22,Severe
5,8,68,F,68,10,0,120,52,Well
10,6,126,F,83,11,6,138,12,Well
13,8,164,M,110,14,3,171,7,Well
12,8,152,F,27,6,7,79,-73,Severe
11,9,141,M,74,10,7,127,-14,Severe
15,5,185,F,2,5,3,63,-122,Severe
8,0,96,M,7,5,6,66,-30,Severe
15,3,183,M,58,9,0,108,-75,Severe
11,4,136,F,98,13,0,156,20,Well
11,8,140,M,27,6,7,79,-61,Severe
16,8,200,M,75,10,9,129,-71,Severe
15,4,184,F,87,11,11,143,-41,Severe
18,10,226,F,21,6,2,74,-152,Severe
15,6,186,M,101,13,4,160,-26,Severe
12,1,145,F,6,5,5,65,-80,Severe
16,11,203,F,65,9,8,116,-87,Severe
10,11,131,M,90,12,3,147,16,Well
14,5,173,M,9,5,7,67,-106,Severe
15,10,190,M,88,12,0,144,-46,Severe
11,8,140,M,55,8,8,104,-36,Severe
6,6,78,F,70,10,2,122,44,Well
11,11,143,F,79,11,1,133,-10,Severe
18,7,223,M,42,7,7,91,-132,Severe
16,1,193,F,26,6,6,78,-115,Severe
6,10,82,M,103,13,6,162,80,Well
10,1,121,M,92,12,5,149,28,Well
12,8,152,M,106,13,10,166,14,Well
17,7,211,M,104,13,7,163,-48,Severe
5,4,64,M,96,12,10,154,90,Well
18,1,217,F,15,5,11,71,-146,Severe
16,7,199,F,32,6,10,82,-117,Severe
9,9,117,M,27,6,7,79,-38,Severe
14,4,172,F,36,7,2,86,-86,Severe
5,3,63,M,43,7,8,92,29,Well
11,4,136,M,61,9,3,111,-25,Severe
10,11,131,M,15,5,11,71,-60,Severe
5,6,66,M,51,8,4,100,34,Well
12,3,147,F,71,10,3,123,-24,Severe
8,10,106,F,3,5,3,63,-43,Severe
18,8,224,F,53,8,6,102,-122,Severe
10,2,122,M,53,8,6,102,-20,Severe
16,5,197,F,63,9,6,114,-83,Severe
16,5,197,M,63,9,6,114,-83,Severe
16,10,202,F,22,6,3,75,-127,Severe
6,1,73,M,77,10,11,131,58,Well
17,9,213,M,78,11,0,132,-81,Severe
6,6,78,F,107,13,11,167,89,Well
11,4,136,F,50,8,3,99,-37,Severe
11,8,140,M,8,5,6,66,-74,Severe
11,3,135,M,77,10,11,131,-4,Mild
16,9,201,M,31,6,9,81,-120,Severe
7,0,84,M,73,10,6,126,42,Well
17,6,210,F,103,13,6,162,-48,Severe
5,4,64,M,85,11,9,141,77,Well
11,9,141,F,26,6,6,78,-63,Severe
13,5,161,F,62,9,4,112,-49,Severe
17,0,204,F,110,14,3,171,-33,Severe
9,3,111,F,5,5,5,65,-46,Severe
6,11,83,M,85,11,9,141,58,Well
15,10,190,F,22,6,3,75,-115,Severe
10,7,127,M,54,8,7,103,-24,Severe
11,11,143,M,73,10,6,126,-17,Severe
14,8,176,M,76,10,10,130,-46,Severe
12,1,145,F,19,6,1,73,-72,Severe
17,3,207,M,16,5,11,71,-136,Severe
8,1,97,M,106,13,10,166,69,Well
14,6,174,M,25,6,5,77,-97,Severe
12,9,153,M,56,8,9,105,-48,Severe
14,6,174,F,77,10,11,131,-43,Severe
11,4,136,M,46,7,11,95,-41,Severe
16,10,202,M,91,12,4,148,-54,Severe
11,10,142,F,39,7,5,89,-53,Severe
5,11,71,F,95,12,9,153,82,Well
8,0,96,F,70,10,2,122,26,Well
11,2,134,F,18,6,1,73,-61,Severe
5,3,63,F,63,9,6,114,51,Well
14,1,169,F,75,10,9,129,-40,Severe
9,8,116,F,38,7,4,88,-28,Severe
14,4,172,F,27,6,7,79,-93,Severe
10,11,131,F,84,11,7,139,8,Well
7,3,87,M,55,8,8,104,17,Well
8,0,96,F,42,7,7,91,-5,Mild
5,5,65,F,49,8,2,98,33,Well
16,3,195,F,103,13,6,162,-33,Severe
18,2,218,F,52,8,5,101,-117,Severe
10,4,124,M,35,7,1,85,-39,Severe
9,6,114,M,52,8,5,101,-13,Severe
17,7,211,M,61,9,3,111,-100,Severe
18,0,216,F,95,12,9,153,-63,Severe
12,10,154,F,75,10,9,129,-25,Severe
7,2,86,F,58,9,0,108,22,Well
10,11,131,M,99,13,1,157,26,Well
13,8,164,F,75,10,9,129,-35,Severe
17,9,213,F,10,5,7,67,-146,Severe
7,3,87,F,73,10,6,126,39,Well
18,1,217,F,70,10,2,122,-95,Severe
11,4,136,F,77,10,11,131,-5,Mild
13,8,164,M,21,6,2,74,-90,Severe
6,5,77,F,33,6,11,83,6,Well
8,5,101,M,5,5,5,65,-36,Severe
13,7,163,F,100,13,3,159,-4,Mild
16,3,195,F,72,10,4,124,-71,Severe
13,5,161,F,65,9,8,116,-45,Severe
15,7,187,F,20,6,2,74,-113,Severe
8,0,96,M,98,13,0,156,60,Well
7,0,84,F,70,10,2,122,38,Well
11,4,136,M,17,6,0,72,-64,Severe
8,5,101,F,47,8,0,96,-5,Mild
5,11,71,F,75,10,9,129,58,Well
6,10,82,F,84,11,7,139,57,Well
13,1,157,F,81,11,4,136,-21,Severe
14,9,177,M,100,13,3,159,-18,Severe
13,3,159,F,91,12,4,148,-11,Severe
17,4,208,M,52,8,5,101,-107,Severe
13,2,158,F,4,5,4,64,-94,Severe
14,7,175,M,12,5,9,69,-106,Severe
15,0,180,F,93,12,6,150,-30,Severe
18,6,222,M,76,10,10,130,-92,Severe
10,0,120,F,78,11,0,132,12,Well
16,7,199,F,10,5,7,67,-132,Severe
17,11,215,M,92,12,5,149,-66,Severe
18,9,225,M,96,12,10,154,-71,Severe
13,6,162,M,99,13,1,157,-5,Mild
14,10,178,M,74,10,7,127,-51,Severe
15,8,188,M,77,10,11,131,-57,Severe
16,5,197,F,41,7,6,90,-107,Severe
13,11,167,F,55,8,8,104,-63,Severe
12,7,151,M,76,10,10,130,-21,Severe
10,8,128,M,95,12,9,153,25,Well
6,5,77,F,19,6,1,73,-4,Mild
8,0,96,M,73,10,6,126,30,Well
18,6,222,F,2,5,3,63,-159,Severe
7,5,89,M,27,6,7,79,-10,Severe
7,5,89,F,79,11,1,133,44,Well
14,11,179,F,96,12,10,154,-25,Severe
18,10,226,M,7,5,6,66,-160,Severe
9,10,118,M,36,7,2,86,-32,Severe
8,9,105,F,45,7,10,94,-11,Severe
17,11,215,F,15,5,11,71,-144,Severe
18,0,216,M,110,14,3,171,-45,Severe
13,3,159,M,101,13,4,160,1,Good
11,9,141,F,47,8,0,96,-45,Severe
5,6,66,F,37,7,3,87,21,Well
6,1,73,F,73,10,6,126,53,Well
15,6,186,F,26,6,6,78,-108,Severe
6,3,75,F,67,9,10,118,43,Well
10,0,120,M,94,12,7,151,31,Well
15,2,182,F,67,9,10,118,-64,Severe
11,6,138,F,5,5,5,65,-73,Severe
14,8,176,F,34,7,0,84,-92,Severe
6,1,73,F,51,8,4,100,27,Well
18,5,221,F,40,7,5,89,-132,Severe
12,3,147,M,57,8,10,106,-41,Severe
17,10,214,F,26,6,6,78,-136,Severe
17,3,207,F,54,8,7,103,-104,Severe
9,8,116,F,50,8,3,99,-17,Severe
13,11,167,F,2,5,3,63,-104,Severe
11,3,135,M,59,9,1,109,-26,Severe
15,6,186,F,46,7,11,95,-91,Severe
6,0,72,F,60,9,2,110,38,Well
7,8,92,F,9,5,7,67,-25,Severe
15,1,181,F,38,7,4,88,-93,Severe
11,4,136,M,83,11,6,138,2,Good
16,0,192,F,93,12,6,150,-42,Severe
9,0,108,M,56,8,9,105,-3,Mild
13,6,162,M,84,11,7,139,-23,Severe
8,7,103,F,31,6,9,81,-22,Severe
5,2,62,F,93,12,6,150,88,Well
11,0,132,F,80,11,3,135,3,Good
10,10,130,M,102,13,6,162,32,Well
14,4,172,F,83,11,6,138,-34,Severe
14,6,174,M,98,13,0,156,-18,Severe
6,7,79,M,72,10,4,124,45,Well
12,7,151,F,63,9,6,114,-37,Severe
8,4,100,F,11,5,8,68,-32,Severe
6,6,78,M,26,6,6,78,0,Neutral
7,3,87,M,9,5,7,67,-20,Severe
17,0,204,F,71,10,3,123,-81,Severe
10,3,123,F,80,11,3,135,12,Well
16,8,200,F,47,8,0,96,-104,Severe
17,7,211,F,69,10,1,121,-90,Severe
7,3,87,M,42,7,7,91,4,Good
10,6,126,M,18,6,1,73,-53,Severe
10,5,125,M,61,9,3,111,-14,Severe
7,1,85,F,73,10,6,126,41,Well
17,10,214,M,25,6,5,77,-137,Severe
10,6,126,M,11,5,8,68,-58,Severe
7,2,86,M,53,8,6,102,16,Well
13,2,158,M,108,14,0,168,10,Well
13,5,161,M,77,10,11,131,-30,Severe
18,0,216,F,23,6,4,76,-140,Severe
7,1,85,M,84,11,7,139,54,Well
14,3,171,M,95,12,9,153,-18,Severe
6,0,72,F,20,6,2,74,2,Good
8,3,99,F,73,10,6,126,27,Well
16,0,192,M,9,5,7,67,-125,Severe
15,2,182,F,47,8,0,96,-86,Severe
16,9,201,F,48,8,1,97,-104,Severe
15,11,191,M,74,10,7,127,-64,Severe
11,10,142,M,21,6,2,74,-68,Severe
16,0,192,F,5,5,5,65,-127,Severe
13,4,160,F,26,6,6,78,-82,Severe
5,1,61,M,89,12,1,145,84,Well
14,0,168,F,67,9,10,118,-50,Severe
6,9,81,F,32,6,10,82,1,Good
6,4,76,F,79,11,1,133,57,Well
6,5,77,F,68,10,0,120,43,Well
9,4,112,M,94,12,7,151,39,Well
8,5,101,F,17,6,0,72,-29,Severe
18,10,226,F,51,8,4,100,-126,Severe
14,3,171,F,20,6,2,74,-97,Severe
9,4,112,F,50,8,3,99,-13,Severe
6,11,83,M,51,8,4,100,17,Well
5,9,69,M,59,9,1,109,40,Well
12,6,150,M,65,9,8,116,-34,Severe
18,3,219,M,14,5,10,70,-149,Severe
18,2,218,F,67,9,10,118,-100,Severe
8,5,101,M,17,6,0,72,-29,Severe
12,3,147,M,35,7,1,85,-62,Severe
10,8,128,F,79,11,1,133,5,Good
16,3,195,F,49,8,2,98,-97,Severe
5,8,68,F,108,14,0,168,100,Well
11,9,141,F,82,11,5,137,-4,Mild
18,0,216,M,19,6,1,73,-143,Severe
14,7,175,M,71,10,3,123,-52,Severe
13,0,156,M,71,10,3,123,-33,Severe
11,3,135,F,82,11,5,137,2,Good
6,3,75,M,12,5,9,69,-6,Severe
5,6,66,F,109,14,1,169,103,Well
15,2,182,F,22,6,3,75,-107,Severe
10,9,129,M,23,6,4,76,-53,Severe
9,4,112,M,82,11,5,137,25,Well
17,5,209,M,49,8,2,98,-111,Severe
5,2,62,M,40,7,5,89,27,Well
6,3,75,F,66,9,9,117,42,Well
16,6,198,M,44,7,9,93,-105,Severe
9,5,113,F,34,7,0,84,-29,Severe
14,2,170,M,5,5,5,65,-105,Severe
6,3,75,F,105,13,9,165,90,Well
14,3,171,M,21,6,2,74,-97,Severe
16,4,196,M,82,11,5,137,-59,Severe
15,11,191,M,13,5,9,69,-122,Severe
8,2,98,F,44,7,9,93,-5,Mild
10,0,120,M,50,8,3,99,-21,Severe
16,11,203,M,85,11,9,141,-62,Severe
7,3,87,M,70,10,2,122,35,Well
5,0,60,M,106,13,10,166,106,Well
5,11,71,M,45,7,10,94,23,Well
14,0,168,F,93,12,6,150,-18,Severe
8,1,97,F,6,5,5,65,-32,Severe
5,3,63,F,19,6,1,73,10,Well
11,7,139,M,91,12,4,148,9,Well
9,4,112,M,44,7,9,93,-19,Severe
14,3,171,M,83,11,6,138,-33,Severe
13,3,159,F,39,7,5,89,-70,Severe
13,3,159,F,79,11,1,133,-26,Severe
16,2,194,M,32,6,10,82,-112,Severe
18,8,224,F,16,5,11,71,-153,Severe
7,10,94,F,33,6,11,83,-11,Severe
7,11,95,M,40,7,5,89,-6,Severe
18,1,217,F,102,13,6,162,-55,Severe
13,5,161,F,94,12,7,151,-10,Severe
14,2,170,M,78,11,0,132,-38,Severe
11,8,140,F,37,7,3,87,-53,Severe
18,8,224,M,2,5,3,63,-161,Severe
6,5,77,F,65,9,8,116,39,Well
9,3,111,F,65,9,8,116,5,Good
12,11,155,M,43,7,8,92,-63,Severe
5,10,70,M,19,6,1,73,3,Good
8,2,98,M,108,14,0,168,70,Well
7,3,87,F,86,11,10,142,55,Well
15,0,180,F,50,8,3,99,-81,Severe
8,8,104,M,74,10,7,127,23,Well
7,5,89,M,98,13,0,156,67,Well
15,6,186,M,79,11,1,133,-53,Severe
14,9,177,F,15,5,11,71,-106,Severe
18,4,220,M,96,12,10,154,-66,Severe
17,10,214,M,17,6,0,72,-142,Severe
13,0,156,F,87,11,11,143,-13,Severe
9,3,111,F,85,11,9,141,30,Well
12,3,147,M,13,5,9,69,-78,Severe
15,8,188,M,76,10,10,130,-58,Severe
7,2,86,F,94,12,7,151,65,Well
12,7,151,F,104,13,7,163,12,Well
8,3,99,F,85,11,9,141,42,Well
12,4,148,M,57,8,10,106,-42,Severe
17,7,211,F,9,5,7,67,-144,Severe
12,3,147,F,38,7,4,88,-59,Severe
6,3,75,M,34,7,0,84,9,Well
15,6,186,F,29,6,8,80,-106,Severe
14,6,174,F,25,6,5,77,-97,Severe
12,10,154,F,11,5,8,68,-86,Severe
18,6,222,M,32,6,10,82,-140,Severe
10,11,131,F,34,7,0,84,-47,Severe
10,3,123,F,13,5,9,69,-54,Severe
16,7,199,F,41,7,6,90,-109,Severe
7,1,85,M,59,9,1,109,24,Well
14,3,171,F,5,5,5,65,-106,Severe
7,8,92,M,19,6,1,73,-19,Severe
16,8,200,F,95,12,9,153,-47,Severe
11,1,133,F,13,5,9,69,-64,Severe
7,9,93,F,97,12,11,155,62,Well
13,0,156,M,101,13,4,160,4,Good
17,6,210,F,30,6,9,81,-129,Severe
5,10,70,F,8,5,6,66,-4,Mild
11,10,142,M,19,6,1,73,-69,Severe
6,5,77,F,67,9,10,118,41,Well
12,8,152,M,42,7,7,91,-61,Severe
5,10,70,M,44,7,9,93,23,Well
12,9,153,F,103,13,6,162,9,Well
16,3,195,F,10,5,7,67,-128,Severe
16,3,195,M,26,6,6,78,-117,Severe
16,11,203,M,16,5,11,71,-132,Severe
14,11,179,F,58,9,0,108,-71,Severe
18,7,223,F,40,7,5,89,-134,Severe
5,4,64,M,94,12,7,151,87,Well
5,7,67,M,53,8,6,102,35,Well
13,7,163,F,45,7,10,94,-69,Severe
13,6,162,M,66,9,9,117,-45,Severe
11,6,138,F,110,14,3,171,33,Well
8,10,106,F,49,8,2,98,-8,Severe
16,7,199,M,57,8,10,106,-93,Severe
14,0,168,M,53,8,6,102,-66,Severe
10,0,120,F,67,9,10,118,-2,Mild
11,3,135,M,76,10,10,130,-5,Mild
18,0,216,F,2,5,3,63,-153,Severe
17,7,211,M,25,6,5,77,-134,Severe
7,10,94,M,19,6,1,73,-21,Severe
8,6,102,F,86,11,10,142,40,Well
11,2,134,F,6,5,5,65,-69,Severe
11,6,138,F,21,6,2,74,-64,Severe
5,7,67,F,8,5,6,66,-1,Mild
14,4,172,M,32,6,10,82,-90,Severe
11,1,133,M,15,5,11,71,-62,Severe
15,8,188,F,100,13,3,159,-29,Severe
18,5,221,M,99,13,1,157,-64,Severe
7,0,84,M,60,9,2,110,26,Well
16,0,192,M,103,13,6,162,-30,Severe
7,0,84,F,96,12,10,154,70,Well
10,7,127,F,63,9,6,114,-13,Severe
17,9,213,M,10,5,7,67,-146,Severe
7,5,89,M,66,9,9,117,28,Well
9,2,110,M,85,11,9,141,31,Well
9,0,108,M,42,7,7,91,-17,Severe
18,11,227,F,71,10,3,123,-104,Severe
13,6,162,F,18,6,1,73,-89,Severe
18,7,223,M,16,5,11,71,-152,Severe
12,11,155,F,53,8,6,102,-53,Severe
17,8,212,M,14,5,10,70,-142,Severe
11,3,135,F,31,6,9,81,-54,Severe
13,10,166,F,38,7,4,88,-78,Severe
15,0,180,M,18,6,1,73,-107,Severe
11,3,135,M,26,6,6,78,-57,Severe
15,3,183,M,46,7,11,95,-88,Severe
14,6,174,M,107,13,11,167,-7,Severe
17,8,212,M,64,9,7,115,-97,Severe
7,9,93,F,9,5,7,67,-26,Severe
7,1,85,M,86,11,10,142,57,Well
13,11,167,M,102,13,6,162,-5,Mild
18,7,223,M,20,6,2,74,-149,Severe
17,5,209,F,25,6,5,77,-132,Severe
7,3,87,F,78,11,0,132,45,Well
6,5,77,M,83,11,6,138,61,Well
9,1,109,F,47,8,0,96,-13,Severe
16,6,198,F,67,9,10,118,-80,Severe
12,7,151,F,93,12,6,150,-1,Mild
7,8,92,F,90,12,3,147,55,Well
9,9,117,F,37,7,3,87,-30,Severe
5,2,62,M,91,12,4,148,86,Well
6,3,75,M,74,10,7,127,52,Well
5,9,69,M,78,11,0,132,63,Well
15,0,180,M,81,11,4,136,-44,Severe
8,3,99,F,29,6,8,80,-19,Severe
5,3,63,F,89,12,1,145,82,Well
13,9,165,F,92,12,5,149,-16,Severe
8,10,106,M,63,9,6,114,8,Well
18,6,222,F,89,12,1,145,-77,Severe
13,4,160,F,4,5,4,64,-96,Severe
8,3,99,F,37,7,3,87,-12,Severe
17,3,207,F,6,5,5,65,-142,Severe
18,2,218,F,24,6,5,77,-141,Severe
5,9,69,F,72,10,4,124,55,Well
8,7,103,M,43,7,8,92,-11,Severe
12,9,153,F,2,5,3,63,-90,Severe
11,3,135,F,59,9,1,109,-26,Severe
7,3,87,M,10,5,7,67,-20,Severe
14,5,173,F,78,11,0,132,-41,Severe
5,3,63,F,87,11,11,143,80,Well
15,11,191,F,78,11,0,132,-59,Severe
15,2,182,M,46,7,11,95,-87,Severe
17,6,210,F,80,11,3,135,-75,Severe
7,3,87,M,29,6,8,80,-7,Severe
9,10,118,M,86,11,10,142,24,Well
17,4,208,M,83,11,6,138,-70,Severe
11,3,135,M,92,12,5,149,14,Well
13,3,159,M,28,6,8,80,-79,Severe
18,2,218,F,64,9,7,115,-103,Severe
16,3,195,F,94,12,7,151,-44,Severe
5,4,64,F,39,7,5,89,25,Well
12,6,150,M,68,10,0,120,-30,Severe
9,10,118,F,52,8,5,101,-17,Severe
16,6,198,F,26,6,6,78,-120,Severe
9,3,111,M,109,14,1,169,58,Well
8,6,102,F,6,5,5,65,-37,Severe
15,9,189,M,69,10,1,121,-68,Severe
14,2,170,M,40,7,5,89,-81,Severe
10,11,131,M,88,12,0,144,13,Well
10,2,122,F,77,10,11,131,9,Well
12,4,148,F,45,7,10,94,-54,Severe
14,7,175,M,57,8,10,106,-69,Severe
16,11,203,M,83,11,6,138,-65,Severe
18,8,224,F,84,11,7,139,-85,Severe
16,8,200,M,80,11,3,135,-65,Severe
12,9,153,F,44,7,9,93,-60,Severe
18,6,222,M,106,13,10,166,-56,Severe
9,4,112,F,85,11,9,141,29,Well
12,0,144,M,91,12,4,148,4,Good
9,3,111,M,9,5,7,67,-44,Severe
12,6,150,F,43,7,8,92,-58,Severe
6,5,77,M,25,6,5,77,0,Neutral
14,9,177,M,40,7,5,89,-88,Severe
9,8,116,F,58,9,0,108,-8,Severe
12,6,150,F,5,5,5,65,-85,Severe
6,7,79,F,55,8,8,104,25,Well
14,3,171,M,63,9,6,114,-57,Severe
10,5,125,M,31,6,9,81,-44,Severe
15,3,183,F,78,11,0,132,-51,Severe
9,1,109,F,14,5,10,70,-39,Severe
15,5,185,M,97,12,11,155,-30,Severe
11,5,137,F,83,11,6,138,1,Good
5,10,70,M,81,11,4,136,66,Well
10,11,131,F,4,5,4,64,-67,Severe
13,11,167,F,32,6,10,82,-85,Severe
17,9,213,F,54,8,7,103,-110,Severe
5,3,63,M,76,10,10,130,67,Well
15,4,184,F,41,7,6,90,-94,Severe
13,7,163,F,31,6,9,81,-82,Severe
18,11,227,F,22,6,3,75,-152,Severe
17,10,214,M,15,5,11,71,-143,Severe
5,4,64,F,36,7,2,86,22,Well
10,5,125,F,83,11,6,138,13,Well
9,0,108,M,19,6,1,73,-35,Severe
18,6,222,F,40,7,5,89,-133,Severe
7,0,84,F,77,10,11,131,47,Well
8,3,99,F,92,12,5,149,50,Well
6,4,76,F,62,9,4,112,36,Well
14,8,176,F,35,7,1,85,-91,Severe
5,7,67,F,64,9,7,115,48,Well
11,5,137,M,72,10,4,124,-13,Severe
16,6,198,F,49,8,2,98,-100,Severe
12,10,154,M,14,5,10,70,-84,Severe
15,1,181,M,98,13,0,156,-25,Severe
6,9,81,M,63,9,6,114,33,Well
15,3,183,F,53,8,6,102,-81,Severe
13,11,167,F,12,5,9,69,-98,Severe
18,0,216,F,47,8,0,96,-120,Severe
9,0,108,M,63,9,6,114,6,Well
5,10,70,F,6,5,5,65,-5,Mild
18,3,219,F,45,7,10,94,-125,Severe
9,1,109,M,86,11,10,142,33,Well
11,0,132,M,39,7,5,89,-43,Severe
12,5,149,M,31,6,9,81,-68,Severe
10,10,130,F,14,5,10,70,-60,Severe
9,11,119,F,35,7,1,85,-34,Severe
8,4,100,F,82,11,5,137,37,Well
17,4,208,F,69,10,1,121,-87,Severe
14,7,175,M,92,12,5,149,-26,Severe
7,5,89,M,77,10,11,131,42,Well
13,9,165,F,90,12,3,147,-18,Severe
16,5,197,M,44,7,9,93,-104,Severe
13,3,159,M,66,9,9,117,-42,Severe
10,2,122,M,92,12,5,149,27,Well
16,3,195,F,57,8,10,106,-89,Severe
17,10,214,F,6,5,5,65,-149,Severe
12,2,146,F,25,6,5,77,-69,Severe
13,2,158,M,37,7,3,87,-71,Severe
11,9,141,F,6,5,5,65,-76,Severe
6,3,75,M,15,5,11,71,-4,Mild
7,5,89,F,10,5,7,67,-22,Severe
14,11,179,M,98,13,0,156,-23,Severe
7,8,92,F,66,9,9,117,25,Well
9,4,112,M,96,12,10,154,42,Well
10,2,122,F,76,10,10,130,8,Well
16,11,203,M,5,5,5,65,-138,Severe
5,8,68,F,24,6,5,77,9,Well
18,3,219,M,47,8,0,96,-123,Severe
10,0,120,M,67,9,10,118,-2,Mild
8,4,100,M,71,10,3,123,23,Well
17,7,211,M,17,6,0,72,-139,Severe
6,7,79,F,96,12,10,154,75,Well
17,7,211,F,78,11,0,132,-79,Severe
17,0,204,M,57,8,10,106,-98,Severe
18,0,216,F,41,7,6,90,-126,Severe
18,4,220,M,66,9,9,117,-103,Severe
6,3,75,F,35,7,1,85,10,Well
12,9,153,F,7,5,6,66,-87,Severe
5,10,70,M,86,11,10,142,72,Well
12,11,155,F,55,8,8,104,-51,Severe
5,0,60,F,71,10,3,123,63,Well
18,1,217,F,87,11,11,143,-74,Severe
13,7,163,F,10,5,7,67,-96,Severe
16,3,195,M,88,12,0,144,-51,Severe
16,9,201,F,24,6,5,77,-124,Severe
5,0,60,F,25,6,5,77,17,Well
13,2,158,F,63,9,6,114,-44,Severe
7,10,94,M,69,10,1,121,27,Well
18,4,220,F,35,7,1,85,-135,Severe
18,10,226,M,58,9,0,108,-118,Severe
17,9,213,F,52,8,5,101,-112,Severe
12,1,145,F,85,11,9,141,-4,Mild
14,7,175,F,3,5,3,63,-112,Severe
14,1,169,M,91,12,4,148,-21,Severe
12,7,151,M,39,7,5,89,-62,Severe
10,1,121,M,96,12,10,154,33,Well
6,11,83,M,90,12,3,147,64,Well
15,11,191,F,55,8,8,104,-87,Severe
9,0,108,M,14,5,10,70,-38,Severe
8,11,107,M,48,8,1,97,-10,Severe
14,5,173,M,52,8,5,101,-72,Severe
11,7,139,M,64,9,7,115,-24,Severe
17,4,208,F,25,6,5,77,-131,Severe
12,4,148,F,47,8,0,96,-52,Severe
17,8,212,M,73,10,6,126,-86,Severe
7,10,94,F,105,13,9,165,71,Well
8,4,100,M,19,6,1,73,-27,Severe
11,7,139,F,61,9,3,111,-28,Severe
10,3,123,M,82,11,5,137,14,Well
11,10,142,M,17,6,0,72,-70,Severe
17,6,210,M,107,13,11,167,-43,Severe
10,7,127,M,50,8,3,99,-28,Severe
8,10,106,M,18,6,1,73,-33,Severe
15,3,183,F,71,10,3,123,-60,Severe
17,4,208,M,110,14,3,171,-37,Severe
18,3,219,M,92,12,5,149,-70,Severe
11,7,139,F,90,12,3,147,8,Well
5,7,67,M,45,7,10,94,27,Well
8,10,106,F,99,13,1,157,51,Well
17,6,210,M,65,9,8,116,-94,Severe
14,1,169,F,2,5,3,63,-106,Severe
10,5,125,M,50,8,3,99,-26,Severe
7,5,89,M,24,6,5,77,-12,Severe
16,4,196,M,79,11,1,133,-63,Severe
12,0,144,F,43,7,8,92,-52,Severe
6,2,74,F,72,10,4,124,50,Well
9,6,114,M,93,12,6,150,36,Well
16,5,197,M,71,10,3,123,-74,Severe
13,5,161,M,100,13,3,159,-2,Mild
10,5,125,F,87,11,11,143,18,Well
13,7,163,M,17,6,0,72,-91,Severe
6,0,72,F,37,7,3,87,15,Well
14,6,174,M,36,7,2,86,-88,Severe
8,6,102,F,46,7,11,95,-7,Severe
10,3,123,F,50,8,3,99,-24,Severe
18,11,227,M,70,10,2,122,-105,Severe
9,3,111,M,80,11,3,135,24,Well
12,5,149,F,87,11,11,143,-6,Severe
9,11,119,F,53,8,6,102,-17,Severe
16,9,201,M,38,7,4,88,-113,Severe
10,1,121,F,20,6,2,74,-47,Severe
11,4,136,F,45,7,10,94,-42,Severe
12,1,145,M,102,13,6,162,17,Well
13,2,158,M,75,10,9,129,-29,Severe
15,3,183,M,94,12,7,151,-32,Severe
13,7,163,F,46,7,11,95,-68,Severe
5,3,63,F,6,5,5,65,2,Good
6,11,83,F,82,11,5,137,54,Well
16,7,199,F,17,6,0,72,-127,Severe
18,5,221,F,55,8,8,104,-117,Severe
8,1,97,M,65,9,8,116,19,Well
6,9,81,F,13,5,9,69,-12,Severe
15,1,181,F,53,8,6,102,-79,Severe
8,4,100,M,72,10,4,124,24,Well
6,6,78,M,53,8,6,102,24,Well
13,10,166,F,109,14,1,169,3,Good
9,6,114,M,68,10,0,120,6,Well
5,9,69,F,73,10,6,126,57,Well
10,0,120,F,66,9,9,117,-3,Mild
9,4,112,F,101,13,4,160,48,Well
8,0,96,M,48,8,1,97,1,Good
6,3,75,F,52,8,5,101,26,Well
11,4,136,F,23,6,4,76,-60,Severe
8,2,98,M,35,7,1,85,-13,Severe
9,0,108,F,105,13,9,165,57,Well
6,5,77,M,108,14,0,168,91,Well
8,3,99,F,89,12,1,145,46,Well
11,2,134,M,80,11,3,135,1,Good
13,10,166,F,5,5,5,65,-101,Severe
18,1,217,F,41,7,6,90,-127,Severe
5,11,71,F,56,8,9,105,34,Well
18,5,221,F,61,9,3,111,-110,Severe
17,3,207,F,8,5,6,66,-141,Severe
11,3,135,M,25,6,5,77,-58,Severe
18,8,224,F,109,14,1,169,-55,Severe
6,7,79,M,51,8,4,100,21,Well
5,1,61,F,48,8,1,97,36,Well
15,3,183,F,49,8,2,98,-85,Severe
11,1,133,M,63,9,6,114,-19,Severe
6,3,75,M,72,10,4,124,49,Well
11,5,137,M,96,12,10,154,17,Well
8,6,102,M,23,6,4,76,-26,Severe
17,10,214,M,95,12,9,153,-61,Severe
11,7,139,M,74,10,7,127,-12,Severe
13,0,156,F,44,7,9,93,-63,Severe
9,3,111,F,12,5,9,69,-42,Severe
8,11,107,F,107,13,11,167,60,Well
10,3,123,F,89,12,1,145,22,Well
6,9,81,F,42,7,7,91,10,Well
16,8,200,F,59,9,1,109,-91,Severe
7,11,95,F,82,11,5,137,42,Well
17,6,210,M,52,8,5,101,-109,Severe
5,5,65,M,58,9,0,108,43,Well
11,10,142,F,110,14,3,171,29,Well
9,0,108,M,30,6,9,81,-27,Severe
6,3,75,F,20,6,2,74,-1,Mild
5,11,71,F,28,6,8,80,9,Well
13,2,158,M,69,10,1,121,-37,Severe
15,8,188,M,8,5,6,66,-122,Severe
15,5,185,M,42,7,7,91,-94,Severe
13,1,157,M,70,10,2,122,-35,Severe
9,4,112,M,58,9,0,108,-4,Mild
18,4,220,F,42,7,7,91,-129,Severe
7,2,86,F,13,5,9,69,-17,Severe
18,3,219,F,87,11,11,143,-76,Severe
10,0,120,M,92,12,5,149,29,Well
10,3,123,F,47,8,0,96,-27,Severe
10,3,123,F,68,10,0,120,-3,Mild
9,5,113,M,72,10,4,124,11,Well
15,10,190,M,6,5,5,65,-125,Severe
9,3,111,F,69,10,1,121,10,Well
9,11,119,F,79,11,1,133,14,Well
18,3,219,F,28,6,8,80,-139,Severe
15,6,186,M,44,7,9,93,-93,Severe
5,3,63,M,41,7,6,90,27,Well
10,4,124,M,43,7,8,92,-32,Severe
5,6,66,M,22,6,3,75,9,Well
14,0,168,F,79,11,1,133,-35,Severe
7,4,88,F,106,13,10,166,78,Well
13,5,161,M,55,8,8,104,-57,Severe
12,9,153,F,40,7,5,89,-64,Severe
14,11,179,F,61,9,3,111,-68,Severe
5,4,64,F,81,11,4,136,72,Well
9,3,111,M,103,13,6,162,51,Well
17,9,213,M,71,10,3,123,-90,Severe
13,2,158,M,87,11,11,143,-15,Severe
8,3,99,M,101,13,4,160,61,Well
10,3,123,M,33,6,11,83,-40,Severe
14,7,175,F,94,12,7,151,-24,Severe
15,1,181,M,38,7,4,88,-93,Severe
18,10,226,F,99,13,1,157,-69,Severe
15,11,191,M,77,10,11,131,-60,Severe
10,6,126,M,41,7,6,90,-36,Severe
17,10,214,F,86,11,10,142,-72,Severe
16,9,201,M,72,10,4,124,-77,Severe
17,0,204,F,62,9,4,112,-92,Severe
16,3,195,F,45,7,10,94,-101,Severe
10,8,128,M,57,8,10,106,-22,Severe
8,9,105,F,109,14,1,169,64,Well
7,3,87,F,7,5,6,66,-21,Severe
16,6,198,M,4,5,4,64,-134,Severe
7,9,93,M,97,12,11,155,62,Well
17,3,207,M,74,10,7,127,-80,Severe
12,9,153,F,30,6,9,81,-72,Severe
17,2,206,M,13,5,9,69,-137,Severe
18,2,218,M,33,6,11,83,-135,Severe
14,7,175,F,106,13,10,166,-9,Severe
16,0,192,M,5,5,5,65,-127,Severe
6,10,82,M,34,7,0,84,2,Good
12,3,147,M,58,9,0,108,-39,Severe
9,8,116,M,38,7,4,88,-28,Severe
9,0,108,M,48,8,1,97,-11,Severe
5,7,67,M,104,13,7,163,96,Well
5,3,63,F,60,9,2,110,47,Well
13,2,158,F,91,12,4,148,-10,Severe
13,11,167,M,62,9,4,112,-55,Severe
6,2,74,M,25,6,5,77,3,Good
17,3,207,F,35,7,1,85,-122,Severe
18,3,219,M,61,9,3,111,-108,Severe
17,3,207,M,21,6,2,74,-133,Severe
10,8,128,M,9,5,7,67,-61,Severe
6,4,76,F,46,7,11,95,19,Well
11,11,143,F,46,7,11,95,-48,Severe
17,8,212,F,68,10,0,120,-92,Severe
18,3,219,F,101,13,4,160,-59,Severe
10,6,126,M,96,12,10,154,28,Well
6,1,73,F,15,5,11,71,-2,Mild
14,3,171,F,97,12,11,155,-16,Severe
9,6,114,M,16,5,11,71,-43,Severe
11,2,134,M,87,11,11,143,9,Well
13,4,160,F,79,11,1,133,-27,Severe
17,3,207,M,101,13,4,160,-47,Severe
9,8,116,F,19,6,1,73,-43,Severe
14,7,175,M,75,10,9,129,-46,Severe
7,4,88,M,36,7,2,86,-2,Mild
14,11,179,F,83,11,6,138,-41,Severe
12,5,149,M,14,5,10,70,-79,Severe
11,3,135,F,53,8,6,102,-33,Severe
11,1,133,M,31,6,9,81,-52,Severe
18,4,220,F,80,11,3,135,-85,Severe
10,0,120,F,23,6,4,76,-44,Severe
7,7,91,M,62,9,4,112,21,Well
16,4,196,M,27,6,7,79,-117,Severe
13,6,162,F,26,6,6,78,-84,Severe
8,11,107,F,105,13,9,165,58,Well
17,7,211,M,97,12,11,155,-56,Severe
15,1,181,F,7,5,6,66,-115,Severe
18,6,222,F,20,6,2,74,-148,Severe
13,7,163,F,80,11,3,135,-28,Severe
10,6,126,F,79,11,1,133,7,Well
6,0,72,F,92,12,5,149,77,Well
11,10,142,F,55,8,8,104,-38,Severe
15,10,190,M,30,6,9,81,-109,Severe
7,4,88,F,45,7,10,94,6,Well
8,7,103,M,20,6,2,74,-29,Severe
18,11,227,M,5,5,5,65,-162,Severe
11,5,137,F,7,5,6,66,-71,Severe
17,0,204,M,102,13,6,162,-42,Severe
14,8,176,M,60,9,2,110,-66,Severe
5,6,66,M,63,9,6,114,48,Well
16,1,193,F,95,12,9,153,-40,Severe
14,11,179,M,33,6,11,83,-96,Severe
9,1,109,F,48,8,1,97,-12,Severe
15,5,185,M,28,6,8,80,-105,Severe
8,6,102,M,34,7,0,84,-18,Severe
14,5,173,M,58,9,0,108,-65,Severe
5,3,63,F,31,6,9,81,18,Well
12,9,153,M,71,10,3,123,-30,Severe
17,11,215,F,90,12,3,147,-68,Severe
12,6,150,F,67,9,10,118,-32,Severe
8,11,107,M,107,13,11,167,60,Well
7,7,91,F,36,7,2,86,-5,Mild
13,0,156,M,86,11,10,142,-14,Severe
18,7,223,F,63,9,6,114,-109,Severe
18,3,219,F,68,10,0,120,-99,Severe
6,5,77,F,83,11,6,138,61,Well
11,10,142,M,69,10,1,121,-21,Severe
10,8,128,F,19,6,1,73,-55,Severe
14,8,176,M,13,5,9,69,-107,Severe
16,10,202,F,36,7,2,86,-116,Severe
7,3,87,M,8,5,6,66,-21,Severe
7,5,89,M,108,14,0,168,79,Well
11,8,140,M,4,5,4,64,-76,Severe
7,10,94,F,69,10,1,121,27,Well
14,1,169,M,93,12,6,150,-19,Severe
13,0,156,F,16,5,11,71,-85,Severe
15,8,188,M,93,12,6,150,-38,Severe
18,10,226,F,58,9,0,108,-118,Severe
6,7,79,M,32,6,10,82,3,Good
8,3,99,M,108,14,0,168,69,Well
17,3,207,M,88,12,0,144,-63,Severe
17,4,208,F,98,13,0,156,-52,Severe
17,6,210,F,31,6,9,81,-129,Severe
7,5,89,M,48,8,1,97,8,Well
16,4,196,F,4,5,4,64,-132,Severe
10,10,130,F,16,5,11,71,-59,Severe
13,7,163,M,106,13,10,166,3,Good
14,11,179,M,89,12,1,145,-34,Severe
7,4,88,F,89,12,1,145,57,Well
12,11,155,F,48,8,1,97,-58,Severe
6,8,80,M,67,9,10,118,38,Well
13,3,159,M,94,12,7,151,-8,Severe
13,3,159,M,106,13,10,166,7,Well
13,10,166,F,44,7,9,93,-73,Severe
18,8,224,M,10,5,7,67,-157,Severe
17,10,214,M,35,7,1,85,-129,Severe
10,1,121,M,57,8,10,106,-15,Severe
12,5,149,F,101,13,4,160,11,Well
18,3,219,F,14,5,10,70,-149,Severe
14,8,176,M,41,7,6,90,-86,Severe
18,7,223,M,94,12,7,151,-72,Severe
11,5,137,M,8,5,6,66,-71,Severe
5,1,61,M,96,12,10,154,93,Well
11,4,136,M,101,13,4,160,24,Well
16,3,195,M,96,12,10,154,-41,Severe
6,1,73,F,48,8,1,97,24,Well
14,10,178,M,24,6,5,77,-101,Severe
8,7,103,F,100,13,3,159,56,Well
8,6,102,F,101,13,4,160,58,Well
15,3,183,F,89,12,1,145,-38,Severe
7,11,95,M,78,11,0,132,37,Well
13,0,156,F,88,12,0,144,-12,Severe
5,3,63,M,23,6,4,76,13,Well
8,4,100,F,72,10,4,124,24,Well
14,10,178,M,82,11,5,137,-41,Severe
17,8,212,F,82,11,5,137,-75,Severe
10,5,125,F,101,13,4,160,35,Well
14,3,171,F,80,11,3,135,-36,Severe
10,6,126,F,94,12,7,151,25,Well
10,5,125,M,76,10,10,130,5,Good
10,7,127,M,66,9,9,117,-10,Severe
16,7,199,F,71,10,3,123,-76,Severe
12,4,148,F,34,7,0,84,-64,Severe
14,7,175,F,54,8,7,103,-72,Severe
12,7,151,F,72,10,4,124,-27,Severe
6,2,74,F,67,9,10,118,44,Well
7,2,86,M,109,14,1,169,83,Well
14,1,169,F,88,12,0,144,-25,Severe
16,6,198,F,15,5,11,71,-127,Severe
13,5,161,M,62,9,4,112,-49,Severe
8,11,107,M,60,9,2,110,3,Good
5,4,64,F,30,6,9,81,17,Well
17,3,207,M,99,13,1,157,-50,Severe
7,8,92,M,101,13,4,160,68,Well
16,5,197,F,26,6,6,78,-119,Severe
17,11,215,F,62,9,4,112,-103,Severe
15,4,184,F,107,13,11,167,-17,Severe
12,4,148,F,96,12,10,154,6,Well
15,11,191,M,15,5,11,71,-120,Severe
7,7,91,F,98,13,0,156,65,Well
13,2,158,F,93,12,6,150,-8,Severe
17,9,213,F,74,10,7,127,-86,Severe
14,7,175,F,17,6,0,72,-103,Severe
8,1,97,F,70,10,2,122,25,Well
12,11,155,M,23,6,4,76,-79,Severe
7,7,91,F,53,8,6,102,11,Well
15,10,190,M,99,13,1,157,-33,Severe
13,9,165,M,23,6,4,76,-89,Severe
17,0,204,F,77,10,11,131,-73,Severe
8,2,98,M,18,6,1,73,-25,Severe
6,9,81,M,42,7,7,91,10,Well
18,3,219,M,5,5,5,65,-154,Severe
16,9,201,M,25,6,5,77,-124,Severe
16,10,202,F,4,5,4,64,-138,Severe
8,4,100,M,59,9,1,109,9,Well
16,2,194,M,21,6,2,74,-120,Severe
9,9,117,F,108,14,0,168,51,Well
12,9,153,M,82,11,5,137,-16,Severe
10,11,131,F,105,13,9,165,34,Well
15,4,184,F,104,13,7,163,-21,Severe
17,6,210,F,87,11,11,143,-67,Severe
13,10,166,F,75,10,9,129,-37,Severe
10,9,129,F,90,12,3,147,18,Well
9,2,110,F,30,6,9,81,-29,Severe
8,0,96,F,25,6,5,77,-19,Severe
5,0,60,F,78,11,0,132,72,Well
6,3,75,F,21,6,2,74,-1,Mild
11,1,133,F,74,10,7,127,-6,Severe
18,3,219,F,74,10,7,127,-92,Severe
7,5,89,F,56,8,9,105,16,Well
13,8,164,M,56,8,9,105,-59,Severe
18,2,218,M,64,9,7,115,-103,Severe
18,5,221,M,69,10,1,121,-100,Severe
6,2,74,F,86,11,10,142,68,Well
9,0,108,F,52,8,5,101,-7,Severe
16,10,202,M,76,10,10,130,-72,Severe
5,4,64,F,110,14,3,171,107,Well
13,7,163,F,104,13,7,163,0,Neutral
9,8,116,F,14,5,10,70,-46,Severe
17,5,209,F,21,6,2,74,-135,Severe
14,5,173,M,46,7,11,95,-78,Severe
17,3,207,F,23,6,4,76,-131,Severe
10,9,129,F,78,11,0,132,3,Good
5,9,69,F,102,13,6,162,93,Well
16,5,197,F,75,10,9,129,-68,Severe
5,8,68,F,66,9,9,117,49,Well
13,0,156,M,25,6,5,77,-79,Severe
17,10,214,F,14,5,10,70,-144,Severe
9,9,117,F,12,5,9,69,-48,Severe
10,6,126,M,46,7,11,95,-31,Severe
17,9,213,F,109,14,1,169,-44,Severe
18,5,221,F,49,8,2,98,-123,Severe
11,6,138,F,72,10,4,124,-14,Severe
8,9,105,M,30,6,9,81,-24,Severe
7,9,93,F,102,13,6,162,69,Well
18,0,216,M,11,5,8,68,-148,Severe
16,11,203,F,32,6,10,82,-121,Severe
10,8,128,F,66,9,9,117,-11,Severe
7,3,87,M,87,11,11,143,56,Well
13,1,157,F,94,12,7,151,-6,Severe
13,8,164,F,24,6,5,77,-87,Severe
12,11,155,M,30,6,9,81,-74,Severe
8,3,99,M,103,13,6,162,63,Well
12,3,147,F,101,13,4,160,13,Well
17,1,205,M,91,12,4,148,-57,Severe
5,3,63,M,10,5,7,67,4,Good
6,6,78,M,12,5,9,69,-9,Severe
12,2,146,M,40,7,5,89,-57,Severe
9,2,110,M,37,7,3,87,-23,Severe
5,8,68,M,38,7,4,88,20,Well
13,8,164,F,102,13,6,162,-2,Mild
16,9,201,M,50,8,3,99,-102,Severe
9,7,115,M,89,12,1,145,30,Well
11,5,137,F,18,6,1,73,-64,Severe
15,8,188,M,97,12,11,155,-33,Severe
12,1,145,F,41,7,6,90,-55,Severe
13,7,163,F,61,9,3,111,-52,Severe
14,10,178,F,22,6,3,75,-103,Severe
7,7,91,F,75,10,9,129,38,Well
12,6,150,F,54,8,7,103,-47,Severe
16,10,202,F,35,7,1,85,-117,Severe
5,11,71,F,32,6,10,82,11,Well
9,6,114,F,47,8,0,96,-18,Severe
10,2,122,M,32,6,10,82,-40,Severe
12,5,149,M,87,11,11,143,-6,Severe
17,10,214,F,90,12,3,147,-67,Severe
12,3,147,M,25,6,5,77,-70,Severe
10,0,120,F,24,6,5,77,-43,Severe
5,10,70,F,41,7,6,90,20,Well
12,11,155,F,83,11,6,138,-17,Severe
18,1,217,F,95,12,9,153,-64,Severe
13,1,157,M,86,11,10,142,-15,Severe
14,10,178,M,97,12,11,155,-23,Severe
18,2,218,F,28,6,8,80,-138,Severe
18,5,221,F,41,7,6,90,-131,Severe
10,3,123,F,25,6,5,77,-46,Severe
17,9,213,M,23,6,4,76,-137,Severe
17,1,205,M,78,11,0,132,-73,Severe
8,5,101,F,98,13,0,156,55,Well
7,1,85,F,105,13,9,165,80,Well
14,4,172,F,74,10,7,127,-45,Severe
10,6,126,M,83,11,6,138,12,Well
6,7,79,M,25,6,5,77,-2,Mild
14,8,176,M,54,8,7,103,-73,Severe
9,4,112,M,110,14,3,171,59,Well
8,7,103,M,99,13,1,157,54,Well
10,2,122,F,3,5,3,63,-59,Severe
7,2,86,M,51,8,4,100,14,Well
5,1,61,M,6,5,5,65,4,Good
15,8,188,F,99,13,1,157,-31,Severe
10,9,129,M,89,12,1,145,16,Well
7,3,87,F,84,11,7,139,52,Well
6,4,76,M,102,13,6,162,86,Well
14,3,171,F,41,7,6,90,-81,Severe
14,3,171,F,26,6,6,78,-93,Severe
15,5,185,M,8,5,6,66,-119,Severe
15,7,187,F,14,5,10,70,-117,Severe
11,4,136,M,27,6,7,79,-57,Severe
17,2,206,M,52,8,5,101,-105,Severe
9,4,112,F,13,5,9,69,-43,Severe
16,4,196,F,98,13,0,156,-40,Severe
15,11,191,M,50,8,3,99,-92,Severe
9,3,111,M,6,5,5,65,-46,Severe
18,0,216,M,85,11,9,141,-75,Severe
13,1,157,F,49,8,2,98,-59,Severe
18,3,219,F,62,9,4,112,-107,Severe
15,4,184,M,68,10,0,120,-64,Severe
9,3,111,F,63,9,6,114,3,Good
6,10,82,F,91,12,4,148,66,Well
15,5,185,F,96,12,10,154,-31,Severe
13,4,160,M,12,5,9,69,-91,Severe
10,1,121,M,7,5,6,66,-55,Severe
10,10,130,M,4,5,4,64,-66,Severe
12,3,147,F,81,11,4,136,-11,Severe
8,10,106,F,54,8,7,103,-3,Mild
12,7,151,M,109,14,1,169,18,Well
13,11,167,F,70,10,2,122,-45,Severe
8,9,105,F,81,11,4,136,31,Well
7,3,87,M,80,11,3,135,48,Well
15,4,184,F,38,7,4,88,-96,Severe
14,6,174,M,39,7,5,89,-85,Severe
16,8,200,M,11,5,8,68,-132,Severe
11,0,132,M,96,12,10,154,22,Well
5,5,65,M,95,12,9,153,88,Well
12,4,148,F,29,6,8,80,-68,Severe
18,3,219,M,75,10,9,129,-90,Severe
15,11,191,F,8,5,6,66,-125,Severe
16,7,199,F,26,6,6,78,-121,Severe
10,2,122,F,88,12,0,144,22,Well
8,3,99,F,4,5,4,64,-35,Severe
6,3,75,M,61,9,3,111,36,Well
16,9,201,F,83,11,6,138,-63,Severe
15,8,188,F,16,5,11,71,-117,Severe
15,10,190,M,97,12,11,155,-35,Severe
6,3,75,F,45,7,10,94,19,Well
17,3,207,F,57,8,10,106,-101,Severe
5,9,69,M,86,11,10,142,73,Well
13,3,159,F,44,7,9,93,-66,Severe
6,2,74,F,90,12,3,147,73,Well
7,3,87,F,95,12,9,153,66,Well
13,6,162,M,19,6,1,73,-89,Severe
5,3,63,M,92,12,5,149,86,Well
10,2,122,F,6,5,5,65,-57,Severe
6,11,83,F,14,5,10,70,-13,Severe
17,3,207,F,101,13,4,160,-47,Severe
12,10,154,F,77,10,11,131,-23,Severe
14,4,172,M,23,6,4,76,-96,Severe
9,3,111,M,25,6,5,77,-34,Severe
16,0,192,F,73,10,6,126,-66,Severe
11,3,135,F,40,7,5,89,-46,Severe
17,6,210,F,35,7,1,85,-125,Severe
11,1,133,F,83,11,6,138,5,Good
7,11,95,M,89,12,1,145,50,Well
5,6,66,M,74,10,7,127,61,Well
14,3,171,M,44,7,9,93,-78,Severe
17,2,206,F,8,5,6,66,-140,Severe
7,1,85,F,81,11,4,136,51,Well
12,3,147,M,102,13,6,162,15,Well
15,6,186,M,21,6,2,74,-112,Severe
11,5,137,M,16,5,11,71,-66,Severe
12,3,147,M,31,6,9,81,-66,Severe
18,8,224,M,91,12,4,148,-76,Severe
10,10,130,F,6,5,5,65,-65,Severe
11,3,135,F,84,11,7,139,4,Good
9,11,119,F,94,12,7,151,32,Well
9,6,114,M,50,8,3,99,-15,Severe
7,7,91,M,8,5,6,66,-25,Severe
18,7,223,F,55,8,8,104,-119,Severe
5,6,66,F,78,11,0,132,66,Well
6,5,77,M,63,9,6,114,37,Well
11,7,139,F,57,8,10,106,-33,Severe
9,5,113,F,71,10,3,123,10,Well
8,9,105,M,44,7,9,93,-12,Severe
17,3,207,M,29,6,8,80,-127,Severe
8,5,101,F,107,13,11,167,66,Well
17,10,214,F,41,7,6,90,-124,Severe
7,4,88,M,71,10,3,123,35,Well
9,8,116,F,74,10,7,127,11,Well
9,4,112,M,36,7,2,86,-26,Severe
11,11,143,F,54,8,7,103,-40,Severe
5,1,61,F,30,6,9,81,20,Well
15,3,183,F,3,5,3,63,-120,Severe
6,10,82,M,10,5,7,67,-15,Severe
16,2,194,M,92,12,5,149,-45,Severe
11,0,132,F,63,9,6,114,-18,Severe
17,8,212,M,45,7,10,94,-118,Severe
14,10,178,M,29,6,8,80,-98,Severe
18,7,223,M,51,8,4,100,-123,Severe
7,3,87,M,33,6,11,83,-4,Mild
14,0,168,F,109,14,1,169,1,Good
9,10,118,F,35,7,1,85,-33,Severe
14,5,173,M,103,13,6,162,-11,Severe
6,1,73,F,80,11,3,135,62,Well
9,8,116,F,67,9,10,118,2,Good
7,0,84,M,68,10,0,120,36,Well
6,4,76,M,20,6,2,74,-2,Mild
12,10,154,M,45,7,10,94,-60,Severe
11,2,134,F,102,13,6,162,28,Well
12,0,144,M,66,9,9,117,-27,Severe
17,6,210,F,97,12,11,155,-55,Severe
10,3,123,F,77,10,11,131,8,Well
18,9,225,M,38,7,4,88,-137,Severe
7,7,91,F,22,6,3,75,-16,Severe
7,11,95,M,45,7,10,94,-1,Mild
18,8,224,M,11,5,8,68,-156,Severe
11,7,139,F,64,9,7,115,-24,Severe
8,3,99,F,27,6,7,79,-20,Severe
17,0,204,M,11,5,8,68,-136,Severe
18,3,219,M,59,9,1,109,-110,Severe
13,3,159,M,98,13,0,156,-3,Mild
17,6,210,M,50,8,3,99,-111,Severe
17,0,204,F,56,8,9,105,-99,Severe
7,9,93,M,55,8,8,104,11,Well
14,11,179,M,78,11,0,132,-47,Severe
16,11,203,F,80,11,3,135,-68,Severe
18,11,227,M,11,5,8,68,-159,Severe
12,1,145,F,87,11,11,143,-2,Mild
16,0,192,F,100,13,3,159,-33,Severe
17,2,206,F,41,7,6,90,-116,Severe
17,5,209,F,31,6,9,81,-128,Severe
8,3,99,F,45,7,10,94,-5,Mild
5,8,68,F,6,5,5,65,-3,Mild
9,0,108,F,94,12,7,151,43,Well
9,0,108,M,107,13,11,167,59,Well
16,3,195,F,82,11,5,137,-58,Severe
18,7,223,F,85,11,9,141,-82,Severe
15,3,183,M,58,9,0,108,-75,Severe
8,7,103,M,90,12,3,147,44,Well
12,5,149,F,104,13,7,163,14,Well
11,2,134,F,38,7,4,88,-46,Severe
10,10,130,F,5,5,5,65,-65,Severe
5,8,68,F,57,8,10,106,38,Well
5,0,60,F,27,6,7,79,19,Well
18,5,221,F,58,9,0,108,-113,Severe
13,0,156,M,60,9,2,110,-46,Severe
15,5,185,M,56,8,9,105,-80,Severe
7,3,87,M,13,5,9,69,-18,Severe
5,11,71,M,46,7,11,95,24,Well
16,6,198,F,45,7,10,94,-104,Severe
16,0,192,M,32,6,10,82,-110,Severe
8,8,104,F,16,5,11,71,-33,Severe
17,9,213,F,66,9,9,117,-96,Severe
16,6,198,F,3,5,3,63,-135,Severe
8,11,107,F,23,6,4,76,-31,Severe
18,6,222,F,28,6,8,80,-142,Severe
18,3,219,F,65,9,8,116,-103,Severe
8,2,98,M,34,7,0,84,-14,Severe
18,3,219,M,6,5,5,65,-154,Severe
6,0,72,M,42,7,7,91,19,Well
14,9,177,M,18,6,1,73,-104,Severe
10,3,123,M,39,7,5,89,-34,Severe
11,3,135,M,51,8,4,100,-35,Severe
5,10,70,M,2,5,3,63,-7,Severe
16,4,196,M,33,6,11,83,-113,Severe
17,1,205,F,87,11,11,143,-62,Severe
13,2,158,F,53,8,6,102,-56,Severe
7,0,84,F,80,11,3,135,51,Well
12,3,147,M,75,10,9,129,-18,Severe
14,1,169,F,87,11,11,143,-26,Severe
14,5,173,M,77,10,11,131,-42,Severe
7,3,87,F,36,7,2,86,-1,Mild
5,5,65,F,89,12,1,145,80,Well
18,7,223,M,7,5,6,66,-157,Severe
10,2,122,F,2,5,3,63,-59,Severe
10,6,126,F,25,6,5,77,-49,Severe
6,5,77,M,64,9,7,115,38,Well
10,3,123,M,68,10,0,120,-3,Mild
14,1,169,F,45,7,10,94,-75,Severe
9,3,111,M,32,6,10,82,-29,Severe
10,4,124,M,52,8,5,101,-23,Severe
10,4,124,F,52,8,5,101,-23,Severe
5,10,70,M,79,11,1,133,63,Well
13,11,167,F,24,6,5,77,-90,Severe
14,5,173,M,20,6,2,74,-99,Severe
17,2,206,F,75,10,9,129,-77,Severe
16,1,193,M,46,7,11,95,-98,Severe
15,5,185,M,18,6,1,73,-112,Severe
6,5,77,F,37,7,3,87,10,Well
16,10,202,M,94,12,7,151,-51,Severe
14,4,172,F,34,7,0,84,-88,Severe
15,6,186,F,30,6,9,81,-105,Severe
13,10,166,F,90,12,3,147,-19,Severe
13,4,160,F,69,10,1,121,-39,Severe
14,5,173,F,15,5,11,71,-102,Severe
13,3,159,M,32,6,10,82,-77,Severe
7,10,94,M,109,14,1,169,75,Well
17,2,206,M,84,11,7,139,-67,Severe
18,10,226,M,15,5,11,71,-155,Severe
17,11,215,F,19,6,1,73,-142,Severe
12,4,148,F,19,6,1,73,-75,Severe
13,11,167,F,68,10,0,120,-47,Severe
15,11,191,M,76,10,10,130,-61,Severe
9,2,110,M,80,11,3,135,25,Well
11,0,132,F,26,6,6,78,-54,Severe
9,7,115,M,13,5,9,69,-46,Severe
8,3,99,M,75,10,9,129,30,Well
15,1,181,M,43,7,8,92,-89,Severe
8,11,107,F,60,9,2,110,3,Good
12,7,151,M,100,13,3,159,8,Well
12,6,150,M,108,14,0,168,18,Well
6,2,74,F,42,7,7,91,17,Well
15,7,187,F,82,11,5,137,-50,Severe
15,3,183,F,65,9,8,116,-67,Severe
11,7,139,F,28,6,8,80,-59,Severe
15,3,183,F,30,6,9,81,-102,Severe
8,11,107,F,43,7,8,92,-15,Severe
18,0,216,F,12,5,9,69,-147,Severe
11,11,143,F,84,11,7,139,-4,Mild
17,11,215,F,82,11,5,137,-78,Severe
15,9,189,M,36,7,2,86,-103,Severe
17,1,205,M,94,12,7,151,-54,Severe
17,9,213,M,79,11,1,133,-80,Severe
7,4,88,M,49,8,2,98,10,Well
5,3,63,M,42,7,7,91,28,Well
18,4,220,M,71,10,3,123,-97,Severe
11,8,140,F,11,5,8,68,-72,Severe
10,3,123,F,98,13,0,156,33,Well
13,3,159,M,102,13,6,162,3,Good
13,7,163,M,108,14,0,168,5,Good
16,2,194,F,67,9,10,118,-76,Severe
16,0,192,F,90,12,3,147,-45,Severe
14,0,168,M,81,11,4,136,-32,Severe
10,5,125,F,70,10,2,122,-3,Mild
13,1,157,F,98,13,0,156,-1,Mild
14,11,179,F,48,8,1,97,-82,Severe
8,5,101,F,3,5,3,63,-38,Severe
11,6,138,F,45,7,10,94,-44,Severe
10,9,129,F,17,6,0,72,-57,Severe
5,11,71,M,73,10,6,126,55,Well
9,8,116,F,34,7,0,84,-32,Severe
18,6,222,F,90,12,3,147,-75,Severe
15,4,184,M,41,7,6,90,-94,Severe
5,8,68,M,44,7,9,93,25,Well
17,1,205,F,30,6,9,81,-124,Severe
15,9,189,F,90,12,3,147,-42,Severe
7,3,87,F,95,12,9,153,66,Well
5,1,61,M,30,6,9,81,20,Well
14,11,179,M,95,12,9,153,-26,Severe
17,11,215,M,105,13,9,165,-50,Severe
14,4,172,M,55,8,8,104,-68,Severe
11,9,141,M,91,12,4,148,7,Well
12,4,148,M,2,5,3,63,-85,Severe
9,2,110,F,2,5,3,63,-47,Severe
15,6,186,F,80,11,3,135,-51,Severe
10,1,121,M,68,10,0,120,-1,Mild
10,2,122,F,27,6,7,79,-43,Severe
10,8,128,F,69,10,1,121,-7,Severe
12,10,154,F,97,12,11,155,1,Good
12,3,147,F,97,12,11,155,8,Well
13,2,158,F,85,11,9,141,-17,Severe
5,9,69,F,95,12,9,153,84,Well
10,8,128,M,92,12,5,149,21,Well
17,8,212,M,75,10,9,129,-83,Severe
17,3,207,M,22,6,3,75,-132,Severe
13,6,162,M,80,11,3,135,-27,Severe
11,0,132,M,50,8,3,99,-33,Severe
5,4,64,M,4,5,4,64,0,Neutral
16,8,200,M,73,10,6,126,-74,Severe
6,9,81,F,18,6,1,73,-8,Severe
14,7,175,F,95,12,9,153,-22,Severe
16,7,199,M,39,7,5,89,-110,Severe
14,8,176,F,28,6,8,80,-96,Severe
8,6,102,F,9,5,7,67,-35,Severe
14,4,172,F,53,8,6,102,-70,Severe
7,4,88,M,59,9,1,109,21,Well
6,3,75,M,100,13,3,159,84,Well
7,5,89,F,33,6,11,83,-6,Severe
14,2,170,F,74,10,7,127,-43,Severe
13,10,166,F,63,9,6,114,-52,Severe
12,8,152,F,76,10,10,130,-22,Severe
11,0,132,M,28,6,8,80,-52,Severe
16,1,193,F,52,8,5,101,-92,Severe
8,1,97,F,81,11,4,136,39,Well
16,3,195,F,58,9,0,108,-87,Severe
6,6,78,F,88,12,0,144,66,Well
6,0,72,F,88,12,0,144,72,Well
6,3,75,F,32,6,10,82,7,Well
17,11,215,F,54,8,7,103,-112,Severe
18,8,224,F,89,12,1,145,-79,Severe
9,1,109,F,4,5,4,64,-45,Severe
17,4,208,F,93,12,6,150,-58,Severe
17,11,215,F,14,5,10,70,-145,Severe
16,10,202,F,39,7,5,89,-113,Severe
9,0,108,F,10,5,7,67,-41,Severe
7,8,92,F,37,7,3,87,-5,Mild
14,4,172,M,90,12,3,147,-25,Severe
8,9,105,M,66,9,9,117,12,Well
18,7,223,M,78,11,0,132,-91,Severe
16,4,196,F,88,12,0,144,-52,Severe
7,5,89,F,31,6,9,81,-8,Severe
5,0,60,F,91,12,4,148,88,Well
13,7,163,F,7,5,6,66,-97,Severe
11,3,135,F,87,11,11,143,8,Well
18,0,216,M,40,7,5,89,-127,Severe
7,9,93,F,38,7,4,88,-5,Mild
12,8,152,F,22,6,3,75,-77,Severe
10,7,127,F,10,5,7,67,-60,Severe
9,8,116,F,63,9,6,114,-2,Mild
11,9,141,M,17,6,0,72,-69,Severe
14,5,173,M,16,5,11,71,-102,Severe
12,1,145,F,86,11,10,142,-3,Mild
9,9,117,F,94,12,7,151,34,Well
10,10,130,M,12,5,9,69,-61,Severe
11,6,138,F,9,5,7,67,-71,Severe
11,11,143,M,48,8,1,97,-46,Severe
17,0,204,F,92,12,5,149,-55,Severe
11,11,143,M,83,11,6,138,-5,Mild
12,8,152,M,50,8,3,99,-53,Severe
7,9,93,M,106,13,10,166,73,Well
8,3,99,F,50,8,3,99,0,Neutral
17,2,206,M,5,5,5,65,-141,Severe
16,4,196,F,7,5,6,66,-130,Severe
6,0,72,F,107,13,11,167,95,Well
10,10,130,M,34,7,0,84,-46,Severe
5,6,66,F,17,6,0,72,6,Well
18,5,221,F,56,8,9,105,-116,Severe
8,0,96,M,94,12,7,151,55,Well
11,5,137,M,64,9,7,115,-22,Severe
18,1,217,M,89,12,1,145,-72,Severe
13,1,157,M,54,8,7,103,-54,Severe
18,3,219,F,54,8,7,103,-116,Severe
7,10,94,M,10,5,7,67,-27,Severe
16,5,197,M,29,6,8,80,-117,Severe
9,5,113,M,16,5,11,71,-42,Severe
17,3,207,M,53,8,6,102,-105,Severe
14,3,171,M,11,5,8,68,-103,Severe
13,3,159,F,13,5,9,69,-90,Severe
8,10,106,M,23,6,4,76,-30,Severe
17,6,210,F,54,8,7,103,-107,Severe
14,8,176,F,38,7,4,88,-88,Severe
10,3,123,F,76,10,10,130,7,Well
18,8,224,M,70,10,2,122,-102,Severe
8,1,97,M,73,10,6,126,29,Well
8,3,99,F,98,13,0,156,57,Well
13,0,156,F,2,5,3,63,-93,Severe
7,1,85,M,19,6,1,73,-12,Severe
17,5,209,F,109,14,1,169,-40,Severe
18,1,217,M,109,14,1,169,-48,Severe
8,3,99,M,77,10,11,131,32,Well
15,6,186,F,49,8,2,98,-88,Severe
14,0,168,M,96,12,10,154,-14,Severe
5,6,66,F,81,11,4,136,70,Well
15,4,184,M,48,8,1,97,-87,Severe
8,1,97,F,51,8,4,100,3,Good
7,0,84,F,9,5,7,67,-17,Severe
7,9,93,M,16,5,11,71,-22,Severe
5,10,70,M,105,13,9,165,95,Well
11,7,139,M,80,11,3,135,-4,Mild
12,4,148,F,67,9,10,118,-30,Severe
16,11,203,F,110,14,3,171,-32,Severe
11,5,137,M,5,5,5,65,-72,Severe
12,8,152,F,29,6,8,80,-72,Severe
12,8,152,F,16,5,11,71,-81,Severe
7,6,90,F,50,8,3,99,9,Well
16,8,200,F,5,5,5,65,-135,Severe
11,0,132,F,16,5,11,71,-61,Severe
18,8,224,M,30,6,9,81,-143,Severe
9,0,108,F,68,10,0,120,12,Well
5,3,63,M,62,9,4,112,49,Well
8,7,103,F,35,7,1,85,-18,Severe
12,1,145,F,46,7,11,95,-50,Severe
7,0,84,M,82,11,5,137,53,Well
6,4,76,M,110,14,3,171,95,Well
12,5,149,M,26,6,6,78,-71,Severe
18,6,222,F,22,6,3,75,-147,Severe
12,2,146,F,61,9,3,111,-35,Severe
17,11,215,M,5,5,5,65,-150,Severe
7,3,87,F,80,11,3,135,48,Well
15,3,183,M,51,8,4,100,-83,Severe
18,3,219,M,34,7,0,84,-135,Severe
9,7,115,F,106,13,10,166,51,Well
8,11,107,M,41,7,6,90,-17,Severe
11,11,143,M,8,5,6,66,-77,Severe
7,8,92,F,96,12,10,154,62,Well
13,7,163,F,35,7,1,85,-78,Severe
16,8,200,F,81,11,4,136,-64,Severe
8,2,98,M,13,5,9,69,-29,Severe
16,11,203,M,31,6,9,81,-122,Severe
7,6,90,M,110,14,3,171,81,Well
12,8,152,F,52,8,5,101,-51,Severe
14,5,173,M,48,8,1,97,-76,Severe
12,10,154,F,76,10,10,130,-24,Severe
12,2,146,M,73,10,6,126,-20,Severe
15,7,187,F,36,7,2,86,-101,Severe
7,2,86,F,23,6,4,76,-10,Severe
8,11,107,M,10,5,7,67,-40,Severe
8,1,97,M,50,8,3,99,2,Good
6,3,75,F,51,8,4,100,25,Well
6,5,77,M,22,6,3,75,-2,Mild
13,6,162,F,27,6,7,79,-83,Severe
6,4,76,M,78,11,0,132,56,Well
18,2,218,F,35,7,1,85,-133,Severe
12,0,144,M,84,11,7,139,-5,Mild
13,2,158,M,33,6,11,83,-75,Severe
6,6,78,F,39,7,5,89,11,Well
5,6,66,F,83,11,6,138,72,Well
14,3,171,M,66,9,9,117,-54,Severe
6,7,79,M,38,7,4,88,9,Well
13,9,165,F,101,13,4,160,-5,Mild
18,6,222,F,7,5,6,66,-156,Severe
5,0,60,M,66,9,9,117,57,Well
7,7,91,M,61,9,3,111,20,Well
14,11,179,F,76,10,10,130,-49,Severe
6,10,82,F,75,10,9,129,47,Well
18,6,222,M,80,11,3,135,-87,Severe
5,10,70,M,9,5,7,67,-3,Mild
13,6,162,F,80,11,3,135,-27,Severe
16,11,203,F,63,9,6,114,-89,Severe
15,4,184,M,32,6,10,82,-102,Severe
6,7,79,M,41,7,6,90,11,Well
7,8,92,M,27,6,7,79,-13,Severe
12,1,145,F,61,9,3,111,-34,Severe
18,9,225,M,67,9,10,118,-107,Severe
7,3,87,M,90,12,3,147,60,Well
7,4,88,M,103,13,6,162,74,Well
18,8,224,M,86,11,10,142,-82,Severe
10,8,128,F,87,11,11,143,15,Well
13,3,159,F,71,10,3,123,-36,Severe
8,0,96,F,9,5,7,67,-29,Severe
10,11,131,M,16,5,11,71,-60,Severe
17,0,204,M,5,5,5,65,-139,Severe
10,4,124,M,106,13,10,166,42,Well
8,11,107,F,54,8,7,103,-4,Mild
11,2,134,F,59,9,1,109,-25,Severe
18,0,216,F,46,7,11,95,-121,Severe
12,9,153,M,76,10,10,130,-23,Severe
17,1,205,F,62,9,4,112,-93,Severe
11,11,143,F,100,13,3,159,16,Well
15,3,183,M,40,7,5,89,-94,Severe
12,11,155,M,73,10,6,126,-29,Severe
12,4,148,M,43,7,8,92,-56,Severe
10,3,123,M,80,11,3,135,12,Well
12,10,154,F,105,13,9,165,11,Well
6,4,76,M,73,10,6,126,50,Well
11,4,136,M,72,10,4,124,-12,Severe
13,0,156,F,49,8,2,98,-58,Severe
14,3,171,F,49,8,2,98,-73,Severe
8,7,103,M,97,12,11,155,52,Well
9,3,111,M,2,5,3,63,-48,Severe
15,7,187,F,60,9,2,110,-77,Severe
17,3,207,M,37,7,3,87,-120,Severe
11,7,139,F,24,6,5,77,-62,Severe
5,6,66,M,65,9,8,116,50,Well
6,11,83,M,81,11,4,136,53,Well
10,8,128,F,20,6,2,74,-54,Severe
12,10,154,F,46,7,11,95,-59,Severe
12,0,144,M,52,8,5,101,-43,Severe
8,3,99,F,85,11,9,141,42,Well
10,4,124,M,25,6,5,77,-47,Severe
17,4,208,F,42,7,7,91,-117,Severe
6,5,77,F,10,5,7,67,-10,Severe
13,9,165,M,65,9,8,116,-49,Severe
6,9,81,M,43,7,8,92,11,Well
11,2,134,F,54,8,7,103,-31,Severe
5,3,63,M,97,12,11,155,92,Well
12,1,145,M,87,11,11,143,-2,Mild
16,3,195,M,107,13,11,167,-28,Severe
14,4,172,F,21,6,2,74,-98,Severe
6,1,73,M,9,5,7,67,-6,Severe
17,11,215,F,36,7,2,86,-129,Severe
15,3,183,F,86,11,10,142,-41,Severe
6,7,79,M,106,13,10,166,87,Well
17,8,212,M,102,13,6,162,-50,Severe
16,8,200,F,13,5,9,69,-131,Severe
7,0,84,F,45,7,10,94,10,Well
17,5,209,F,98,13,0,156,-53,Severe
9,6,114,F,25,6,5,77,-37,Severe
15,2,182,M,110,14,3,171,-11,Severe
8,0,96,F,110,14,3,171,75,Well
15,3,183,M,91,12,4,148,-35,Severe
12,11,155,F,28,6,8,80,-75,Severe
13,3,159,F,20,6,2,74,-85,Severe
5,5,65,M,26,6,6,78,13,Well
10,9,129,M,92,12,5,149,20,Well
12,4,148,F,9,5,7,67,-81,Severe
8,1,97,F,41,7,6,90,-7,Severe
14,6,174,M,28,6,8,80,-94,Severe
11,5,137,F,10,5,7,67,-70,Severe
15,2,182,M,78,11,0,132,-50,Severe
11,2,134,F,91,12,4,148,14,Well
10,9,129,F,110,14,3,171,42,Well
18,6,222,M,71,10,3,123,-99,Severe
5,2,62,M,66,9,9,117,55,Well
5,8,68,F,102,13,6,162,94,Well
5,10,70,F,10,5,7,67,-3,Mild
13,0,156,F,76,10,10,130,-26,Severe
7,9,93,F,107,13,11,167,74,Well
15,3,183,M,37,7,3,87,-96,Severe
6,10,82,F,20,6,2,74,-8,Severe
15,10,190,F,42,7,7,91,-99,Severe
14,1,169,M,38,7,4,88,-81,Severe
16,3,195,M,27,6,7,79,-116,Severe
17,3,207,M,109,14,1,169,-38,Severe
17,2,206,F,53,8,6,102,-104,Severe
6,3,75,F,31,6,9,81,6,Well
11,7,139,M,79,11,1,133,-6,Severe
16,2,194,M,60,9,2,110,-84,Severe
8,5,101,F,35,7,1,85,-16,Severe
13,1,157,F,65,9,8,116,-41,Severe
9,5,113,M,2,5,3,63,-50,Severe
18,10,226,M,53,8,6,102,-124,Severe
6,0,72,M,24,6,5,77,5,Good
5,9,69,M,20,6,2,74,5,Good
16,7,199,M,62,9,4,112,-87,Severe
11,9,141,M,18,6,1,73,-68,Severe
11,3,135,F,71,10,3,123,-12,Severe
15,5,185,M,40,7,5,89,-96,Severe
7,5,89,M,6,5,5,65,-24,Severe
18,2,218,M,68,10,0,120,-98,Severe
11,6,138,M,58,9,0,108,-30,Severe
9,5,113,F,24,6,5,77,-36,Severe
6,11,83,F,52,8,5,101,18,Well
9,3,111,F,15,5,11,71,-40,Severe
17,1,205,M,110,14,3,171,-34,Severe
8,4,100,M,95,12,9,153,53,Well
12,1,145,F,21,6,2,74,-71,Severe
12,8,152,F,109,14,1,169,17,Well
15,8,188,F,95,12,9,153,-35,Severe
17,10,214,M,89,12,1,145,-69,Severe
6,1,73,F,17,6,0,72,-1,Mild
5,8,68,M,14,5,10,70,2,Good
13,4,160,F,73,10,6,126,-34,Severe
11,0,132,M,43,7,8,92,-40,Severe
15,7,187,M,91,12,4,148,-39,Severe
6,1,73,F,21,6,2,74,1,Good
18,9,225,M,105,13,9,165,-60,Severe
18,3,219,M,89,12,1,145,-74,Severe
18,8,224,F,64,9,7,115,-109,Severe
16,6,198,F,19,6,1,73,-125,Severe
16,2,194,F,35,7,1,85,-109,Severe
18,4,220,F,53,8,6,102,-118,Severe
7,3,87,F,96,12,10,154,67,Well
11,10,142,F,87,11,11,143,1,Good
13,7,163,M,42,7,7,91,-72,Severe
8,6,102,F,105,13,9,165,63,Well
12,2,146,F,19,6,1,73,-73,Severe
14,6,174,M,20,6,2,74,-100,Severe
9,2,110,M,30,6,9,81,-29,Severe
6,6,78,F,46,7,11,95,17,Well
15,8,188,F,56,8,9,105,-83,Severe
11,1,133,M,108,14,0,168,35,Well
7,2,86,M,19,6,1,73,-13,Severe
16,10,202,M,36,7,2,86,-116,Severe
5,6,66,F,29,6,8,80,14,Well
15,6,186,M,40,7,5,89,-97,Severe
11,11,143,F,106,13,10,166,23,Well
16,0,192,F,67,9,10,118,-74,Severe
11,0,132,M,31,6,9,81,-51,Severe
17,2,206,M,41,7,6,90,-116,Severe
9,6,114,M,71,10,3,123,9,Well
11,2,134,M,56,8,9,105,-29,Severe
7,7,91,F,97,12,11,155,64,Well
17,11,215,M,104,13,7,163,-52,Severe
10,2,122,F,23,6,4,76,-46,Severe
14,3,171,F,73,10,6,126,-45,Severe
14,3,171,F,36,7,2,86,-85,Severe
17,3,207,M,72,10,4,124,-83,Severe
14,7,175,M,66,9,9,117,-58,Severe
16,0,192,M,16,5,11,71,-121,Severe
9,9,117,F,11,5,8,68,-49,Severe
18,9,225,F,26,6,6,78,-147,Severe
8,3,99,F,14,5,10,70,-29,Severe
16,2,194,F,21,6,2,74,-120,Severe
5,3,63,M,10,5,7,67,4,Good
16,11,203,M,98,13,0,156,-47,Severe
9,5,113,F,22,6,3,75,-38,Severe
11,3,135,M,79,11,1,133,-2,Mild
10,2,122,M,54,8,7,103,-19,Severe
16,5,197,M,30,6,9,81,-116,Severe
10,0,120,F,44,7,9,93,-27,Severe
11,7,139,M,92,12,5,149,10,Well
6,7,79,M,40,7,5,89,10,Well
8,9,105,F,2,5,3,63,-42,Severe
12,4,148,F,49,8,2,98,-50,Severe
14,11,179,M,2,5,3,63,-116,Severe
10,11,131,F,25,6,5,77,-54,Severe
14,6,174,M,31,6,9,81,-93,Severe
12,2,146,M,29,6,8,80,-66,Severe
16,1,193,M,47,8,0,96,-97,Severe
13,5,161,M,27,6,7,79,-82,Severe
8,3,99,F,15,5,11,71,-28,Severe
7,9,93,F,12,5,9,69,-24,Severe
17,3,207,M,27,6,7,79,-128,Severe
18,7,223,M,9,5,7,67,-156,Severe
16,3,195,M,29,6,8,80,-115,Severe
12,5,149,F,67,9,10,118,-31,Severe
15,0,180,M,89,12,1,145,-35,Severe
13,1,157,F,30,6,9,81,-76,Severe
18,11,227,M,33,6,11,83,-144,Severe
8,0,96,M,35,7,1,85,-11,Severe
5,3,63,F,78,11,0,132,69,Well
9,0,108,M,105,13,9,165,57,Well
12,5,149,M,99,13,1,157,8,Well
6,2,74,M,72,10,4,124,50,Well
13,0,156,M,95,12,9,153,-3,Mild
11,9,141,F,109,14,1,169,28,Well
10,2,122,F,106,13,10,166,44,Well
5,4,64,M,44,7,9,93,29,Well
7,3,87,M,13,5,9,69,-18,Severe
5,11,71,M,32,6,10,82,11,Well
8,5,101,M,110,14,3,171,70,Well
8,8,104,M,84,11,7,139,35,Well
11,11,143,F,32,6,10,82,-61,Severe
17,1,205,M,23,6,4,76,-129,Severe
5,6,66,M,105,13,9,165,99,Well
18,5,221,M,106,13,10,166,-55,Severe
18,3,219,M,98,13,0,156,-63,Severe
7,5,89,F,51,8,4,100,11,Well
16,11,203,M,82,11,5,137,-66,Severe
14,10,178,M,79,11,1,133,-45,Severe
18,8,224,F,35,7,1,85,-139,Severe
16,4,196,M,105,13,9,165,-31,Severe
9,1,109,F,39,7,5,89,-20,Severe
16,4,196,F,82,11,5,137,-59,Severe
11,10,142,M,95,12,9,153,11,Well
15,5,185,M,48,8,1,97,-88,Severe
12,0,144,F,3,5,3,63,-81,Severe
18,10,226,F,70,10,2,122,-104,Severe
13,8,164,M,95,12,9,153,-11,Severe
13,6,162,F,37,7,3,87,-75,Severe
17,4,208,M,39,7,5,89,-119,Severe
15,5,185,F,106,13,10,166,-19,Severe
18,7,223,M,11,5,8,68,-155,Severe
10,9,129,M,72,10,4,124,-5,Mild
18,11,227,F,44,7,9,93,-134,Severe
5,6,66,M,108,14,0,168,102,Well
10,3,123,M,5,5,5,65,-58,Severe
18,1,217,M,21,6,2,74,-143,Severe
16,7,199,M,19,6,1,73,-126,Severe
5,3,63,F,37,7,3,87,24,Well
9,3,111,M,101,13,4,160,49,Well
13,7,163,F,72,10,4,124,-39,Severe
9,6,114,F,42,7,7,91,-23,Severe
13,3,159,F,105,13,9,165,6,Well
8,5,101,M,3,5,3,63,-38,Severe
5,11,71,M,102,13,6,162,91,Well
12,8,152,F,12,5,9,69,-83,Severe
5,4,64,F,97,12,11,155,91,Well
9,9,117,F,36,7,2,86,-31,Severe
15,3,183,M,65,9,8,116,-67,Severe
17,5,209,M,67,9,10,118,-91,Severe
9,6,114,F,41,7,6,90,-24,Severe
17,7,211,M,23,6,4,76,-135,Severe
12,4,148,M,88,12,0,144,-4,Mild
14,3,171,M,105,13,9,165,-6,Severe
15,9,189,M,57,8,10,106,-83,Severe
17,6,210,M,66,9,9,117,-93,Severe
6,11,83,M,35,7,1,85,2,Good
7,9,93,M,70,10,2,122,29,Well
16,0,192,M,52,8,5,101,-91,Severe
13,3,159,F,94,12,7,151,-8,Severe
8,10,106,F,52,8,5,101,-5,Mild
11,6,138,M,86,11,10,142,4,Good
8,3,99,M,36,7,2,86,-13,Severe
8,4,100,F,109,14,1,169,69,Well
8,1,97,M,92,12,5,149,52,Well
12,5,149,M,46,7,11,95,-54,Severe
16,5,197,F,47,8,0,96,-101,Severe
18,7,223,M,60,9,2,110,-113,Severe
9,3,111,F,6,5,5,65,-46,Severe
16,3,195,M,15,5,11,71,-124,Severe
7,5,89,F,108,14,0,168,79,Well
7,0,84,F,13,5,9,69,-15,Severe
11,8,140,M,66,9,9,117,-23,Severe
18,0,216,F,107,13,11,167,-49,Severe
18,2,218,F,108,14,0,168,-50,Severe
7,6,90,F,49,8,2,98,8,Well
8,7,103,M,31,6,9,81,-22,Severe
18,6,222,F,47,8,0,96,-126,Severe
15,2,182,F,74,10,7,127,-55,Severe
8,4,100,M,63,9,6,114,14,Well
16,6,198,M,35,7,1,85,-113,Severe
17,7,211,F,50,8,3,99,-112,Severe
10,11,131,F,82,11,5,137,6,Well
18,2,218,M,26,6,6,78,-140,Severe
8,7,103,M,91,12,4,148,45,Well
15,2,182,F,50,8,3,99,-83,Severe
8,9,105,M,78,11,0,132,27,Well
18,6,222,F,29,6,8,80,-142,Severe
14,1,169,F,50,8,3,99,-70,Severe
17,10,214,M,65,9,8,116,-98,Severe
11,2,134,M,79,11,1,133,-1,Mild
16,10,202,F,89,12,1,145,-57,Severe
12,3,147,M,37,7,3,87,-60,Severe
10,4,124,F,7,5,6,66,-58,Severe
10,3,123,F,63,9,6,114,-9,Severe
13,7,163,M,25,6,5,77,-86,Severe
15,10,190,M,108,14,0,168,-22,Severe
15,8,188,F,66,9,9,117,-71,Severe
16,2,194,F,98,13,0,156,-38,Severe
13,9,165,F,98,13,0,156,-9,Severe
15,9,189,F,42,7,7,91,-98,Severe
17,2,206,M,48,8,1,97,-109,Severe
10,3,123,F,110,14,3,171,48,Well
9,3,111,M,36,7,2,86,-25,Severe
14,7,175,M,90,12,3,147,-28,Severe
7,8,92,M,103,13,6,162,70,Well
15,6,186,M,52,8,5,101,-85,Severe
16,10,202,F,7,5,6,66,-136,Severe
9,3,111,F,43,7,8,92,-19,Severe
11,0,132,M,3,5,3,63,-69,Severe
11,6,138,F,94,12,7,151,13,Well
6,3,75,M,81,11,4,136,61,Well
15,11,191,M,107,13,11,167,-24,Severe
14,3,171,F,90,12,3,147,-24,Severe
16,5,197,M,35,7,1,85,-112,Severe
11,9,141,F,17,6,0,72,-69,Severe
7,3,87,F,82,11,5,137,50,Well
16,7,199,F,39,7,5,89,-110,Severe
14,7,175,M,91,12,4,148,-27,Severe
16,2,194,F,25,6,5,77,-117,Severe
6,5,77,M,84,11,7,139,62,Well
18,0,216,F,56,8,9,105,-111,Severe
5,8,68,M,85,11,9,141,73,Well
13,0,156,F,27,6,7,79,-77,Severe
10,7,127,M,89,12,1,145,18,Well
10,7,127,M,60,9,2,110,-17,Severe
16,11,203,F,64,9,7,115,-88,Severe
17,10,214,F,108,14,0,168,-46,Severe
11,4,136,M,3,5,3,63,-73,Severe
6,6,78,F,109,14,1,169,91,Well
12,10,154,F,99,13,1,157,3,Good
16,11,203,M,35,7,1,85,-118,Severe
11,6,138,M,14,5,10,70,-68,Severe
12,3,147,M,105,13,9,165,18,Well
15,3,183,M,95,12,9,153,-30,Severe
6,6,78,M,71,10,3,123,45,Well
13,1,157,F,80,11,3,135,-22,Severe
6,7,79,M,75,10,9,129,50,Well
15,11,191,F,94,12,7,151,-40,Severe
17,4,208,F,26,6,6,78,-130,Severe
18,1,217,M,19,6,1,73,-144,Severe
8,9,105,M,67,9,10,118,13,Well
7,11,95,F,72,10,4,124,29,Well
8,3,99,M,59,9,1,109,10,Well
13,8,164,F,99,13,1,157,-7,Severe
13,3,159,M,86,11,10,142,-17,Severe
5,11,71,F,85,11,9,141,70,Well
15,4,184,F,78,11,0,132,-52,Severe
17,2,206,M,7,5,6,66,-140,Severe
16,7,199,M,4,5,4,64,-135,Severe
16,3,195,M,100,13,3,159,-36,Severe
5,6,66,M,40,7,5,89,23,Well
9,7,115,F,48,8,1,97,-18,Severe
18,9,225,F,101,13,4,160,-65,Severe
13,2,158,M,31,6,9,81,-77,Severe
6,2,74,F,15,5,11,71,-3,Mild
8,2,98,M,17,6,0,72,-26,Severe
16,3,195,F,105,13,9,165,-30,Severe
17,4,208,F,84,11,7,139,-69,Severe
13,0,156,M,77,10,11,131,-25,Severe
5,7,67,F,45,7,10,94,27,Well
13,4,160,M,38,7,4,88,-72,Severe
15,11,191,F,84,11,7,139,-52,Severe
12,8,152,M,64,9,7,115,-37,Severe
7,7,91,F,37,7,3,87,-4,Mild
17,5,209,M,81,11,4,136,-73,Severe
10,2,122,M,77,10,11,131,9,Well
17,1,205,F,18,6,1,73,-132,Severe
16,3,195,M,59,9,1,109,-86,Severe
16,6,198,F,44,7,9,93,-105,Severe
18,3,219,F,82,11,5,137,-82,Severe
10,8,128,F,78,11,0,132,4,Good
18,3,219,M,61,9,3,111,-108,Severe
15,6,186,M,93,12,6,150,-36,Severe
7,1,85,M,35,7,1,85,0,Neutral
13,6,162,F,59,9,1,109,-53,Severe
8,4,100,M,89,12,1,145,45,Well
12,3,147,F,60,9,2,110,-37,Severe
9,10,118,F,2,5,3,63,-55,Severe
12,1,145,M,36,7,2,86,-59,Severe
14,3,171,F,95,12,9,153,-18,Severe
10,11,131,M,27,6,7,79,-52,Severe
11,5,137,M,90,12,3,147,10,Well
7,2,86,F,69,10,1,121,35,Well
6,5,77,F,84,11,7,139,62,Well
17,2,206,M,16,5,11,71,-135,Severe
11,4,136,F,21,6,2,74,-62,Severe
13,4,160,F,53,8,6,102,-58,Severe
18,3,219,M,7,5,6,66,-153,Severe
15,7,187,M,87,11,11,143,-44,Severe
14,7,175,M,101,13,4,160,-15,Severe
17,11,215,F,23,6,4,76,-139,Severe
15,11,191,M,86,11,10,142,-49,Severe
16,4,196,F,18,6,1,73,-123,Severe
8,3,99,F,66,9,9,117,18,Well
6,8,80,M,8,5,6,66,-14,Severe
8,8,104,F,30,6,9,81,-23,Severe
15,3,183,F,68,10,0,120,-63,Severe
18,6,222,M,43,7,8,92,-130,Severe
8,4,100,M,86,11,10,142,42,Well
6,8,80,M,69,10,1,121,41,Well
10,4,124,M,101,13,4,160,36,Well
9,3,111,F,87,11,11,143,32,Well
8,5,101,F,23,6,4,76,-25,Severe
14,0,168,M,21,6,2,74,-94,Severe
5,9,69,M,56,8,9,105,36,Well
11,9,141,M,106,13,10,166,25,Well
15,3,183,M,29,6,8,80,-103,Severe
12,11,155,M,94,12,7,151,-4,Mild
8,5,101,F,38,7,4,88,-13,Severe
18,6,222,M,25,6,5,77,-145,Severe
11,11,143,M,101,13,4,160,17,Well
13,4,160,M,97,12,11,155,-5,Mild
10,6,126,F,59,9,1,109,-17,Severe
11,9,141,M,84,11,7,139,-2,Mild
18,0,216,M,96,12,10,154,-62,Severe
6,5,77,F,31,6,9,81,4,Good
16,4,196,M,58,9,0,108,-88,Severe
5,10,70,M,22,6,3,75,5,Good
9,5,113,F,25,6,5,77,-36,Severe
12,4,148,M,27,6,7,79,-69,Severe
6,2,74,M,98,13,0,156,82,Well
5,1,61,F,86,11,10,142,81,Well
17,5,209,F,53,8,6,102,-107,Severe
9,8,116,F,68,10,0,120,4,Good
8,7,103,M,80,11,3,135,32,Well
9,4,112,F,16,5,11,71,-41,Severe
18,5,221,M,104,13,7,163,-58,Severe
6,1,73,M,46,7,11,95,22,Well
16,7,199,F,85,11,9,141,-58,Severe
17,6,210,M,83,11,6,138,-72,Severe
7,3,87,F,103,13,6,162,75,Well
5,6,66,F,88,12,0,144,78,Well
8,11,107,M,52,8,5,101,-6,Severe
16,2,194,F,93,12,6,150,-44,Severe
15,8,188,M,37,7,3,87,-101,Severe
13,5,161,M,49,8,2,98,-63,Severe
8,5,101,M,73,10,6,126,25,Well
16,7,199,M,2,5,3,63,-136,Severe
14,6,174,M,21,6,2,74,-100,Severe
12,7,151,F,54,8,7,103,-48,Severe
10,8,128,F,18,6,1,73,-55,Severe
15,7,187,F,68,10,0,120,-67,Severe
11,0,132,M,82,11,5,137,5,Good
18,3,219,F,25,6,5,77,-142,Severe
7,7,91,F,21,6,2,74,-17,Severe
8,8,104,M,39,7,5,89,-15,Severe
5,9,69,F,34,7,0,84,15,Well
8,7,103,M,79,11,1,133,30,Well
16,6,198,M,96,12,10,154,-44,Severe
7,0,84,F,27,6,7,79,-5,Mild
15,9,189,F,105,13,9,165,-24,Severe
6,5,77,F,80,11,3,135,58,Well
5,3,63,M,36,7,2,86,23,Well
16,5,197,F,108,14,0,168,-29,Severe
14,7,175,F,25,6,5,77,-98,Severe
16,1,193,M,91,12,4,148,-45,Severe
13,3,159,M,26,6,6,78,-81,Severe
15,9,189,F,99,13,1,157,-32,Severe
11,6,138,M,8,5,6,66,-72,Severe
5,2,62,F,23,6,4,76,14,Well
6,2,74,M,30,6,9,81,7,Well
17,3,207,F,30,6,9,81,-126,Severe
7,5,89,M,30,6,9,81,-8,Severe
5,0,60,M,78,11,0,132,72,Well
7,2,86,F,81,11,4,136,50,Well
7,11,95,M,35,7,1,85,-10,Severe
10,3,123,F,20,6,2,74,-49,Severe
6,5,77,M,101,13,4,160,83,Well
10,5,125,F,78,11,0,132,7,Well
8,9,105,F,49,8,2,98,-7,Severe
9,7,115,M,14,5,10,70,-45,Severe
14,8,176,F,49,8,2,98,-78,Severe
5,9,69,F,29,6,8,80,11,Well
7,2,86,F,107,13,11,167,81,Well
17,1,205,M,50,8,3,99,-106,Severe
12,6,150,F,61,9,3,111,-39,Severe
11,1,133,M,45,7,10,94,-39,Severe
14,5,173,M,5,5,5,65,-108,Severe
10,10,130,F,15,5,11,71,-59,Severe
11,3,135,M,90,12,3,147,12,Well
16,3,195,F,26,6,6,78,-117,Severe
11,3,135,M,2,5,3,63,-72,Severe
16,3,195,M,85,11,9,141,-54,Severe
16,7,199,M,85,11,9,141,-58,Severe
6,6,78,M,97,12,11,155,77,Well
17,3,207,M,85,11,9,141,-66,Severe
9,0,108,M,61,9,3,111,3,Good
8,0,96,F,86,11,10,142,46,Well
7,7,91,M,22,6,3,75,-16,Severe
11,1,133,F,60,9,2,110,-23,Severe
11,0,132,F,44,7,9,93,-39,Severe
9,0,108,F,57,8,10,106,-2,Mild
9,2,110,M,33,6,11,83,-27,Severe
12,4,148,M,17,6,0,72,-76,Severe
16,8,200,F,29,6,8,80,-120,Severe
7,3,87,M,18,6,1,73,-14,Severe
7,0,84,F,89,12,1,145,61,Well
13,8,164,M,106,13,10,166,2,Good
16,2,194,M,79,11,1,133,-61,Severe
13,1,157,F,61,9,3,111,-46,Severe
11,7,139,F,89,12,1,145,6,Well
9,11,119,F,57,8,10,106,-13,Severe
6,6,78,F,11,5,8,68,-10,Severe
9,8,116,M,102,13,6,162,46,Well
12,0,144,M,45,7,10,94,-50,Severe
15,1,181,M,95,12,9,153,-28,Severe
10,7,127,F,27,6,7,79,-48,Severe
12,1,145,F,95,12,9,153,8,Well
5,3,63,F,53,8,6,102,39,Well
7,10,94,F,17,6,0,72,-22,Severe
14,0,168,M,45,7,10,94,-74,Severe
16,0,192,F,97,12,11,155,-37,Severe
5,3,63,M,68,10,0,120,57,Well
11,5,137,F,81,11,4,136,-1,Mild
9,2,110,F,62,9,4,112,2,Good
15,11,191,F,24,6,5,77,-114,Severe
15,10,190,F,31,6,9,81,-109,Severe
16,0,192,M,78,11,0,132,-60,Severe
10,6,126,F,57,8,10,106,-20,Severe
15,2,182,M,22,6,3,75,-107,Severe
13,3,159,M,78,11,0,132,-27,Severe
16,11,203,M,25,6,5,77,-126,Severe
14,2,170,F,47,8,0,96,-74,Severe
17,3,207,M,32,6,10,82,-125,Severe
9,5,113,F,60,9,2,110,-3,Mild
17,3,207,F,37,7,3,87,-120,Severe
7,9,93,F,78,11,0,132,39,Well
14,4,172,F,58,9,0,108,-64,Severe
16,7,199,F,109,14,1,169,-30,Severe
14,3,171,F,102,13,6,162,-9,Severe
7,4,88,M,107,13,11,167,79,Well
6,6,78,M,70,10,2,122,44,Well
15,11,191,F,107,13,11,167,-24,Severe
8,11,107,M,71,10,3,123,16,Well
17,0,204,M,42,7,7,91,-113,Severe
10,0,120,M,91,12,4,148,28,Well
11,10,142,M,55,8,8,104,-38,Severe
15,3,183,M,62,9,4,112,-71,Severe
9,7,115,F,79,11,1,133,18,Well
9,3,111,M,106,13,10,166,55,Well
17,3,207,F,31,6,9,81,-126,Severe
7,1,85,F,100,13,3,159,74,Well
11,6,138,F,40,7,5,89,-49,Severe
11,7,139,M,8,5,6,66,-73,Severe
6,2,74,F,60,9,2,110,36,Well
13,4,160,M,68,10,0,120,-40,Severe
6,5,77,M,89,12,1,145,68,Well
13,6,162,F,97,12,11,155,-7,Severe
17,9,213,M,80,11,3,135,-78,Severe
11,0,132,M,65,9,8,116,-16,Severe
7,5,89,F,3,5,3,63,-26,Severe
17,0,204,F,10,5,7,67,-137,Severe
9,10,118,M,103,13,6,162,44,Well
10,11,131,F,43,7,8,92,-39,Severe
6,8,80,F,93,12,6,150,70,Well
18,3,219,M,39,7,5,89,-130,Severe
7,3,87,F,98,13,0,156,69,Well
17,10,214,M,40,7,5,89,-125,Severe
5,6,66,M,86,11,10,142,76,Well
9,11,119,F,107,13,11,167,48,Well
16,10,202,F,80,11,3,135,-67,Severe
5,3,63,M,2,5,3,63,0,Neutral
15,8,188,F,89,12,1,145,-43,Severe
12,11,155,M,69,10,1,121,-34,Severe
6,3,75,F,6,5,5,65,-10,Severe
10,3,123,F,33,6,11,83,-40,Severe
16,2,194,M,94,12,7,151,-43,Severe
15,6,186,F,5,5,5,65,-121,Severe
18,9,225,M,97,12,11,155,-70,Severe
10,2,122,M,109,14,1,169,47,Well
9,10,118,M,23,6,4,76,-42,Severe
16,3,195,M,7,5,6,66,-129,Severe
8,4,100,M,12,5,9,69,-31,Severe
14,11,179,F,28,6,8,80,-99,Severe
14,7,175,F,8,5,6,66,-109,Severe
12,9,153,F,66,9,9,117,-36,Severe
5,5,65,F,67,9,10,118,53,Well
13,6,162,M,22,6,3,75,-87,Severe
5,1,61,M,83,11,6,138,77,Well
9,10,118,F,17,6,0,72,-46,Severe
18,6,222,F,59,9,1,109,-113,Severe
16,5,197,M,54,8,7,103,-94,Severe
6,3,75,F,13,5,9,69,-6,Severe
15,10,190,M,47,8,0,96,-94,Severe
17,5,209,M,72,10,4,124,-85,Severe
13,4,160,M,76,10,10,130,-30,Severe
14,5,173,M,57,8,10,106,-67,Severe
15,10,190,F,45,7,10,94,-96,Severe
12,4,148,F,7,5,6,66,-82,Severe
5,10,70,M,100,13,3,159,89,Well
16,1,193,M,71,10,3,123,-70,Severe
16,10,202,F,78,11,0,132,-70,Severe
17,10,214,M,52,8,5,101,-113,Severe
13,10,166,F,6,5,5,65,-101,Severe
7,10,94,F,98,13,0,156,62,Well
14,3,171,F,9,5,7,67,-104,Severe
11,1,133,M,101,13,4,160,27,Well
10,3,123,M,46,7,11,95,-28,Severe
14,7,175,F,60,9,2,110,-65,Severe
14,11,179,M,70,10,2,122,-57,Severe
6,3,75,F,63,9,6,114,39,Well
6,0,72,M,12,5,9,69,-3,Mild
16,6,198,M,60,9,2,110,-88,Severe
10,9,129,F,51,8,4,100,-29,Severe
6,2,74,M,42,7,7,91,17,Well
9,2,110,F,78,11,0,132,22,Well
11,3,135,F,70,10,2,122,-13,Severe
15,7,187,F,51,8,4,100,-87,Severe
15,7,187,F,57,8,10,106,-81,Severe
11,3,135,M,82,11,5,137,2,Good
13,9,165,M,66,9,9,117,-48,Severe
10,11,131,M,17,6,0,72,-59,Severe
5,4,64,M,70,10,2,122,58,Well
12,5,149,F,95,12,9,153,4,Good
10,8,128,F,99,13,1,157,29,Well
17,6,210,M,34,7,0,84,-126,Severe
5,2,62,M,46,7,11,95,33,Well
5,6,66,F,35,7,1,85,19,Well
18,4,220,F,16,5,11,71,-149,Severe
11,8,140,M,36,7,2,86,-54,Severe
7,7,91,F,30,6,9,81,-10,Severe
5,2,62,F,110,14,3,171,109,Well
18,8,224,M,5,5,5,65,-159,Severe
10,9,129,M,60,9,2,110,-19,Severe
16,4,196,F,42,7,7,91,-105,Severe
16,6,198,M,29,6,8,80,-118,Severe
7,2,86,F,30,6,9,81,-5,Mild
7,10,94,M,8,5,6,66,-28,Severe
15,2,182,M,72,10,4,124,-58,Severe
8,3,99,F,63,9,6,114,15,Well
10,9,129,M,15,5,11,71,-58,Severe
17,0,204,F,50,8,3,99,-105,Severe
9,0,108,F,15,5,11,71,-37,Severe
5,0,60,M,21,6,2,74,14,Well
18,3,219,M,10,5,7,67,-152,Severe
15,11,191,M,110,14,3,171,-20,Severe
5,0,60,M,18,6,1,73,13,Well
9,1,109,M,60,9,2,110,1,Good
10,8,128,M,31,6,9,81,-47,Severe
18,0,216,F,53,8,6,102,-114,Severe
7,3,87,F,47,8,0,96,9,Well
14,2,170,M,33,6,11,83,-87,Severe
18,1,217,M,23,6,4,76,-141,Severe
17,7,211,F,68,10,0,120,-91,Severe
14,8,176,F,88,12,0,144,-32,Severe
15,10,190,M,86,11,10,142,-48,Severe
16,10,202,M,108,14,0,168,-34,Severe
10,5,125,M,71,10,3,123,-2,Mild
11,9,141,M,44,7,9,93,-48,Severe
18,7,223,F,11,5,8,68,-155,Severe
7,9,93,F,22,6,3,75,-18,Severe
11,0,132,M,13,5,9,69,-63,Severe
5,0,60,F,89,12,1,145,85,Well
9,2,110,M,47,8,0,96,-14,Severe
16,3,195,M,18,6,1,73,-122,Severe
14,3,171,M,84,11,7,139,-32,Severe
18,10,226,M,25,6,5,77,-149,Severe
8,8,104,M,28,6,8,80,-24,Severe
10,3,123,M,21,6,2,74,-49,Severe
12,4,148,F,108,14,0,168,20,Well
16,8,200,M,67,9,10,118,-82,Severe
15,0,180,M,105,13,9,165,-15,Severe
18,7,223,M,92,12,5,149,-74,Severe
14,4,172,M,62,9,4,112,-60,Severe
16,6,198,M,19,6,1,73,-125,Severe
9,2,110,M,104,13,7,163,53,Well
14,1,169,M,71,10,3,123,-46,Severe
8,0,96,M,22,6,3,75,-21,Severe
18,5,221,F,47,8,0,96,-125,Severe
17,8,212,F,13,5,9,69,-143,Severe
5,6,66,M,19,6,1,73,7,Well
11,10,142,F,66,9,9,117,-25,Severe
8,3,99,M,67,9,10,118,19,Well
16,11,203,F,5,5,5,65,-138,Severe
15,3,183,F,24,6,5,77,-106,Severe
7,7,91,M,3,5,3,63,-28,Severe
17,4,208,F,71,10,3,123,-85,Severe
7,1,85,M,18,6,1,73,-12,Severe
8,3,99,M,33,6,11,83,-16,Severe
17,11,215,F,4,5,4,64,-151,Severe
16,7,199,F,69,10,1,121,-78,Severe
10,5,125,M,34,7,0,84,-41,Severe
12,6,150,F,2,5,3,63,-87,Severe
18,11,227,M,8,5,6,66,-161,Severe
14,3,171,F,85,11,9,141,-30,Severe
5,11,71,M,64,9,7,115,44,Well
11,9,141,F,107,13,11,167,26,Well
7,1,85,M,88,12,0,144,59,Well
8,10,106,F,87,11,11,143,37,Well
11,3,135,M,57,8,10,106,-29,Severe
14,11,179,F,64,9,7,115,-64,Severe
14,9,177,M,8,5,6,66,-111,Severe
14,5,173,F,91,12,4,148,-25,Severe
8,2,98,M,79,11,1,133,35,Well
7,10,94,M,12,5,9,69,-25,Severe
17,0,204,M,98,13,0,156,-48,Severe
10,2,122,F,107,13,11,167,45,Well
7,1,85,M,42,7,7,91,6,Well
17,10,214,F,20,6,2,74,-140,Severe
12,8,152,F,103,13,6,162,10,Well
12,4,148,F,79,11,1,133,-15,Severe
5,2,62,M,87,11,11,143,81,Well
17,5,209,F,108,14,0,168,-41,Severe
12,3,147,F,90,12,3,147,0,Neutral
11,3,135,F,14,5,10,70,-65,Severe
17,3,207,M,3,5,3,63,-144,Severe
9,0,108,M,2,5,3,63,-45,Severe
11,4,136,M,57,8,10,106,-30,Severe
14,8,176,F,79,11,1,133,-43,Severe
6,7,79,F,69,10,1,121,42,Well
8,5,101,M,74,10,7,127,26,Well
14,0,168,F,50,8,3,99,-69,Severe
12,8,152,F,105,13,9,165,13,Well
12,3,147,M,21,6,2,74,-73,Severe
14,7,175,F,31,6,9,81,-94,Severe
15,10,190,F,55,8,8,104,-86,Severe
18,4,220,F,99,13,1,157,-63,Severe
17,2,206,M,49,8,2,98,-108,Severe
6,4,76,F,85,11,9,141,65,Well
16,0,192,F,48,8,1,97,-95,Severe
13,7,163,F,108,14,0,168,5,Good
6,10,82,M,18,6,1,73,-9,Severe
7,3,87,M,30,6,9,81,-6,Severe
12,3,147,F,83,11,6,138,-9,Severe
16,3,195,M,64,9,7,115,-80,Severe
18,8,224,F,65,9,8,116,-108,Severe
14,3,171,M,32,6,10,82,-89,Severe
14,4,172,M,43,7,8,92,-80,Severe
17,8,212,F,57,8,10,106,-106,Severe
11,2,134,M,38,7,4,88,-46,Severe
14,6,174,M,10,5,7,67,-107,Severe
12,10,154,F,14,5,10,70,-84,Severe
16,6,198,F,30,6,9,81,-117,Severe
17,6,210,F,32,6,10,82,-128,Severe
9,4,112,F,105,13,9,165,53,Well
14,7,175,F,24,6,5,77,-98,Severe
8,10,106,F,45,7,10,94,-12,Severe
13,8,164,M,69,10,1,121,-43,Severe
13,11,167,M,41,7,6,90,-77,Severe
16,5,197,F,86,11,10,142,-55,Severe
8,11,107,F,63,9,6,114,7,Well
17,0,204,M,56,8,9,105,-99,Severe
13,8,164,M,49,8,2,98,-66,Severe
15,9,189,M,85,11,9,141,-48,Severe
8,10,106,F,46,7,11,95,-11,Severe
17,3,207,F,43,7,8,92,-115,Severe
14,6,174,M,4,5,4,64,-110,Severe
6,1,73,F,98,13,0,156,83,Well
17,3,207,M,43,7,8,92,-115,Severe
5,5,65,F,65,9,8,116,51,Well
18,3,219,F,110,14,3,171,-48,Severe
15,11,191,F,64,9,7,115,-76,Severe
12,4,148,F,110,14,3,171,23,Well
11,10,142,M,81,11,4,136,-6,Severe
13,4,160,M,7,5,6,66,-94,Severe
14,4,172,M,30,6,9,81,-91,Severe
10,6,126,M,100,13,3,159,33,Well
5,1,61,M,78,11,0,132,71,Well
17,10,214,M,60,9,2,110,-104,Severe
11,3,135,M,88,12,0,144,9,Well
17,2,206,M,42,7,7,91,-115,Severe
9,6,114,F,95,12,9,153,39,Well
14,9,177,F,10,5,7,67,-110,Severe
13,3,159,F,30,6,9,81,-78,Severe
16,7,199,M,43,7,8,92,-107,Severe
13,4,160,M,74,10,7,127,-33,Severe
8,9,105,F,79,11,1,133,28,Well
17,0,204,M,41,7,6,90,-114,Severe
5,8,68,M,39,7,5,89,21,Well
8,5,101,F,83,11,6,138,37,Well
6,2,74,M,75,10,9,129,55,Well
14,10,178,M,99,13,1,157,-21,Severe
9,0,108,F,74,10,7,127,19,Well
11,3,135,M,97,12,11,155,20,Well
6,6,78,M,100,13,3,159,81,Well
10,4,124,F,68,10,0,120,-4,Mild
12,2,146,F,101,13,4,160,14,Well
10,2,122,F,25,6,5,77,-45,Severe
14,6,174,M,12,5,9,69,-105,Severe
15,2,182,F,56,8,9,105,-77,Severe
9,11,119,F,38,7,4,88,-31,Severe
17,6,210,F,36,7,2,86,-124,Severe
6,3,75,F,65,9,8,116,41,Well
16,2,194,M,20,6,2,74,-120,Severe
7,8,92,M,59,9,1,109,17,Well
14,10,178,M,63,9,6,114,-64,Severe
6,6,78,F,75,10,9,129,51,Well
7,2,86,F,77,10,11,131,45,Well
9,6,114,M,41,7,6,90,-24,Severe
18,8,224,F,26,6,6,78,-146,Severe
8,4,100,F,83,11,6,138,38,Well
10,6,126,F,97,12,11,155,29,Well
12,2,146,M,53,8,6,102,-44,Severe
14,11,179,M,34,7,0,84,-95,Severe
9,3,111,F,74,10,7,127,16,Well
16,5,197,M,25,6,5,77,-120,Severe
15,1,181,F,76,10,10,130,-51,Severe
7,10,94,M,85,11,9,141,47,Well
12,6,150,M,72,10,4,124,-26,Severe
16,0,192,F,63,9,6,114,-78,Severe
12,7,151,F,36,7,2,86,-65,Severe
8,0,96,M,59,9,1,109,13,Well
16,8,200,F,83,11,6,138,-62,Severe
17,9,213,M,109,14,1,169,-44,Severe
13,0,156,F,97,12,11,155,-1,Mild
15,7,187,M,10,5,7,67,-120,Severe
18,8,224,M,35,7,1,85,-139,Severe
13,9,165,M,63,9,6,114,-51,Severe
13,8,164,M,11,5,8,68,-96,Severe
17,7,211,M,110,14,3,171,-40,Severe
12,1,145,F,13,5,9,69,-76,Severe
18,0,216,M,18,6,1,73,-143,Severe
17,1,205,M,107,13,11,167,-38,Severe
15,3,183,F,76,10,10,130,-53,Severe
17,7,211,M,72,10,4,124,-87,Severe
15,6,186,M,8,5,6,66,-120,Severe
11,0,132,F,39,7,5,89,-43,Severe
10,10,130,F,38,7,4,88,-42,Severe
11,8,140,M,15,5,11,71,-69,Severe
18,9,225,F,58,9,0,108,-117,Severe
18,4,220,F,61,9,3,111,-109,Severe
12,3,147,F,56,8,9,105,-42,Severe
15,5,185,M,105,13,9,165,-20,Severe
16,5,197,M,18,6,1,73,-124,Severe
16,8,200,F,94,12,7,151,-49,Severe
8,10,106,M,66,9,9,117,11,Well
8,0,96,F,104,13,7,163,67,Well
11,10,142,M,30,6,9,81,-61,Severe
10,4,124,F,45,7,10,94,-30,Severe
11,5,137,M,46,7,11,95,-42,Severe
15,11,191,F,49,8,2,98,-93,Severe
9,3,111,F,52,8,5,101,-10,Severe
12,1,145,F,34,7,0,84,-61,Severe
8,8,104,F,80,11,3,135,31,Well
14,1,169,F,108,14,0,168,-1,Mild
15,2,182,F,10,5,7,67,-115,Severe
17,5,209,M,105,13,9,165,-44,Severe
5,1,61,F,8,5,6,66,5,Good
12,0,144,F,77,10,11,131,-13,Severe
8,11,107,F,6,5,5,65,-42,Severe
12,4,148,M,26,6,6,78,-70,Severe
8,8,104,F,35,7,1,85,-19,Severe
17,3,207,F,48,8,1,97,-110,Severe
8,9,105,F,101,13,4,160,55,Well
6,5,77,M,110,14,3,171,94,Well
10,10,130,M,94,12,7,151,21,Well
12,10,154,M,32,6,10,82,-72,Severe
14,3,171,M,73,10,6,126,-45,Severe
11,3,135,F,83,11,6,138,3,Good
9,4,112,M,29,6,8,80,-32,Severe
16,7,199,M,68,10,0,120,-79,Severe
7,8,92,M,85,11,9,141,49,Well
12,7,151,M,13,5,9,69,-82,Severe
9,3,111,F,90,12,3,147,36,Well
6,5,77,F,50,8,3,99,22,Well
10,2,122,M,42,7,7,91,-31,Severe
12,8,152,M,16,5,11,71,-81,Severe
10,2,122,M,63,9,6,114,-8,Severe
9,7,115,M,35,7,1,85,-30,Severe
7,8,92,M,28,6,8,80,-12,Severe
6,5,77,M,28,6,8,80,3,Good
17,0,204,M,20,6,2,74,-130,Severe
14,8,176,F,22,6,3,75,-101,Severe
16,11,203,F,107,13,11,167,-36,Severe
10,3,123,F,95,12,9,153,30,Well
16,0,192,M,27,6,7,79,-113,Severe
6,7,79,F,101,13,4,160,81,Well
8,3,99,M,56,8,9,105,6,Well
11,6,138,M,15,5,11,71,-67,Severe
14,9,177,M,75,10,9,129,-48,Severe
9,9,117,F,67,9,10,118,1,Good
6,1,73,M,41,7,6,90,17,Well
8,3,99,M,104,13,7,163,64,Well
9,3,111,F,83,11,6,138,27,Well
18,5,221,F,97,12,11,155,-66,Severe
15,3,183,F,97,12,11,155,-28,Severe
18,8,224,F,104,13,7,163,-61,Severe
12,11,155,M,104,13,7,163,8,Well
12,7,151,F,10,5,7,67,-84,Severe
10,8,128,M,55,8,8,104,-24,Severe
12,10,154,M,51,8,4,100,-54,Severe
16,3,195,F,29,6,8,80,-115,Severe
9,1,109,F,41,7,6,90,-19,Severe
7,0,84,F,23,6,4,76,-8,Severe
7,4,88,M,31,6,9,81,-7,Severe
17,11,215,F,108,14,0,168,-47,Severe
17,3,207,M,59,9,1,109,-98,Severe
7,4,88,M,42,7,7,91,3,Good
6,5,77,F,5,5,5,65,-12,Severe
8,11,107,M,79,11,1,133,26,Well
7,1,85,M,69,10,1,121,36,Well
14,8,176,M,20,6,2,74,-102,Severe
17,2,206,M,107,13,11,167,-39,Severe
14,8,176,F,73,10,6,126,-50,Severe
7,7,91,F,107,13,11,167,76,Well
10,9,129,M,54,8,7,103,-26,Severe
9,2,110,M,43,7,8,92,-18,Severe
15,3,183,M,23,6,4,76,-107,Severe
14,8,176,F,20,6,2,74,-102,Severe
8,1,97,M,80,11,3,135,38,Well
8,1,97,F,76,10,10,130,33,Well
9,7,115,M,99,13,1,157,42,Well
16,6,198,F,13,5,9,69,-129,Severe
18,0,216,F,59,9,1,109,-107,Severe
9,1,109,M,78,11,0,132,23,Well
11,3,135,M,55,8,8,104,-31,Severe
9,0,108,M,45,7,10,94,-14,Severe
16,1,193,M,37,7,3,87,-106,Severe
10,3,123,F,34,7,0,84,-39,Severe
15,0,180,F,75,10,9,129,-51,Severe
15,10,190,F,88,12,0,144,-46,Severe
10,9,129,F,96,12,10,154,25,Well
5,7,67,M,73,10,6,126,59,Well
5,3,63,M,110,14,3,171,108,Well
18,2,218,M,67,9,10,118,-100,Severe
7,8,92,F,16,5,11,71,-21,Severe
8,8,104,M,2,5,3,63,-41,Severe
10,7,127,F,109,14,1,169,42,Well
6,8,80,M,27,6,7,79,-1,Mild
9,8,116,M,68,10,0,120,4,Good
15,6,186,F,16,5,11,71,-115,Severe
10,3,123,M,38,7,4,88,-35,Severe
16,6,198,M,76,10,10,130,-68,Severe
5,2,62,F,21,6,2,74,12,Well
9,11,119,F,99,13,1,157,38,Well
11,7,139,F,53,8,6,102,-37,Severe
14,0,168,F,22,6,3,75,-93,Severe
11,3,135,F,37,7,3,87,-48,Severe
14,3,171,F,8,5,6,66,-105,Severe
13,11,167,F,10,5,7,67,-100,Severe
7,3,87,M,4,5,4,64,-23,Severe
13,3,159,M,36,7,2,86,-73,Severe
17,9,213,M,39,7,5,89,-124,Severe
18,5,221,M,32,6,10,82,-139,Severe
11,0,132,F,73,10,6,126,-6,Severe
18,2,218,F,16,5,11,71,-147,Severe
9,7,115,M,80,11,3,135,20,Well
7,9,93,F,55,8,8,104,11,Well
17,3,207,F,97,12,11,155,-52,Severe
9,1,109,M,81,11,4,136,27,Well
7,3,87,F,46,7,11,95,8,Well
6,3,75,M,35,7,1,85,10,Well
16,3,195,F,9,5,7,67,-128,Severe
6,3,75,M,73,10,6,126,51,Well
8,11,107,F,18,6,1,73,-34,Severe
5,3,63,M,105,13,9,165,102,Well
16,6,198,F,12,5,9,69,-129,Severe
6,3,75,M,54,8,7,103,28,Well
17,9,213,F,23,6,4,76,-137,Severe
9,6,114,M,80,11,3,135,21,Well
13,0,156,M,68,10,0,120,-36,Severe
15,11,191,M,101,13,4,160,-31,Severe
11,2,134,F,40,7,5,89,-45,Severe
17,9,213,M,101,13,4,160,-53,Severe
11,3,135,F,19,6,1,73,-62,Severe
18,5,221,F,107,13,11,167,-54,Severe
16,11,203,F,21,6,2,74,-129,Severe
12,6,150,M,107,13,11,167,17,Well
15,5,185,M,87,11,11,143,-42,Severe
16,3,195,M,108,14,0,168,-27,Severe
12,8,152,F,89,12,1,145,-7,Severe
7,4,88,F,107,13,11,167,79,Well
6,3,75,F,5,5,5,65,-10,Severe
14,11,179,F,91,12,4,148,-31,Severe
16,8,200,M,15,5,11,71,-129,Severe
11,6,138,F,43,7,8,92,-46,Severe
5,8,68,M,13,5,9,69,1,Good
12,2,146,M,50,8,3,99,-47,Severe
11,0,132,F,45,7,10,94,-38,Severe
14,1,169,M,28,6,8,80,-89,Severe
7,4,88,M,29,6,8,80,-8,Severe
13,5,161,M,44,7,9,93,-68,Severe
6,10,82,F,26,6,6,78,-4,Mild
18,3,219,M,42,7,7,91,-128,Severe
8,6,102,F,61,9,3,111,9,Well
12,11,155,F,47,8,0,96,-59,Severe
6,3,75,F,74,10,7,127,52,Well
6,11,83,F,71,10,3,123,40,Well
15,7,187,F,23,6,4,76,-111,Severe
16,3,195,M,63,9,6,114,-81,Severe
14,11,179,F,32,6,10,82,-97,Severe
13,7,163,F,96,12,10,154,-9,Severe
7,9,93,M,28,6,8,80,-13,Severe
12,7,151,F,53,8,6,102,-49,Severe
10,2,122,M,85,11,9,141,19,Well
9,1,109,M,71,10,3,123,14,Well
15,6,186,F,108,14,0,168,-18,Severe
11,11,143,M,49,8,2,98,-45,Severe
10,8,128,F,13,5,9,69,-59,Severe
13,2,158,F,37,7,3,87,-71,Severe
15,2,182,F,27,6,7,79,-103,Severe
9,4,112,M,2,5,3,63,-49,Severe
5,7,67,M,62,9,4,112,45,Well
18,8,224,M,46,7,11,95,-129,Severe
15,7,187,M,43,7,8,92,-95,Severe
16,3,195,M,29,6,8,80,-115,Severe
13,3,159,F,58,9,0,108,-51,Severe
15,0,180,F,10,5,7,67,-113,Severe
8,5,101,F,27,6,7,79,-22,Severe
8,3,99,M,85,11,9,141,42,Well
10,1,121,M,27,6,7,79,-42,Severe
5,3,63,F,26,6,6,78,15,Well
6,0,72,F,71,10,3,123,51,Well
11,1,133,F,24,6,5,77,-56,Severe
7,3,87,M,108,14,0,168,81,Well
18,8,224,M,105,13,9,165,-59,Severe
16,11,203,M,51,8,4,100,-103,Severe
11,3,135,M,71,10,3,123,-12,Severe
7,6,90,F,64,9,7,115,25,Well
5,1,61,F,21,6,2,74,13,Well
12,2,146,F,17,6,0,72,-74,Severe
12,1,145,F,11,5,8,68,-77,Severe
6,3,75,F,107,13,11,167,92,Well
11,7,139,F,71,10,3,123,-16,Severe
8,0,96,M,63,9,6,114,18,Well
12,5,149,F,100,13,3,159,10,Well
15,4,184,F,49,8,2,98,-86,Severe
13,10,166,M,23,6,4,76,-90,Severe
5,5,65,F,23,6,4,76,11,Well
17,3,207,F,41,7,6,90,-117,Severe
11,3,135,F,24,6,5,77,-58,Severe
6,3,75,F,17,6,0,72,-3,Mild
13,9,165,M,39,7,5,89,-76,Severe
8,3,99,M,85,11,9,141,42,Well
16,6,198,M,12,5,9,69,-129,Severe
14,10,178,F,69,10,1,121,-57,Severe
17,3,207,M,79,11,1,133,-74,Severe
13,3,159,M,25,6,5,77,-82,Severe
16,1,193,F,74,10,7,127,-66,Severe
18,0,216,M,100,13,3,159,-57,Severe
5,11,71,F,94,12,7,151,80,Well
14,7,175,M,100,13,3,159,-16,Severe
9,6,114,M,11,5,8,68,-46,Severe
18,0,216,M,95,12,9,153,-63,Severe
7,9,93,M,60,9,2,110,17,Well
18,9,225,F,68,10,0,120,-105,Severe
10,6,126,M,51,8,4,100,-26,Severe
7,11,95,M,101,13,4,160,65,Well
18,5,221,M,87,11,11,143,-78,Severe
7,3,87,M,69,10,1,121,34,Well
6,1,73,M,48,8,1,97,24,Well
11,0,132,M,103,13,6,162,30,Well
9,0,108,F,25,6,5,77,-31,Severe
9,6,114,M,13,5,9,69,-45,Severe
7,0,84,F,58,9,0,108,24,Well
5,7,67,M,75,10,9,129,62,Well
10,7,127,F,64,9,7,115,-12,Severe
11,5,137,M,78,11,0,132,-5,Mild
12,9,153,M,13,5,9,69,-84,Severe
15,9,189,M,75,10,9,129,-60,Severe
14,1,169,F,106,13,10,166,-3,Mild
17,1,205,F,3,5,3,63,-142,Severe
9,11,119,M,52,8,5,101,-18,Severe
10,9,129,M,62,9,4,112,-17,Severe
9,9,117,M,65,9,8,116,-1,Mild
12,3,147,M,109,14,1,169,22,Well
18,3,219,F,29,6,8,80,-139,Severe
9,2,110,F,76,10,10,130,20,Well
17,9,213,M,2,5,3,63,-150,Severe
9,0,108,F,88,12,0,144,36,Well
14,4,172,M,107,13,11,167,-5,Mild
18,11,227,M,88,12,0,144,-83,Severe
11,3,135,F,56,8,9,105,-30,Severe
16,9,201,M,94,12,7,151,-50,Severe
18,9,225,M,99,13,1,157,-68,Severe
14,7,175,M,3,5,3,63,-112,Severe
5,3,63,F,44,7,9,93,30,Well
8,5,101,M,31,6,9,81,-20,Severe
18,0,216,F,80,11,3,135,-81,Severe
7,8,92,F,86,11,10,142,50,Well
15,5,185,M,67,9,10,118,-67,Severe
10,8,128,F,25,6,5,77,-51,Severe
14,1,169,M,85,11,9,141,-28,Severe
8,7,103,F,69,10,1,121,18,Well
16,1,193,F,58,9,0,108,-85,Severe
8,5,101,M,16,5,11,71,-30,Severe
5,0,60,F,7,5,6,66,6,Well
17,7,211,M,81,11,4,136,-75,Severe
7,3,87,M,50,8,3,99,12,Well
9,0,108,F,100,13,3,159,51,Well
16,0,192,F,81,11,4,136,-56,Severe
15,6,186,F,22,6,3,75,-111,Severe
18,3,219,F,17,6,0,72,-147,Severe
9,8,116,M,104,13,7,163,47,Well
12,6,150,M,6,5,5,65,-85,Severe
17,8,212,F,33,6,11,83,-129,Severe
11,0,132,F,66,9,9,117,-15,Severe
13,3,159,F,70,10,2,122,-37,Severe
18,3,219,F,67,9,10,118,-101,Severe
8,8,104,M,27,6,7,79,-25,Severe
6,6,78,M,13,5,9,69,-9,Severe
5,8,68,F,97,12,11,155,87,Well
18,6,222,F,97,12,11,155,-67,Severe
9,9,117,M,47,8,0,96,-21,Severe
7,7,91,M,30,6,9,81,-10,Severe
13,7,163,F,97,12,11,155,-8,Severe
14,11,179,M,67,9,10,118,-61,Severe
18,2,218,F,96,12,10,154,-64,Severe
13,9,165,F,55,8,8,104,-61,Severe
15,4,184,F,102,13,6,162,-22,Severe
6,9,81,M,90,12,3,147,66,Well
7,5,89,F,83,11,6,138,49,Well
18,4,220,F,39,7,5,89,-131,Severe
18,3,219,M,67,9,10,118,-101,Severe
10,2,122,F,11,5,8,68,-54,Severe
13,8,164,F,100,13,3,159,-5,Mild
12,4,148,M,70,10,2,122,-26,Severe
16,6,198,M,69,10,1,121,-77,Severe
17,0,204,F,60,9,2,110,-94,Severe
15,2,182,M,69,10,1,121,-61,Severe
5,2,62,F,78,11,0,132,70,Well
16,9,201,F,99,13,1,157,-44,Severe
6,2,74,F,77,10,11,131,57,Well
9,7,115,M,23,6,4,76,-39,Severe
9,8,116,M,58,9,0,108,-8,Severe
14,10,178,M,98,13,0,156,-22,Severe
16,7,199,M,79,11,1,133,-66,Severe
6,1,73,F,87,11,11,143,70,Well
14,1,169,F,3,5,3,63,-106,Severe
7,10,94,M,107,13,11,167,73,Well
16,0,192,M,97,12,11,155,-37,Severe
12,10,154,F,33,6,11,83,-71,Severe
6,3,75,F,16,5,11,71,-4,Mild
15,10,190,M,46,7,11,95,-95,Severe
12,2,146,M,47,8,0,96,-50,Severe
7,2,86,F,21,6,2,74,-12,Severe
11,0,132,M,99,13,1,157,25,Well
8,2,98,F,79,11,1,133,35,Well
14,0,168,M,100,13,3,159,-9,Severe
17,2,206,F,29,6,8,80,-126,Severe
6,8,80,M,55,8,8,104,24,Well
7,4,88,M,18,6,1,73,-15,Severe
15,4,184,F,82,11,5,137,-47,Severe
16,4,196,F,47,8,0,96,-100,Severe
7,10,94,M,72,10,4,124,30,Well
8,2,98,F,38,7,4,88,-10,Severe
9,8,116,M,86,11,10,142,26,Well
14,1,169,M,51,8,4,100,-69,Severe
18,4,220,M,73,10,6,126,-94,Severe
15,0,180,F,66,9,9,117,-63,Severe
11,11,143,M,20,6,2,74,-69,Severe
17,4,208,F,15,5,11,71,-137,Severe
6,0,72,M,22,6,3,75,3,Good
11,9,141,M,90,12,3,147,6,Well
12,9,153,F,102,13,6,162,9,Well
13,4,160,F,58,9,0,108,-52,Severe
10,10,130,F,75,10,9,129,-1,Mild
16,0,192,F,86,11,10,142,-50,Severe
6,5,77,F,100,13,3,159,82,Well
12,7,151,M,78,11,0,132,-19,Severe
14,5,173,F,66,9,9,117,-56,Severe
7,1,85,F,97,12,11,155,70,Well
14,2,170,M,30,6,9,81,-89,Severe
14,11,179,M,48,8,1,97,-82,Severe
12,4,148,M,97,12,11,155,7,Well
11,11,143,M,58,9,0,108,-35,Severe
16,11,203,M,88,12,0,144,-59,Severe
9,5,113,F,91,12,4,148,35,Well
17,2,206,M,64,9,7,115,-91,Severe
12,3,147,F,107,13,11,167,20,Well
7,0,84,F,34,7,0,84,0,Neutral
7,8,92,M,42,7,7,91,-1,Mild
18,6,222,M,53,8,6,102,-120,Severe
6,2,74,M,80,11,3,135,61,Well
12,8,152,M,3,5,3,63,-89,Severe
18,11,227,M,96,12,10,154,-73,Severe
7,11,95,F,68,10,0,120,25,Well
15,6,186,F,70,10,2,122,-64,Severe
6,5,77,M,38,7,4,88,11,Well
11,7,139,M,13,5,9,69,-70,Severe
13,3,159,F,19,6,1,73,-86,Severe
9,3,111,M,49,8,2,98,-13,Severe
9,0,108,M,13,5,9,69,-39,Severe
15,3,183,M,108,14,0,168,-15,Severe
16,3,195,F,8,5,6,66,-129,Severe
10,7,127,F,6,5,5,65,-62,Severe
6,6,78,F,12,5,9,69,-9,Severe
8,4,100,M,30,6,9,81,-19,Severe
15,10,190,F,32,6,10,82,-108,Severe
6,1,73,F,72,10,4,124,51,Well
15,9,189,F,20,6,2,74,-115,Severe
8,3,99,M,93,12,6,150,51,Well
11,7,139,M,72,10,4,124,-15,Severe
9,7,115,F,105,13,9,165,50,Well
12,3,147,F,44,7,9,93,-54,Severe
5,3,63,M,72,10,4,124,61,Well
7,2,86,F,54,8,7,103,17,Well
14,10,178,F,104,13,7,163,-15,Severe
5,4,64,F,94,12,7,151,87,Well
12,10,154,F,70,10,2,122,-32,Severe
15,3,183,M,59,9,1,109,-74,Severe
7,1,85,M,14,5,10,70,-15,Severe
10,7,127,M,106,13,10,166,39,Well
9,0,108,M,3,5,3,63,-45,Severe
12,1,145,F,27,6,7,79,-66,Severe
14,4,172,F,3,5,3,63,-109,Severe
16,8,200,M,104,13,7,163,-37,Severe
17,10,214,F,39,7,5,89,-125,Severe
17,1,205,M,49,8,2,98,-107,Severe
10,6,126,F,84,11,7,139,13,Well
15,10,190,F,39,7,5,89,-101,Severe
9,11,119,F,49,8,2,98,-21,Severe
10,3,123,M,29,6,8,80,-43,Severe
16,3,195,F,48,8,1,97,-98,Severe
13,8,164,F,9,5,7,67,-97,Severe
15,1,181,M,23,6,4,76,-105,Severe
15,9,189,F,44,7,9,93,-96,Severe
6,6,78,M,82,11,5,137,59,Well
6,11,83,F,74,10,7,127,44,Well
10,0,120,M,22,6,3,75,-45,Severe
16,1,193,F,44,7,9,93,-100,Severe
17,2,206,M,12,5,9,69,-137,Severe
7,3,87,M,55,8,8,104,17,Well
16,5,197,F,97,12,11,155,-42,Severe
13,2,158,F,70,10,2,122,-36,Severe
18,10,226,F,14,5,10,70,-156,Severe
8,11,107,F,4,5,4,64,-43,Severe
16,1,193,M,86,11,10,142,-51,Severe
12,0,144,F,56,8,9,105,-39,Severe
13,8,164,M,76,10,10,130,-34,Severe
12,8,152,M,45,7,10,94,-58,Severe
13,1,157,M,62,9,4,112,-45,Severe
8,3,99,F,105,13,9,165,66,Well
18,5,221,F,35,7,1,85,-136,Severe
6,11,83,M,78,11,0,132,49,Well
12,6,150,M,19,6,1,73,-77,Severe
12,3,147,M,37,7,3,87,-60,Severe
9,4,112,M,73,10,6,126,14,Well
11,9,141,F,11,5,8,68,-73,Severe
16,6,198,M,58,9,0,108,-90,Severe
6,6,78,M,92,12,5,149,71,Well
6,2,74,M,68,10,0,120,46,Well
15,3,183,F,23,6,4,76,-107,Severe
5,0,60,F,43,7,8,92,32,Well
6,7,79,F,30,6,9,81,2,Good
13,1,157,F,64,9,7,115,-42,Severe
8,4,100,M,43,7,8,92,-8,Severe
12,3,147,M,95,12,9,153,6,Well
7,6,90,F,22,6,3,75,-15,Severe
17,0,204,M,49,8,2,98,-106,Severe
15,11,191,F,59,9,1,109,-82,Severe
17,3,207,F,50,8,3,99,-108,Severe
10,9,129,M,44,7,9,93,-36,Severe
11,4,136,F,59,9,1,109,-27,Severe
13,3,159,M,24,6,5,77,-82,Severe
6,4,76,M,28,6,8,80,4,Good
6,4,76,F,102,13,6,162,86,Well
11,6,138,M,55,8,8,104,-34,Severe
10,3,123,M,76,10,10,130,7,Well
15,0,180,M,6,5,5,65,-115,Severe
10,2,122,F,105,13,9,165,43,Well
15,7,187,F,17,6,0,72,-115,Severe
17,9,213,M,3,5,3,63,-150,Severe
16,3,195,F,86,11,10,142,-53,Severe
13,4,160,F,15,5,11,71,-89,Severe
18,2,218,F,76,10,10,130,-88,Severe
13,11,167,F,9,5,7,67,-100,Severe
12,0,144,F,94,12,7,151,7,Well
12,0,144,M,39,7,5,89,-55,Severe
7,2,86,M,64,9,7,115,29,Well
16,11,203,M,73,10,6,126,-77,Severe
11,7,139,F,104,13,7,163,24,Well
10,3,123,F,82,11,5,137,14,Well
9,0,108,F,45,7,10,94,-14,Severe
5,6,66,F,19,6,1,73,7,Well
13,5,161,M,39,7,5,89,-72,Severe
6,9,81,M,102,13,6,162,81,Well
16,3,195,M,17,6,0,72,-123,Severe
12,0,144,M,9,5,7,67,-77,Severe
5,4,64,F,19,6,1,73,9,Well
11,3,135,M,6,5,5,65,-70,Severe
17,5,209,M,51,8,4,100,-109,Severe
5,5,65,F,64,9,7,115,50,Well
14,9,177,F,47,8,0,96,-81,Severe
14,1,169,F,7,5,6,66,-103,Severe
16,8,200,F,19,6,1,73,-127,Severe
7,11,95,F,29,6,8,80,-15,Severe
13,1,157,F,100,13,3,159,2,Good
10,5,125,F,95,12,9,153,28,Well
10,0,120,F,91,12,4,148,28,Well
14,6,174,F,10,5,7,67,-107,Severe
6,7,79,F,9,5,7,67,-12,Severe
18,3,219,M,54,8,7,103,-116,Severe
12,6,150,F,37,7,3,87,-63,Severe
7,8,92,M,64,9,7,115,23,Well
10,5,125,M,84,11,7,139,14,Well
8,11,107,F,53,8,6,102,-5,Mild
17,10,214,F,77,10,11,131,-83,Severe
12,9,153,F,86,11,10,142,-11,Severe
5,4,64,F,49,8,2,98,34,Well
7,6,90,M,13,5,9,69,-21,Severe
12,10,154,M,57,8,10,106,-48,Severe
5,6,66,M,87,11,11,143,77,Well
13,11,167,F,75,10,9,129,-38,Severe
17,8,212,M,54,8,7,103,-109,Severe
13,5,161,M,106,13,10,166,5,Good
11,0,132,F,18,6,1,73,-59,Severe
10,7,127,F,25,6,5,77,-50,Severe
8,8,104,M,106,13,10,166,62,Well
13,5,161,M,11,5,8,68,-93,Severe
5,6,66,F,13,5,9,69,3,Good
17,11,215,M,88,12,0,144,-71,Severe
10,0,120,M,12,5,9,69,-51,Severe
16,0,192,F,94,12,7,151,-41,Severe
14,8,176,M,32,6,10,82,-94,Severe
13,2,158,M,39,7,5,89,-69,Severe
5,5,65,M,29,6,8,80,15,Well
8,2,98,M,4,5,4,64,-34,Severe
5,0,60,F,76,10,10,130,70,Well
9,7,115,F,90,12,3,147,32,Well
5,7,67,M,54,8,7,103,36,Well
10,5,125,F,107,13,11,167,42,Well
17,5,209,M,2,5,3,63,-146,Severe
16,10,202,F,82,11,5,137,-65,Severe
18,1,217,M,72,10,4,124,-93,Severe
18,10,226,M,43,7,8,92,-134,Severe
13,2,158,F,45,7,10,94,-64,Severe
8,0,96,M,72,10,4,124,28,Well
14,2,170,F,69,10,1,121,-49,Severe
14,5,173,M,12,5,9,69,-104,Severe
6,2,74,F,53,8,6,102,28,Well
8,4,100,M,31,6,9,81,-19,Severe
10,2,122,M,110,14,3,171,49,Well
16,11,203,F,34,7,0,84,-119,Severe
12,5,149,F,9,5,7,67,-82,Severe
11,7,139,M,58,9,0,108,-31,Severe
6,6,78,M,78,11,0,132,54,Well
15,5,185,F,3,5,3,63,-122,Severe
18,1,217,M,80,11,3,135,-82,Severe
11,2,134,M,104,13,7,163,29,Well
12,9,153,M,89,12,1,145,-8,Severe
17,5,209,M,104,13,7,163,-46,Severe
18,7,223,M,80,11,3,135,-88,Severe
8,0,96,F,38,7,4,88,-8,Severe
15,3,183,F,37,7,3,87,-96,Severe
9,11,119,M,34,7,0,84,-35,Severe
11,8,140,M,73,10,6,126,-14,Severe
12,11,155,M,39,7,5,89,-66,Severe
12,8,152,F,102,13,6,162,10,Well
7,4,88,M,101,13,4,160,72,Well
14,7,175,M,80,11,3,135,-40,Severe
12,5,149,F,36,7,2,86,-63,Severe
7,8,92,F,64,9,7,115,23,Well
9,5,113,F,19,6,1,73,-40,Severe
12,5,149,M,58,9,0,108,-41,Severe
18,2,218,F,5,5,5,65,-153,Severe
12,7,151,M,80,11,3,135,-16,Severe
18,4,220,F,48,8,1,97,-123,Severe
17,5,209,M,102,13,6,162,-47,Severe
11,1,133,M,66,9,9,117,-16,Severe
11,1,133,M,75,10,9,129,-4,Mild
16,0,192,F,20,6,2,74,-118,Severe
16,10,202,M,44,7,9,93,-109,Severe
16,10,202,F,55,8,8,104,-98,Severe
11,3,135,M,14,5,10,70,-65,Severe
15,1,181,F,36,7,2,86,-95,Severe
8,9,105,F,6,5,5,65,-40,Severe
17,4,208,F,99,13,1,157,-51,Severe
6,6,78,F,106,13,10,166,88,Well
12,1,145,M,59,9,1,109,-36,Severe
18,4,220,M,5,5,5,65,-155,Severe
6,9,81,M,79,11,1,133,52,Well
8,6,102,M,71,10,3,123,21,Well
15,6,186,F,38,7,4,88,-98,Severe
5,2,62,M,62,9,4,112,50,Well
6,6,78,F,6,5,5,65,-13,Severe
6,6,78,F,30,6,9,81,3,Good
11,8,140,F,98,13,0,156,16,Well
9,6,114,F,45,7,10,94,-20,Severe
13,4,160,F,39,7,5,89,-71,Severe
7,9,93,M,35,7,1,85,-8,Severe
11,3,135,M,48,8,1,97,-38,Severe
7,11,95,M,64,9,7,115,20,Well
5,6,66,M,36,7,2,86,20,Well
12,11,155,M,57,8,10,106,-49,Severe
7,3,87,M,72,10,4,124,37,Well
12,8,152,M,82,11,5,137,-15,Severe
12,8,152,M,88,12,0,144,-8,Severe
8,10,106,M,53,8,6,102,-4,Mild
16,9,201,F,69,10,1,121,-80,Severe
7,1,85,M,77,10,11,131,46,Well
12,11,155,M,56,8,9,105,-50,Severe
6,6,78,F,103,13,6,162,84,Well
5,9,69,F,53,8,6,102,33,Well
7,7,91,M,79,11,1,133,42,Well
18,8,224,F,61,9,3,111,-113,Severe
8,5,101,F,20,6,2,74,-27,Severe
11,11,143,M,82,11,5,137,-6,Severe
16,9,201,M,29,6,8,80,-121,Severe
12,0,144,M,106,13,10,166,22,Well
18,8,224,F,66,9,9,117,-107,Severe
7,7,91,F,68,10,0,120,29,Well
7,1,85,F,82,11,5,137,52,Well
6,6,78,M,62,9,4,112,34,Well
5,2,62,F,37,7,3,87,25,Well
10,8,128,M,61,9,3,111,-17,Severe
10,0,120,F,81,11,4,136,16,Well
5,3,63,M,110,14,3,171,108,Well
12,8,152,M,4,5,4,64,-88,Severe
12,0,144,F,47,8,0,96,-48,Severe
10,3,123,M,50,8,3,99,-24,Severe
5,0,60,F,93,12,6,150,90,Well
7,3,87,F,10,5,7,67,-20,Severe
12,3,147,M,100,13,3,159,12,Well
15,5,185,M,36,7,2,86,-99,Severe
9,3,111,F,106,13,10,166,55,Well
5,9,69,M,46,7,11,95,26,Well
17,4,208,F,10,5,7,67,-141,Severe
9,0,108,M,75,10,9,129,21,Well
6,3,75,F,105,13,9,165,90,Well
9,0,108,F,64,9,7,115,7,Well
15,11,191,M,109,14,1,169,-22,Severe
11,3,135,F,2,5,3,63,-72,Severe
7,5,89,F,100,13,3,159,70,Well
13,3,159,M,96,12,10,154,-5,Mild
8,2,98,F,12,5,9,69,-29,Severe
14,6,174,M,62,9,4,112,-62,Severe
16,2,194,F,27,6,7,79,-115,Severe
8,3,99,F,77,10,11,131,32,Well
17,2,206,F,40,7,5,89,-117,Severe
9,10,118,F,67,9,10,118,0,Neutral
18,11,227,F,94,12,7,151,-76,Severe
16,3,195,M,50,8,3,99,-96,Severe
12,0,144,F,13,5,9,69,-75,Severe
14,3,171,M,74,10,7,127,-44,Severe
18,8,224,F,19,6,1,73,-151,Severe
7,3,87,M,2,5,3,63,-24,Severe
7,7,91,M,90,12,3,147,56,Well
9,3,111,M,2,5,3,63,-48,Severe
7,9,93,M,96,12,10,154,61,Well
17,2,206,M,57,8,10,106,-100,Severe
14,7,175,F,70,10,2,122,-53,Severe
8,10,106,M,42,7,7,91,-15,Severe
6,7,79,M,65,9,8,116,37,Well
18,7,223,F,88,12,0,144,-79,Severe
5,4,64,M,80,11,3,135,71,Well
5,1,61,F,92,12,5,149,88,Well
12,9,153,M,110,14,3,171,18,Well
9,10,118,M,85,11,9,141,23,Well
16,3,195,F,82,11,5,137,-58,Severe
10,2,122,F,37,7,3,87,-35,Severe
14,6,174,F,104,13,7,163,-11,Severe
10,1,121,M,50,8,3,99,-22,Severe
17,0,204,F,25,6,5,77,-127,Severe
18,11,227,F,76,10,10,130,-97,Severe
5,0,60,M,90,12,3,147,87,Well
15,11,191,M,78,11,0,132,-59,Severe
18,4,220,M,39,7,5,89,-131,Severe
18,11,227,M,108,14,0,168,-59,Severe
13,3,159,M,103,13,6,162,3,Good
17,7,211,M,15,5,11,71,-140,Severe
8,8,104,M,75,10,9,129,25,Well
15,0,180,M,39,7,5,89,-91,Severe
17,8,212,F,59,9,1,109,-103,Severe
17,7,211,F,72,10,4,124,-87,Severe
15,5,185,F,81,11,4,136,-49,Severe
8,6,102,M,37,7,3,87,-15,Severe
13,9,165,F,75,10,9,129,-36,Severe
5,8,68,M,9,5,7,67,-1,Mild
18,2,218,M,75,10,9,129,-89,Severe
17,4,208,F,29,6,8,80,-128,Severe
13,6,162,F,61,9,3,111,-51,Severe
10,5,125,M,27,6,7,79,-46,Severe
9,8,116,F,49,8,2,98,-18,Severe
17,1,205,M,68,10,0,120,-85,Severe
15,1,181,F,89,12,1,145,-36,Severe
6,11,83,F,21,6,2,74,-9,Severe
9,11,119,F,96,12,10,154,35,Well
15,1,181,F,12,5,9,69,-112,Severe
17,10,214,F,105,13,9,165,-49,Severe
14,10,178,M,108,14,0,168,-10,Severe
10,6,126,M,13,5,9,69,-57,Severe
15,11,191,M,89,12,1,145,-46,Severe
13,6,162,M,8,5,6,66,-96,Severe
13,3,159,F,98,13,0,156,-3,Mild
12,5,149,F,11,5,8,68,-81,Severe
12,1,145,F,72,10,4,124,-21,Severe
16,0,192,M,60,9,2,110,-82,Severe
5,5,65,M,42,7,7,91,26,Well
7,11,95,F,58,9,0,108,13,Well
17,7,211,F,61,9,3,111,-100,Severe
16,6,198,F,84,11,7,139,-59,Severe
5,9,69,F,26,6,6,78,9,Well
15,3,183,F,44,7,9,93,-90,Severe
18,9,225,F,42,7,7,91,-134,Severe
8,8,104,F,28,6,8,80,-24,Severe
16,3,195,M,68,10,0,120,-75,Severe
5,7,67,F,39,7,5,89,22,Well
13,1,157,M,9,5,7,67,-90,Severe
15,9,189,F,71,10,3,123,-66,Severe
8,1,97,M,19,6,1,73,-24,Severe
12,7,151,M,73,10,6,126,-25,Severe
7,9,93,M,110,14,3,171,78,Well
10,6,126,M,84,11,7,139,13,Well
11,10,142,M,7,5,6,66,-76,Severe
6,0,72,M,90,12,3,147,75,Well
15,10,190,F,73,10,6,126,-64,Severe
13,2,158,M,102,13,6,162,4,Good
12,7,151,F,44,7,9,93,-58,Severe
11,0,132,M,59,9,1,109,-23,Severe
6,1,73,F,101,13,4,160,87,Well
7,5,89,M,33,6,11,83,-6,Severe
8,8,104,F,15,5,11,71,-33,Severe
18,9,225,F,63,9,6,114,-111,Severe
14,7,175,M,16,5,11,71,-104,Severe
13,5,161,M,83,11,6,138,-23,Severe
15,6,186,M,58,9,0,108,-78,Severe
8,0,96,M,12,5,9,69,-27,Severe
16,10,202,M,15,5,11,71,-131,Severe
15,9,189,M,5,5,5,65,-124,Severe
17,0,204,F,61,9,3,111,-93,Severe
16,7,199,F,11,5,8,68,-131,Severe
14,10,178,M,25,6,5,77,-101,Severe
9,3,111,F,76,10,10,130,19,Well
8,3,99,F,47,8,0,96,-3,Mild
14,9,177,F,63,9,6,114,-63,Severe
11,4,136,M,88,12,0,144,8,Well
8,10,106,F,24,6,5,77,-29,Severe
12,6,150,M,30,6,9,81,-69,Severe
11,10,142,F,106,13,10,166,24,Well
6,3,75,M,83,11,6,138,63,Well
17,8,212,F,4,5,4,64,-148,Severe
5,10,70,M,65,9,8,116,46,Well
16,2,194,F,42,7,7,91,-103,Severe
5,11,71,M,65,9,8,116,45,Well
7,3,87,M,106,13,10,166,79,Well
16,5,197,F,32,6,10,82,-115,Severe
5,4,64,M,28,6,8,80,16,Well
17,3,207,M,47,8,0,96,-111,Severe
11,0,132,M,51,8,4,100,-32,Severe
11,6,138,F,82,11,5,137,-1,Mild
5,3,63,F,77,10,11,131,68,Well
12,4,148,M,87,11,11,143,-5,Mild
10,3,123,F,52,8,5,101,-22,Severe
14,2,170,M,60,9,2,110,-60,Severe
10,8,128,F,96,12,10,154,26,Well
11,3,135,F,4,5,4,64,-71,Severe
6,3,75,M,65,9,8,116,41,Well
12,1,145,M,29,6,8,80,-65,Severe
17,9,213,M,52,8,5,101,-112,Severe
17,4,208,M,32,6,10,82,-126,Severe
14,6,174,M,8,5,6,66,-108,Severe
18,2,218,M,34,7,0,84,-134,Severe
18,7,223,F,78,11,0,132,-91,Severe
7,7,91,M,28,6,8,80,-11,Severe
10,3,123,M,60,9,2,110,-13,Severe
9,9,117,M,64,9,7,115,-2,Mild
8,0,96,F,55,8,8,104,8,Well
18,6,222,M,110,14,3,171,-51,Severe
12,0,144,M,47,8,0,96,-48,Severe
7,10,94,M,54,8,7,103,9,Well
16,11,203,M,41,7,6,90,-113,Severe
9,6,114,M,7,5,6,66,-48,Severe
5,5,65,F,20,6,2,74,9,Well
15,8,188,M,4,5,4,64,-124,Severe
6,9,81,F,89,12,1,145,64,Well
10,2,122,M,86,11,10,142,20,Well
9,6,114,M,28,6,8,80,-34,Severe
14,0,168,F,5,5,5,65,-103,Severe
8,1,97,F,53,8,6,102,5,Good
6,11,83,F,30,6,9,81,-2,Mild
5,3,63,F,64,9,7,115,52,Well
9,7,115,M,68,10,0,120,5,Good
8,6,102,F,93,12,6,150,48,Well
9,11,119,M,16,5,11,71,-48,Severe
18,3,219,F,6,5,5,65,-154,Severe
12,3,147,F,38,7,4,88,-59,Severe
10,5,125,F,88,12,0,144,19,Well
5,3,63,M,51,8,4,100,37,Well
18,1,217,M,16,5,11,71,-146,Severe
17,6,210,F,78,11,0,132,-78,Severe
15,0,180,M,104,13,7,163,-17,Severe
13,2,158,M,70,10,2,122,-36,Severe
15,4,184,F,31,6,9,81,-103,Severe
16,6,198,M,86,11,10,142,-56,Severe
9,9,117,F,46,7,11,95,-22,Severe
12,3,147,M,28,6,8,80,-67,Severe
11,9,141,F,52,8,5,101,-40,Severe
13,5,161,M,34,7,0,84,-77,Severe
14,4,172,M,40,7,5,89,-83,Severe
5,7,67,M,16,5,11,71,4,Good
16,4,196,F,80,11,3,135,-61,Severe
16,0,192,M,24,6,5,77,-115,Severe
18,8,224,M,94,12,7,151,-73,Severe
6,0,72,F,98,13,0,156,84,Well
6,0,72,M,8,5,6,66,-6,Severe
15,3,183,F,49,8,2,98,-85,Severe
15,1,181,M,61,9,3,111,-70,Severe
7,10,94,F,24,6,5,77,-17,Severe
5,3,63,M,52,8,5,101,38,Well
12,1,145,M,48,8,1,97,-48,Severe
12,1,145,M,43,7,8,92,-53,Severe
18,7,223,F,45,7,10,94,-129,Severe
8,6,102,F,29,6,8,80,-22,Severe
18,7,223,M,70,10,2,122,-101,Severe
7,9,93,M,79,11,1,133,40,Well
10,3,123,M,88,12,0,144,21,Well
17,1,205,M,15,5,11,71,-134,Severe
15,8,188,F,6,5,5,65,-123,Severe
6,2,74,M,23,6,4,76,2,Good
13,3,159,F,17,6,0,72,-87,Severe
18,3,219,M,19,6,1,73,-146,Severe
7,3,87,F,103,13,6,162,75,Well
10,9,129,F,54,8,7,103,-26,Severe
5,6,66,F,6,5,5,65,-1,Mild
13,11,167,M,17,6,0,72,-95,Severe
12,8,152,M,51,8,4,100,-52,Severe
14,6,174,F,20,6,2,74,-100,Severe
17,3,207,F,37,7,3,87,-120,Severe
6,1,73,F,27,6,7,79,6,Well
18,4,220,M,57,8,10,106,-114,Severe
10,6,126,F,42,7,7,91,-35,Severe
14,9,177,M,58,9,0,108,-69,Severe
17,0,204,F,45,7,10,94,-110,Severe
14,2,170,M,53,8,6,102,-68,Severe
11,1,133,F,9,5,7,67,-66,Severe
11,10,142,M,80,11,3,135,-7,Severe
8,3,99,F,22,6,3,75,-24,Severe
12,3,147,F,12,5,9,69,-78,Severe
11,6,138,F,3,5,3,63,-75,Severe
18,11,227,M,83,11,6,138,-89,Severe
13,8,164,M,107,13,11,167,3,Good
16,6,198,M,7,5,6,66,-132,Severe
14,4,172,M,15,5,11,71,-101,Severe
5,6,66,M,31,6,9,81,15,Well
5,8,68,M,108,14,0,168,100,Well
13,3,159,M,15,5,11,71,-88,Severe
10,0,120,M,98,13,0,156,36,Well
12,0,144,M,5,5,5,65,-79,Severe
13,4,160,F,96,12,10,154,-6,Severe
18,0,216,M,12,5,9,69,-147,Severe
11,10,142,M,54,8,7,103,-39,Severe
10,11,131,F,59,9,1,109,-22,Severe
10,6,126,M,6,5,5,65,-61,Severe
13,1,157,F,86,11,10,142,-15,Severe
17,3,207,F,34,7,0,84,-123,Severe
12,4,148,M,58,9,0,108,-40,Severe
17,6,210,F,99,13,1,157,-53,Severe
15,9,189,M,11,5,8,68,-121,Severe
16,8,200,F,61,9,3,111,-89,Severe
9,1,109,F,102,13,6,162,53,Well
14,7,175,M,95,12,9,153,-22,Severe
12,4,148,M,64,9,7,115,-33,Severe
6,11,83,F,40,7,5,89,6,Well
10,5,125,M,106,13,10,166,41,Well
15,7,187,M,65,9,8,116,-71,Severe
13,9,165,M,102,13,6,162,-3,Mild
8,9,105,F,54,8,7,103,-2,Mild
17,4,208,F,89,12,1,145,-63,Severe
13,5,161,F,3,5,3,63,-98,Severe
16,7,199,F,91,12,4,148,-51,Severe
8,9,105,F,95,12,9,153,48,Well
17,2,206,F,107,13,11,167,-39,Severe
5,5,65,M,86,11,10,142,77,Well
12,2,146,M,59,9,1,109,-37,Severe
14,10,178,F,44,7,9,93,-85,Severe
11,10,142,M,90,12,3,147,5,Good
15,3,183,M,103,13,6,162,-21,Severe
11,8,140,M,9,5,7,67,-73,Severe
13,10,166,F,39,7,5,89,-77,Severe
14,10,178,F,60,9,2,110,-68,Severe
16,3,195,F,37,7,3,87,-108,Severe
9,1,109,M,22,6,3,75,-34,Severe
9,10,118,F,37,7,3,87,-31,Severe
11,8,140,F,44,7,9,93,-47,Severe
16,6,198,M,89,12,1,145,-53,Severe
14,4,172,M,74,10,7,127,-45,Severe
12,3,147,F,92,12,5,149,2,Good
14,4,172,F,8,5,6,66,-106,Severe
5,4,64,F,76,10,10,130,66,Well
11,7,139,F,46,7,11,95,-44,Severe
7,10,94,F,25,6,5,77,-17,Severe
11,3,135,M,11,5,8,68,-67,Severe
16,7,199,M,101,13,4,160,-39,Severe
11,1,133,F,44,7,9,93,-40,Severe
18,5,221,M,29,6,8,80,-141,Severe
7,10,94,M,56,8,9,105,11,Well
18,1,217,F,14,5,10,70,-147,Severe
15,0,180,F,53,8,6,102,-78,Severe
6,5,77,M,35,7,1,85,8,Well
18,1,217,F,23,6,4,76,-141,Severe
5,1,61,M,41,7,6,90,29,Well
8,2,98,M,36,7,2,86,-12,Severe
14,7,175,F,39,7,5,89,-86,Severe
18,0,216,M,31,6,9,81,-135,Severe
6,5,77,F,28,6,8,80,3,Good
6,3,75,M,24,6,5,77,2,Good
18,5,221,M,25,6,5,77,-144,Severe
5,1,61,F,39,7,5,89,28,Well
12,5,149,F,70,10,2,122,-27,Severe
18,2,218,F,31,6,9,81,-137,Severe
9,1,109,M,40,7,5,89,-20,Severe
16,6,198,F,70,10,2,122,-76,Severe
13,4,160,F,101,13,4,160,0,Neutral
8,11,107,M,56,8,9,105,-2,Mild
6,2,74,F,107,13,11,167,93,Well
7,2,86,M,88,12,0,144,58,Well
8,2,98,F,85,11,9,141,43,Well
9,8,116,F,110,14,3,171,55,Well
6,3,75,F,65,9,8,116,41,Well
18,8,224,M,101,13,4,160,-64,Severe
5,3,63,M,22,6,3,75,12,Well
14,2,170,M,58,9,0,108,-62,Severe
14,1,169,M,82,11,5,137,-32,Severe
9,10,118,M,81,11,4,136,18,Well
6,7,79,M,19,6,1,73,-6,Severe
18,10,226,F,43,7,8,92,-134,Severe
5,5,65,M,30,6,9,81,16,Well
11,2,134,M,20,6,2,74,-60,Severe
14,9,177,F,24,6,5,77,-100,Severe
13,3,159,M,19,6,1,73,-86,Severe
13,5,161,F,29,6,8,80,-81,Severe
6,8,80,F,22,6,3,75,-5,Mild
9,9,117,M,39,7,5,89,-28,Severe
9,3,111,F,6,5,5,65,-46,Severe
15,2,182,M,7,5,6,66,-116,Severe
9,9,117,M,46,7,11,95,-22,Severe
15,4,184,M,105,13,9,165,-19,Severe
15,0,180,M,93,12,6,150,-30,Severe
12,2,146,F,64,9,7,115,-31,Severe
15,0,180,M,85,11,9,141,-39,Severe
7,10,94,M,86,11,10,142,48,Well
12,6,150,M,3,5,3,63,-87,Severe
15,10,190,F,33,6,11,83,-107,Severe
16,7,199,F,108,14,0,168,-31,Severe
10,6,126,M,9,5,7,67,-59,Severe
5,0,60,M,2,5,3,63,3,Good
7,3,87,M,19,6,1,73,-14,Severe
11,9,141,M,14,5,10,70,-71,Severe
13,11,167,F,80,11,3,135,-32,Severe
10,5,125,M,36,7,2,86,-39,Severe
11,4,136,F,82,11,5,137,1,Good
9,3,111,F,68,10,0,120,9,Well
10,5,125,F,18,6,1,73,-52,Severe
12,5,149,F,28,6,8,80,-69,Severe
5,1,61,F,4,5,4,64,3,Good
16,4,196,F,54,8,7,103,-93,Severe
13,4,160,M,66,9,9,117,-43,Severe
5,1,61,F,68,10,0,120,59,Well
9,3,111,F,85,11,9,141,30,Well
13,1,157,F,82,11,5,137,-20,Severe
17,5,209,M,93,12,6,150,-59,Severe
13,10,166,M,6,5,5,65,-101,Severe
7,10,94,F,51,8,4,100,6,Well
13,3,159,M,90,12,3,147,-12,Severe
12,4,148,F,22,6,3,75,-73,Severe
10,10,130,M,78,11,0,132,2,Good
14,3,171,M,39,7,5,89,-82,Severe
13,10,166,F,22,6,3,75,-91,Severe
12,9,153,F,15,5,11,71,-82,Severe
5,7,67,F,54,8,7,103,36,Well
8,1,97,M,89,12,1,145,48,Well
11,3,135,M,91,12,4,148,13,Well
17,7,211,M,37,7,3,87,-124,Severe
11,3,135,M,29,6,8,80,-55,Severe
11,11,143,F,47,8,0,96,-47,Severe
10,0,120,M,65,9,8,116,-4,Mild
5,5,65,F,46,7,11,95,30,Well
14,6,174,M,59,9,1,109,-65,Severe
14,8,176,M,50,8,3,99,-77,Severe
5,4,64,M,105,13,9,165,101,Well
16,5,197,M,9,5,7,67,-130,Severe
5,11,71,F,13,5,9,69,-2,Mild
11,1,133,F,105,13,9,165,32,Well
10,4,124,M,94,12,7,151,27,Well
5,5,65,M,66,9,9,117,52,Well
5,5,65,F,88,12,0,144,79,Well
17,0,204,M,101,13,4,160,-44,Severe
18,8,224,F,47,8,0,96,-128,Severe
18,10,226,M,76,10,10,130,-96,Severe
7,10,94,F,37,7,3,87,-7,Severe
15,5,185,F,98,13,0,156,-29,Severe
7,10,94,F,47,8,0,96,2,Good
11,3,135,F,12,5,9,69,-66,Severe
6,1,73,F,105,13,9,165,92,Well
7,11,95,M,6,5,5,65,-30,Severe
17,3,207,F,95,12,9,153,-54,Severe
13,6,162,F,102,13,6,162,0,Neutral
12,8,152,F,85,11,9,141,-11,Severe
14,3,171,M,110,14,3,171,0,Neutral
12,9,153,F,85,11,9,141,-12,Severe
10,9,129,F,89,12,1,145,16,Well
15,5,185,M,88,12,0,144,-41,Severe
13,0,156,F,32,6,10,82,-74,Severe
17,10,214,F,83,11,6,138,-76,Severe
17,3,207,F,55,8,8,104,-103,Severe
15,8,188,M,72,10,4,124,-64,Severe
17,5,209,M,65,9,8,116,-93,Severe
9,3,111,M,89,12,1,145,34,Well
14,1,169,F,103,13,6,162,-7,Severe
6,3,75,M,16,5,11,71,-4,Mild
15,0,180,M,65,9,8,116,-64,Severe
5,7,67,F,15,5,11,71,4,Good
11,7,139,F,17,6,0,72,-67,Severe
10,2,122,F,65,9,8,116,-6,Severe
18,8,224,F,37,7,3,87,-137,Severe
14,8,176,F,86,11,10,142,-34,Severe
15,4,184,M,36,7,2,86,-98,Severe
8,0,96,F,7,5,6,66,-30,Severe
12,3,147,F,36,7,2,86,-61,Severe
8,10,106,F,30,6,9,81,-25,Severe
14,8,176,M,45,7,10,94,-82,Severe
10,0,120,M,8,5,6,66,-54,Severe
11,4,136,M,8,5,6,66,-70,Severe
6,7,79,M,70,10,2,122,43,Well
16,3,195,F,93,12,6,150,-45,Severe
17,2,206,F,73,10,6,126,-80,Severe
15,9,189,M,87,11,11,143,-46,Severe
12,0,144,M,81,11,4,136,-8,Severe
16,7,199,F,103,13,6,162,-37,Severe
6,7,79,M,24,6,5,77,-2,Mild
6,3,75,M,57,8,10,106,31,Well
7,1,85,M,12,5,9,69,-16,Severe
16,0,192,M,13,5,9,69,-123,Severe
10,6,126,F,77,10,11,131,5,Good
12,1,145,F,104,13,7,163,18,Well
9,6,114,F,58,9,0,108,-6,Severe
13,1,157,M,16,5,11,71,-86,Severe
15,1,181,M,32,6,10,82,-99,Severe
15,5,185,F,26,6,6,78,-107,Severe
8,5,101,F,53,8,6,102,1,Good
17,5,209,F,61,9,3,111,-98,Severe
16,4,196,M,92,12,5,149,-47,Severe
18,0,216,M,43,7,8,92,-124,Severe
13,10,166,F,37,7,3,87,-79,Severe
17,7,211,F,56,8,9,105,-106,Severe
10,5,125,F,105,13,9,165,40,Well
11,5,137,M,79,11,1,133,-4,Mild
16,8,200,M,14,5,10,70,-130,Severe
15,5,185,F,7,5,6,66,-119,Severe
11,3,135,M,63,9,6,114,-21,Severe
5,5,65,F,8,5,6,66,1,Good
10,0,120,M,80,11,3,135,15,Well
10,5,125,F,21,6,2,74,-51,Severe
7,1,85,M,4,5,4,64,-21,Severe
7,2,86,F,43,7,8,92,6,Well
17,7,211,M,20,6,2,74,-137,Severe
10,8,128,F,97,12,11,155,27,Well
12,1,145,M,44,7,9,93,-52,Severe
7,5,89,F,77,10,11,131,42,Well
6,6,78,M,103,13,6,162,84,Well
8,2,98,F,32,6,10,82,-16,Severe
10,3,123,M,62,9,4,112,-11,Severe
9,8,116,M,84,11,7,139,23,Well
11,6,138,M,80,11,3,135,-3,Mild
5,8,68,M,106,13,10,166,98,Well
5,11,71,F,87,11,11,143,72,Well
10,7,127,M,97,12,11,155,28,Well
13,11,167,M,103,13,6,162,-5,Mild
18,3,219,F,94,12,7,151,-68,Severe
5,11,71,M,26,6,6,78,7,Well
6,2,74,F,110,14,3,171,97,Well
7,5,89,M,55,8,8,104,15,Well
13,3,159,F,110,14,3,171,12,Well
10,8,128,M,69,10,1,121,-7,Severe
17,1,205,M,79,11,1,133,-72,Severe
11,1,133,F,20,6,2,74,-59,Severe
5,11,71,M,6,5,5,65,-6,Severe
12,4,148,F,5,5,5,65,-83,Severe
14,0,168,M,12,5,9,69,-99,Severe
17,2,206,M,38,7,4,88,-118,Severe
7,8,92,F,73,10,6,126,34,Well
12,5,149,F,59,9,1,109,-40,Severe
14,5,173,F,102,13,6,162,-11,Severe
15,8,188,M,30,6,9,81,-107,Severe
18,0,216,M,73,10,6,126,-90,Severe
18,3,219,F,106,13,10,166,-53,Severe
13,9,165,M,64,9,7,115,-50,Severe
7,10,94,M,2,5,3,63,-31,Severe
17,1,205,M,53,8,6,102,-103,Severe
17,3,207,F,98,13,0,156,-51,Severe
13,9,165,M,107,13,11,167,2,Good
9,3,111,F,4,5,4,64,-47,Severe
13,3,159,M,80,11,3,135,-24,Severe
10,0,120,F,2,5,3,63,-57,Severe
6,10,82,M,67,9,10,118,36,Well
16,5,197,F,53,8,6,102,-95,Severe
7,7,91,F,76,10,10,130,39,Well
10,0,120,F,56,8,9,105,-15,Severe
12,2,146,M,69,10,1,121,-25,Severe
17,5,209,F,69,10,1,121,-88,Severe
11,11,143,F,95,12,9,153,10,Well
10,4,124,F,39,7,5,89,-35,Severe
17,6,210,M,54,8,7,103,-107,Severe
16,9,201,F,18,6,1,73,-128,Severe
14,2,170,F,76,10,10,130,-40,Severe
11,4,136,F,12,5,9,69,-67,Severe
17,2,206,M,55,8,8,104,-102,Severe
18,0,216,F,103,13,6,162,-54,Severe
10,10,130,F,74,10,7,127,-3,Mild
18,9,225,M,33,6,11,83,-142,Severe
18,11,227,F,68,10,0,120,-107,Severe
9,11,119,M,43,7,8,92,-27,Severe
18,3,219,M,15,5,11,71,-148,Severe
17,5,209,F,30,6,9,81,-128,Severe
13,6,162,F,10,5,7,67,-95,Severe
14,5,173,M,39,7,5,89,-84,Severe
10,3,123,F,22,6,3,75,-48,Severe
8,4,100,F,33,6,11,83,-17,Severe
16,8,200,F,88,12,0,144,-56,Severe
11,3,135,F,107,13,11,167,32,Well
12,3,147,F,89,12,1,145,-2,Mild
15,2,182,F,75,10,9,129,-53,Severe
8,1,97,F,13,5,9,69,-28,Severe
14,0,168,F,30,6,9,81,-87,Severe
5,1,61,F,58,9,0,108,47,Well
15,8,188,M,101,13,4,160,-28,Severe
14,1,169,F,31,6,9,81,-88,Severe
12,4,148,M,71,10,3,123,-25,Severe
13,4,160,F,56,8,9,105,-55,Severe
14,10,178,F,41,7,6,90,-88,Severe
14,4,172,M,103,13,6,162,-10,Severe
10,7,127,F,32,6,10,82,-45,Severe
9,6,114,F,54,8,7,103,-11,Severe
15,8,188,F,82,11,5,137,-51,Severe
17,2,206,M,11,5,8,68,-138,Severe
11,9,141,F,56,8,9,105,-36,Severe
11,9,141,F,46,7,11,95,-46,Severe
13,4,160,F,98,13,0,156,-4,Mild
6,6,78,M,2,5,3,63,-15,Severe
6,3,75,M,64,9,7,115,40,Well
6,10,82,F,35,7,1,85,3,Good
14,8,176,M,66,9,9,117,-59,Severe
8,1,97,F,110,14,3,171,74,Well
16,0,192,F,75,10,9,129,-63,Severe
12,11,155,F,25,6,5,77,-78,Severe
5,3,63,M,102,13,6,162,99,Well
15,0,180,M,21,6,2,74,-106,Severe
13,4,160,M,59,9,1,109,-51,Severe
9,3,111,M,15,5,11,71,-40,Severe
8,5,101,F,106,13,10,166,65,Well
12,1,145,F,81,11,4,136,-9,Severe
13,2,158,F,96,12,10,154,-4,Mild
15,9,189,F,72,10,4,124,-65,Severe
18,10,226,F,92,12,5,149,-77,Severe
16,10,202,F,33,6,11,83,-119,Severe
5,7,67,F,99,13,1,157,90,Well
10,7,127,F,83,11,6,138,11,Well
14,8,176,F,63,9,6,114,-62,Severe
17,2,206,F,16,5,11,71,-135,Severe
9,8,116,F,20,6,2,74,-42,Severe
16,0,192,F,64,9,7,115,-77,Severe
13,1,157,F,69,10,1,121,-36,Severe
10,8,128,F,63,9,6,114,-14,Severe
7,6,90,M,31,6,9,81,-9,Severe
5,1,61,M,106,13,10,166,105,Well
6,3,75,M,61,9,3,111,36,Well
15,4,184,F,42,7,7,91,-93,Severe
18,2,218,F,78,11,0,132,-86,Severe
5,5,65,M,81,11,4,136,71,Well
15,10,190,F,98,13,0,156,-34,Severe
14,0,168,F,32,6,10,82,-86,Severe
14,11,179,M,66,9,9,117,-62,Severe
14,2,170,M,43,7,8,92,-78,Severe
10,3,123,M,66,9,9,117,-6,Severe
5,9,69,M,71,10,3,123,54,Well
8,5,101,F,87,11,11,143,42,Well
5,3,63,M,20,6,2,74,11,Well
6,2,74,M,9,5,7,67,-7,Severe
14,5,173,M,6,5,5,65,-108,Severe
13,1,157,M,11,5,8,68,-89,Severe
5,1,61,F,24,6,5,77,16,Well
12,9,153,F,38,7,4,88,-65,Severe
17,1,205,M,88,12,0,144,-61,Severe
6,6,78,F,65,9,8,116,38,Well
6,10,82,M,7,5,6,66,-16,Severe
6,0,72,M,49,8,2,98,26,Well
5,3,63,M,86,11,10,142,79,Well
13,8,164,M,26,6,6,78,-86,Severe
11,0,132,M,22,6,3,75,-57,Severe
10,10,130,M,44,7,9,93,-37,Severe
12,4,148,F,14,5,10,70,-78,Severe
14,9,177,M,47,8,0,96,-81,Severe
13,11,167,F,65,9,8,116,-51,Severe
7,2,86,F,65,9,8,116,30,Well
18,3,219,F,69,10,1,121,-98,Severe
13,3,159,M,34,7,0,84,-75,Severe
16,5,197,M,72,10,4,124,-73,Severe
5,1,61,F,6,5,5,65,4,Good
14,0,168,F,51,8,4,100,-68,Severe
10,3,123,M,19,6,1,73,-50,Severe
15,9,189,M,22,6,3,75,-114,Severe
7,4,88,F,18,6,1,73,-15,Severe
14,1,169,M,108,14,0,168,-1,Mild
13,9,165,F,18,6,1,73,-92,Severe
17,5,209,M,8,5,6,66,-143,Severe
7,1,85,F,6,5,5,65,-20,Severe
18,2,218,F,38,7,4,88,-130,Severe
14,0,168,F,17,6,0,72,-96,Severe
18,5,221,M,15,5,11,71,-150,Severe
11,0,132,M,71,10,3,123,-9,Severe
17,8,212,F,104,13,7,163,-49,Severe
8,4,100,M,37,7,3,87,-13,Severe
7,8,92,F,2,5,3,63,-29,Severe
13,5,161,F,73,10,6,126,-35,Severe
14,10,178,M,48,8,1,97,-81,Severe
15,9,189,F,49,8,2,98,-91,Severe
13,11,167,F,54,8,7,103,-64,Severe
5,3,63,F,78,11,0,132,69,Well
11,0,132,F,87,11,11,143,11,Well
15,3,183,M,13,5,9,69,-114,Severe
5,6,66,F,64,9,7,115,49,Well
15,9,189,F,41,7,6,90,-99,Severe
18,4,220,M,10,5,7,67,-153,Severe
15,2,182,M,79,11,1,133,-49,Severe
6,9,81,F,99,13,1,157,76,Well
7,2,86,M,31,6,9,81,-5,Mild
16,6,198,F,98,13,0,156,-42,Severe
13,0,156,M,27,6,7,79,-77,Severe
6,3,75,M,64,9,7,115,40,Well
8,0,96,M,55,8,8,104,8,Well
5,8,68,M,54,8,7,103,35,Well
5,2,62,M,11,5,8,68,6,Well
10,7,127,F,99,13,1,157,30,Well
16,11,203,M,32,6,10,82,-121,Severe
13,10,166,M,106,13,10,166,0,Neutral
12,11,155,M,68,10,0,120,-35,Severe
9,6,114,M,30,6,9,81,-33,Severe
18,0,216,F,51,8,4,100,-116,Severe
6,6,78,F,13,5,9,69,-9,Severe
6,0,72,F,70,10,2,122,50,Well
8,2,98,F,24,6,5,77,-21,Severe
9,5,113,F,68,10,0,120,7,Well
8,3,99,F,86,11,10,142,43,Well
10,9,129,F,37,7,3,87,-42,Severe
10,3,123,M,90,12,3,147,24,Well
8,8,104,F,86,11,10,142,38,Well
17,7,211,M,57,8,10,106,-105,Severe
15,7,187,F,28,6,8,80,-107,Severe
8,0,96,F,33,6,11,83,-13,Severe
7,2,86,M,75,10,9,129,43,Well
7,11,95,M,63,9,6,114,19,Well
12,0,144,F,11,5,8,68,-76,Severe
11,1,133,M,26,6,6,78,-55,Severe
11,3,135,F,48,8,1,97,-38,Severe
8,9,105,F,76,10,10,130,25,Well
9,3,111,F,28,6,8,80,-31,Severe
14,3,171,F,100,13,3,159,-12,Severe
13,3,159,F,45,7,10,94,-65,Severe
18,3,219,M,79,11,1,133,-86,Severe
12,3,147,F,99,13,1,157,10,Well
9,5,113,M,106,13,10,166,53,Well
7,5,89,M,42,7,7,91,2,Good
8,2,98,F,18,6,1,73,-25,Severe
7,3,87,M,46,7,11,95,8,Well
5,5,65,F,105,13,9,165,100,Well
14,1,169,F,29,6,8,80,-89,Severe
15,10,190,M,65,9,8,116,-74,Severe
5,6,66,F,85,11,9,141,75,Well
14,4,172,F,41,7,6,90,-82,Severe
14,3,171,M,91,12,4,148,-23,Severe
10,5,125,M,32,6,10,82,-43,Severe
17,3,207,F,69,10,1,121,-86,Severe
6,11,83,F,86,11,10,142,59,Well
14,9,177,F,22,6,3,75,-102,Severe
8,2,98,F,2,5,3,63,-35,Severe
5,0,60,M,8,5,6,66,6,Well
9,7,115,M,2,5,3,63,-52,Severe
5,8,68,M,102,13,6,162,94,Well
14,5,173,F,19,6,1,73,-100,Severe
6,3,75,F,84,11,7,139,64,Well
13,3,159,M,17,6,0,72,-87,Severe
8,0,96,M,36,7,2,86,-10,Severe
16,3,195,F,85,11,9,141,-54,Severe
5,0,60,M,60,9,2,110,50,Well
10,11,131,F,21,6,2,74,-57,Severe
9,11,119,F,97,12,11,155,36,Well
5,0,60,M,91,12,4,148,88,Well
5,3,63,F,31,6,9,81,18,Well
18,7,223,M,99,13,1,157,-66,Severe
15,1,181,F,8,5,6,66,-115,Severe
15,10,190,M,60,9,2,110,-80,Severe
5,3,63,M,71,10,3,123,60,Well
7,3,87,F,106,13,10,166,79,Well
7,3,87,M,75,10,9,129,42,Well
10,7,127,M,29,6,8,80,-47,Severe
8,5,101,F,68,10,0,120,19,Well
17,10,214,F,49,8,2,98,-116,Severe
17,7,211,F,65,9,8,116,-95,Severe
11,4,136,M,97,12,11,155,19,Well
11,4,136,M,87,11,11,143,7,Well
7,7,91,M,104,13,7,163,72,Well
5,8,68,F,98,13,0,156,88,Well
10,10,130,F,9,5,7,67,-63,Severe
11,5,137,M,73,10,6,126,-11,Severe
5,2,62,M,94,12,7,151,89,Well
18,4,220,M,103,13,6,162,-58,Severe
10,3,123,M,101,13,4,160,37,Well
17,11,215,M,62,9,4,112,-103,Severe
9,11,119,M,64,9,7,115,-4,Mild
6,3,75,M,39,7,5,89,14,Well
8,6,102,F,41,7,6,90,-12,Severe
14,3,171,F,29,6,8,80,-91,Severe
10,3,123,F,105,13,9,165,42,Well
12,0,144,F,90,12,3,147,3,Good
13,7,163,F,82,11,5,137,-26,Severe
6,10,82,M,42,7,7,91,9,Well
5,6,66,F,5,5,5,65,-1,Mild
12,7,151,M,18,6,1,73,-78,Severe
5,7,67,M,59,9,1,109,42,Well
13,3,159,F,74,10,7,127,-32,Severe
12,5,149,F,81,11,4,136,-13,Severe
14,0,168,M,110,14,3,171,3,Good
5,6,66,F,72,10,4,124,58,Well
15,0,180,M,83,11,6,138,-42,Severe
6,8,80,M,84,11,7,139,59,Well
17,2,206,M,27,6,7,79,-127,Severe
13,5,161,F,66,9,9,117,-44,Severe
11,4,136,F,69,10,1,121,-15,Severe
16,9,201,F,14,5,10,70,-131,Severe
16,6,198,M,53,8,6,102,-96,Severe
16,8,200,M,26,6,6,78,-122,Severe
7,9,93,M,104,13,7,163,70,Well
15,1,181,F,98,13,0,156,-25,Severe
14,7,175,M,38,7,4,88,-87,Severe
18,9,225,M,71,10,3,123,-102,Severe
11,8,140,M,106,13,10,166,26,Well
6,9,81,M,77,10,11,131,50,Well
7,3,87,M,81,11,4,136,49,Well
7,2,86,M,12,5,9,69,-17,Severe
16,2,194,F,78,11,0,132,-62,Severe
7,5,89,M,91,12,4,148,59,Well
11,3,135,F,13,5,9,69,-66,Severe
12,3,147,M,50,8,3,99,-48,Severe
6,4,76,M,5,5,5,65,-11,Severe
15,3,183,M,52,8,5,101,-82,Severe
10,0,120,F,58,9,0,108,-12,Severe
6,7,79,F,106,13,10,166,87,Well
11,3,135,M,88,12,0,144,9,Well
8,7,103,M,95,12,9,153,50,Well
8,5,101,M,47,8,0,96,-5,Mild
14,3,171,M,92,12,5,149,-22,Severe
9,11,119,M,29,6,8,80,-39,Severe
5,4,64,M,9,5,7,67,3,Good
12,1,145,M,9,5,7,67,-78,Severe
8,11,107,F,96,12,10,154,47,Well
5,10,70,M,46,7,11,95,25,Well
9,3,111,F,24,6,5,77,-34,Severe
8,9,105,M,60,9,2,110,5,Good
15,1,181,M,39,7,5,89,-92,Severe
16,1,193,M,95,12,9,153,-40,Severe
11,1,133,F,30,6,9,81,-52,Severe
13,10,166,M,52,8,5,101,-65,Severe
16,11,203,F,22,6,3,75,-128,Severe
14,8,176,M,49,8,2,98,-78,Severe
17,4,208,F,36,7,2,86,-122,Severe
14,3,171,M,102,13,6,162,-9,Severe
6,3,75,F,79,11,1,133,58,Well
7,4,88,F,31,6,9,81,-7,Severe
7,8,92,F,11,5,8,68,-24,Severe
18,1,217,M,61,9,3,111,-106,Severe
14,3,171,F,101,13,4,160,-11,Severe
7,11,95,F,42,7,7,91,-4,Mild
13,6,162,F,79,11,1,133,-29,Severe
10,6,126,F,93,12,6,150,24,Well
16,5,197,M,104,13,7,163,-34,Severe
17,9,213,F,9,5,7,67,-146,Severe
14,0,168,M,36,7,2,86,-82,Severe
5,4,64,F,75,10,9,129,65,Well
13,7,163,M,11,5,8,68,-95,Severe
9,6,114,F,76,10,10,130,16,Well
8,1,97,F,99,13,1,157,60,Well
15,3,183,F,41,7,6,90,-93,Severe
14,11,179,M,60,9,2,110,-69,Severe
5,2,62,F,41,7,6,90,28,Well
6,2,74,F,43,7,8,92,18,Well
6,7,79,M,42,7,7,91,12,Well
14,7,175,F,107,13,11,167,-8,Severe
18,4,220,M,20,6,2,74,-146,Severe
6,8,80,M,47,8,0,96,16,Well
5,1,61,F,14,5,10,70,9,Well
11,4,136,M,22,6,3,75,-61,Severe
14,2,170,F,11,5,8,68,-102,Severe
8,11,107,F,94,12,7,151,44,Well
14,1,169,F,98,13,0,156,-13,Severe
11,5,137,M,2,5,3,63,-74,Severe
9,4,112,F,68,10,0,120,8,Well
12,3,147,M,98,13,0,156,9,Well
12,0,144,M,14,5,10,70,-74,Severe
12,6,150,F,41,7,6,90,-60,Severe
18,10,226,F,83,11,6,138,-88,Severe
6,2,74,M,106,13,10,166,92,Well
7,8,92,F,74,10,7,127,35,Well
11,3,135,M,60,9,2,110,-25,Severe
10,3,123,M,72,10,4,124,1,Good
7,7,91,M,4,5,4,64,-27,Severe
13,4,160,F,103,13,6,162,2,Good
10,2,122,F,40,7,5,89,-33,Severe
12,1,145,M,22,6,3,75,-70,Severe
7,5,89,F,107,13,11,167,78,Well
18,7,223,M,104,13,7,163,-60,Severe
15,0,180,F,26,6,6,78,-102,Severe
18,8,224,F,38,7,4,88,-136,Severe
14,0,168,M,46,7,11,95,-73,Severe
17,6,210,F,53,8,6,102,-108,Severe
17,2,206,M,30,6,9,81,-125,Severe
7,6,90,F,27,6,7,79,-11,Severe
17,0,204,M,71,10,3,123,-81,Severe
12,5,149,M,110,14,3,171,22,Well
6,10,82,F,44,7,9,93,11,Well
15,6,186,M,50,8,3,99,-87,Severe
12,9,153,F,41,7,6,90,-63,Severe
11,7,139,M,37,7,3,87,-52,Severe
17,2,206,M,91,12,4,148,-58,Severe
12,2,146,M,36,7,2,86,-60,Severe
11,7,139,M,77,10,11,131,-8,Severe
13,5,161,F,13,5,9,69,-92,Severe
5,6,66,F,62,9,4,112,46,Well
14,1,169,F,99,13,1,157,-12,Severe
6,7,79,M,43,7,8,92,13,Well
18,8,224,F,82,11,5,137,-87,Severe
7,9,93,M,24,6,5,77,-16,Severe
10,6,126,M,24,6,5,77,-49,Severe
7,2,86,M,43,7,8,92,6,Well
9,3,111,F,98,13,0,156,45,Well
7,11,95,F,23,6,4,76,-19,Severe
13,4,160,M,52,8,5,101,-59,Severe
8,1,97,F,52,8,5,101,4,Good
15,9,189,M,42,7,7,91,-98,Severe
13,5,161,M,98,13,0,156,-5,Mild
6,2,74,F,57,8,10,106,32,Well
11,8,140,F,25,6,5,77,-63,Severe
11,11,143,F,86,11,10,142,-1,Mild
16,5,197,F,94,12,7,151,-46,Severe
8,10,106,F,58,9,0,108,2,Good
5,4,64,M,101,13,4,160,96,Well
16,9,201,F,85,11,9,141,-60,Severe
17,1,205,F,108,14,0,168,-37,Severe
11,6,138,M,77,10,11,131,-7,Severe
13,0,156,M,10,5,7,67,-89,Severe
13,0,156,F,31,6,9,81,-75,Severe
15,5,185,F,46,7,11,95,-90,Severe
6,7,79,F,97,12,11,155,76,Well
18,8,224,M,52,8,5,101,-123,Severe
8,7,103,M,2,5,3,63,-40,Severe
14,8,176,M,85,11,9,141,-35,Severe
5,7,67,M,65,9,8,116,49,Well
5,10,70,F,40,7,5,89,19,Well
8,8,104,F,79,11,1,133,29,Well
15,6,186,F,13,5,9,69,-117,Severe
8,11,107,F,84,11,7,139,32,Well
12,2,146,M,108,14,0,168,22,Well
12,11,155,F,42,7,7,91,-64,Severe
12,5,149,F,7,5,6,66,-83,Severe
11,7,139,F,15,5,11,71,-68,Severe
17,6,210,M,109,14,1,169,-41,Severe
18,1,217,F,24,6,5,77,-140,Severe
13,2,158,F,40,7,5,89,-69,Severe
10,11,131,M,75,10,9,129,-2,Mild
17,3,207,M,19,6,1,73,-134,Severe
14,7,175,F,56,8,9,105,-70,Severe
7,2,86,M,10,5,7,67,-19,Severe
8,2,98,F,43,7,8,92,-6,Severe
6,8,80,M,64,9,7,115,35,Well
9,4,112,F,73,10,6,126,14,Well
16,9,201,M,99,13,1,157,-44,Severe
7,11,95,F,19,6,1,73,-22,Severe
10,5,125,F,57,8,10,106,-19,Severe
6,6,78,M,48,8,1,97,19,Well
16,10,202,M,29,6,8,80,-122,Severe
17,3,207,F,79,11,1,133,-74,Severe
11,5,137,M,40,7,5,89,-48,Severe
18,2,218,M,19,6,1,73,-145,Severe
16,10,202,F,76,10,10,130,-72,Severe
17,9,213,F,18,6,1,73,-140,Severe
8,3,99,M,36,7,2,86,-13,Severe
14,8,176,F,33,6,11,83,-93,Severe
17,3,207,F,94,12,7,151,-56,Severe
11,1,133,M,91,12,4,148,15,Well
14,0,168,F,85,11,9,141,-27,Severe
18,3,219,M,57,8,10,106,-113,Severe
6,6,78,F,90,12,3,147,69,Well
12,1,145,F,7,5,6,66,-79,Severe
12,6,150,M,26,6,6,78,-72,Severe
18,0,216,M,90,12,3,147,-69,Severe
11,3,135,M,33,6,11,83,-52,Severe
10,2,122,M,94,12,7,151,29,Well
8,9,105,F,36,7,2,86,-19,Severe
7,4,88,F,83,11,6,138,50,Well
7,7,91,M,64,9,7,115,24,Well
11,11,143,M,18,6,1,73,-70,Severe
14,3,171,F,19,6,1,73,-98,Severe
15,4,184,F,17,6,0,72,-112,Severe
13,7,163,M,46,7,11,95,-68,Severe
5,2,62,M,55,8,8,104,42,Well
13,6,162,F,54,8,7,103,-59,Severe
5,3,63,M,78,11,0,132,69,Well
17,1,205,F,82,11,5,137,-68,Severe
14,7,175,F,18,6,1,73,-102,Severe
16,3,195,F,54,8,7,103,-92,Severe
6,8,80,F,3,5,3,63,-17,Severe
10,4,124,F,62,9,4,112,-12,Severe
6,11,83,M,52,8,5,101,18,Well
6,9,81,M,83,11,6,138,57,Well
11,3,135,F,65,9,8,116,-19,Severe
13,4,160,F,50,8,3,99,-61,Severe
6,8,80,M,78,11,0,132,52,Well
12,2,146,F,16,5,11,71,-75,Severe
8,9,105,M,9,5,7,67,-38,Severe
13,3,159,F,16,5,11,71,-88,Severe
5,5,65,M,28,6,8,80,15,Well
11,3,135,F,90,12,3,147,12,Well
16,5,197,M,13,5,9,69,-128,Severe
7,1,85,F,20,6,2,74,-11,Severe
12,3,147,F,104,13,7,163,16,Well
16,5,197,M,78,11,0,132,-65,Severe
14,2,170,M,73,10,6,126,-44,Severe
13,10,166,M,30,6,9,81,-85,Severe
11,11,143,M,107,13,11,167,24,Well
9,11,119,F,13,5,9,69,-50,Severe
11,2,134,F,106,13,10,166,32,Well
8,7,103,M,39,7,5,89,-14,Severe
11,3,135,F,108,14,0,168,33,Well
15,3,183,M,9,5,7,67,-116,Severe
16,3,195,M,71,10,3,123,-72,Severe
9,3,111,F,80,11,3,135,24,Well
7,9,93,M,107,13,11,167,74,Well
9,1,109,M,95,12,9,153,44,Well
8,8,104,F,107,13,11,167,63,Well
15,8,188,F,74,10,7,127,-61,Severe
6,9,81,M,101,13,4,160,79,Well
6,3,75,F,73,10,6,126,51,Well
12,9,153,F,50,8,3,99,-54,Severe
5,10,70,F,25,6,5,77,7,Well
11,1,133,F,106,13,10,166,33,Well
16,5,197,M,64,9,7,115,-82,Severe
17,4,208,M,46,7,11,95,-113,Severe
7,3,87,M,101,13,4,160,73,Well
18,3,219,F,108,14,0,168,-51,Severe
13,5,161,F,24,6,5,77,-84,Severe
6,3,75,M,21,6,2,74,-1,Mild
14,6,174,F,109,14,1,169,-5,Mild
17,2,206,F,27,6,7,79,-127,Severe
9,1,109,F,12,5,9,69,-40,Severe
8,10,106,F,8,5,6,66,-40,Severe
8,9,105,M,84,11,7,139,34,Well
10,10,130,F,81,11,4,136,6,Well
16,3,195,M,45,7,10,94,-101,Severe
17,3,207,M,12,5,9,69,-138,Severe
10,7,127,M,70,10,2,122,-5,Mild
6,8,80,M,95,12,9,153,73,Well
10,0,120,F,96,12,10,154,34,Well
16,10,202,F,21,6,2,74,-128,Severe
8,10,106,F,107,13,11,167,61,Well
13,1,157,M,107,13,11,167,10,Well
6,4,76,F,95,12,9,153,77,Well
5,6,66,M,14,5,10,70,4,Good
5,1,61,M,59,9,1,109,48,Well
18,1,217,M,91,12,4,148,-69,Severe
11,3,135,F,66,9,9,117,-18,Severe
17,9,213,M,105,13,9,165,-48,Severe
15,0,180,F,103,13,6,162,-18,Severe
5,7,67,F,6,5,5,65,-2,Mild
17,10,214,F,75,10,9,129,-85,Severe
14,11,179,F,4,5,4,64,-115,Severe
17,11,215,F,84,11,7,139,-76,Severe
7,2,86,M,81,11,4,136,50,Well
16,11,203,F,91,12,4,148,-55,Severe
16,9,201,M,79,11,1,133,-68,Severe
9,1,109,F,99,13,1,157,48,Well
7,3,87,F,63,9,6,114,27,Well
9,3,111,M,107,13,11,167,56,Well
12,6,150,F,98,13,0,156,6,Well
5,6,66,M,89,12,1,145,79,Well
9,3,111,M,56,8,9,105,-6,Severe
13,2,158,M,83,11,6,138,-20,Severe
12,11,155,F,71,10,3,123,-32,Severe
8,4,100,F,62,9,4,112,12,Well
18,11,227,M,31,6,9,81,-146,Severe
6,3,75,F,95,12,9,153,78,Well
15,8,188,M,57,8,10,106,-82,Severe
13,2,158,M,50,8,3,99,-59,Severe
5,1,61,M,65,9,8,116,55,Well
11,6,138,F,15,5,11,71,-67,Severe
7,6,90,M,41,7,6,90,0,Neutral
17,5,209,F,11,5,8,68,-141,Severe
9,10,118,M,30,6,9,81,-37,Severe
5,3,63,F,13,5,9,69,6,Well
18,2,218,F,71,10,3,123,-95,Severe
16,1,193,F,28,6,8,80,-113,Severe
15,2,182,F,16,5,11,71,-111,Severe
7,11,95,M,31,6,9,81,-14,Severe
6,11,83,M,107,13,11,167,84,Well
17,9,213,F,42,7,7,91,-122,Severe
15,2,182,F,48,8,1,97,-85,Severe
5,3,63,M,57,8,10,106,43,Well
13,4,160,M,39,7,5,89,-71,Severe
13,11,167,F,61,9,3,111,-56,Severe
8,8,104,M,9,5,7,67,-37,Severe
13,3,159,M,90,12,3,147,-12,Severe
5,1,61,F,19,6,1,73,12,Well
9,1,109,M,14,5,10,70,-39,Severe
7,4,88,F,51,8,4,100,12,Well
17,5,209,M,103,13,6,162,-47,Severe
15,4,184,M,79,11,1,133,-51,Severe
14,1,169,M,109,14,1,169,0,Neutral
5,1,61,M,3,5,3,63,2,Good
15,9,189,F,43,7,8,92,-97,Severe
17,6,210,M,84,11,7,139,-71,Severe
5,4,64,F,29,6,8,80,16,Well
8,8,104,F,82,11,5,137,33,Well
18,10,226,F,11,5,8,68,-158,Severe
12,10,154,M,77,10,11,131,-23,Severe
9,6,114,M,47,8,0,96,-18,Severe
17,7,211,M,58,9,0,108,-103,Severe
6,11,83,M,11,5,8,68,-15,Severe
8,7,103,F,104,13,7,163,60,Well
16,3,195,M,77,10,11,131,-64,Severe
12,10,154,M,34,7,0,84,-70,Severe
15,5,185,M,20,6,2,74,-111,Severe
6,3,75,F,18,6,1,73,-2,Mild
6,2,74,M,40,7,5,89,15,Well
14,4,172,F,17,6,0,72,-100,Severe
14,9,177,F,3,5,3,63,-114,Severe
12,9,153,M,34,7,0,84,-69,Severe
12,6,150,F,17,6,0,72,-78,Severe
13,0,156,M,109,14,1,169,13,Well
5,3,63,F,40,7,5,89,26,Well
17,0,204,M,34,7,0,84,-120,Severe
8,3,99,F,36,7,2,86,-13,Severe
8,0,96,M,17,6,0,72,-24,Severe
15,7,187,M,60,9,2,110,-77,Severe
15,6,186,M,38,7,4,88,-98,Severe
11,1,133,M,6,5,5,65,-68,Severe
11,8,140,F,17,6,0,72,-68,Severe
11,6,138,M,68,10,0,120,-18,Severe
7,7,91,M,49,8,2,98,7,Well
7,3,87,F,76,10,10,130,43,Well
11,8,140,M,33,6,11,83,-57,Severe
8,4,100,F,19,6,1,73,-27,Severe
11,3,135,F,104,13,7,163,28,Well
11,8,140,F,58,9,0,108,-32,Severe
6,3,75,M,4,5,4,64,-11,Severe
18,0,216,M,30,6,9,81,-135,Severe
7,7,91,F,44,7,9,93,2,Good
17,10,214,M,11,5,8,68,-146,Severe
15,7,187,M,63,9,6,114,-73,Severe
15,3,183,F,71,10,3,123,-60,Severe
17,0,204,F,43,7,8,92,-112,Severe
16,4,196,F,8,5,6,66,-130,Severe
18,9,225,F,92,12,5,149,-76,Severe
15,11,191,M,108,14,0,168,-23,Severe
11,2,134,F,51,8,4,100,-34,Severe
7,4,88,M,25,6,5,77,-11,Severe
8,4,100,M,4,5,4,64,-36,Severe
5,1,61,F,98,13,0,156,95,Well
14,3,171,F,99,13,1,157,-14,Severe
17,7,211,M,9,5,7,67,-144,Severe
9,3,111,F,52,8,5,101,-10,Severe
7,2,86,M,54,8,7,103,17,Well
5,0,60,M,103,13,6,162,102,Well
13,8,164,F,51,8,4,100,-64,Severe
8,2,98,F,81,11,4,136,38,Well
9,2,110,F,60,9,2,110,0,Neutral
5,4,64,M,21,6,2,74,10,Well
11,3,135,M,80,11,3,135,0,Neutral
7,9,93,M,44,7,9,93,0,Neutral
16,3,195,F,9,5,7,67,-128,Severe
8,10,106,F,31,6,9,81,-25,Severe
14,7,175,M,74,10,7,127,-48,Severe
13,6,162,F,63,9,6,114,-48,Severe
5,7,67,M,44,7,9,93,26,Well
7,11,95,F,40,7,5,89,-6,Severe
16,4,196,M,71,10,3,123,-73,Severe
18,2,218,M,59,9,1,109,-109,Severe
9,5,113,F,97,12,11,155,42,Well
9,10,118,M,9,5,7,67,-51,Severe
16,3,195,M,78,11,0,132,-63,Severe
18,3,219,F,86,11,10,142,-77,Severe
13,0,156,M,74,10,7,127,-29,Severe
15,11,191,M,75,10,9,129,-62,Severe
12,7,151,F,106,13,10,166,15,Well
10,1,121,F,45,7,10,94,-27,Severe
6,9,81,F,19,6,1,73,-8,Severe
12,5,149,M,24,6,5,77,-72,Severe
12,11,155,M,107,13,11,167,12,Well
12,6,150,F,89,12,1,145,-5,Mild
17,2,206,F,37,7,3,87,-119,Severe
18,3,219,M,110,14,3,171,-48,Severe
6,4,76,F,89,12,1,145,69,Well
6,8,80,F,86,11,10,142,62,Well
9,0,108,F,87,11,11,143,35,Well
13,5,161,M,14,5,10,70,-91,Severe
15,6,186,F,48,8,1,97,-89,Severe
8,6,102,M,61,9,3,111,9,Well
5,3,63,F,77,10,11,131,68,Well
13,10,166,F,8,5,6,66,-100,Severe
7,4,88,M,5,5,5,65,-23,Severe
14,7,175,M,37,7,3,87,-88,Severe
6,5,77,F,98,13,0,156,79,Well
6,7,79,M,100,13,3,159,80,Well
5,7,67,F,18,6,1,73,6,Well
17,3,207,M,77,10,11,131,-76,Severe
5,11,71,F,84,11,7,139,68,Well
6,10,82,M,100,13,3,159,77,Well
12,7,151,M,83,11,6,138,-13,Severe
11,8,140,M,75,10,9,129,-11,Severe
5,10,70,M,12,5,9,69,-1,Mild
5,3,63,F,14,5,10,70,7,Well
12,8,152,F,77,10,11,131,-21,Severe
8,3,99,F,60,9,2,110,11,Well
7,7,91,F,9,5,7,67,-24,Severe
18,10,226,F,3,5,3,63,-163,Severe
11,4,136,M,63,9,6,114,-22,Severe
5,4,64,F,106,13,10,166,102,Well
5,3,63,F,33,6,11,83,20,Well
11,3,135,M,50,8,3,99,-36,Severe
15,4,184,M,15,5,11,71,-113,Severe
8,4,100,F,5,5,5,65,-35,Severe
18,6,222,F,69,10,1,121,-101,Severe
18,9,225,F,62,9,4,112,-113,Severe
17,3,207,F,81,11,4,136,-71,Severe
11,1,133,M,48,8,1,97,-36,Severe
12,9,153,M,49,8,2,98,-55,Severe
13,0,156,M,28,6,8,80,-76,Severe
5,5,65,M,23,6,4,76,11,Well
6,1,73,M,97,12,11,155,82,Well
16,6,198,M,50,8,3,99,-99,Severe
14,0,168,F,76,10,10,130,-38,Severe
6,6,78,M,67,9,10,118,40,Well
10,7,127,F,43,7,8,92,-35,Severe
18,1,217,F,84,11,7,139,-78,Severe
11,5,137,F,11,5,8,68,-69,Severe
13,3,159,F,8,5,6,66,-93,Severe
18,11,227,M,17,6,0,72,-155,Severe
11,10,142,M,109,14,1,169,27,Well
5,1,61,M,101,13,4,160,99,Well
17,2,206,F,66,9,9,117,-89,Severe
14,8,176,F,24,6,5,77,-99,Severe
18,0,216,F,6,5,5,65,-151,Severe
5,8,68,M,60,9,2,110,42,Well
9,7,115,F,8,5,6,66,-49,Severe
18,0,216,F,93,12,6,150,-66,Severe
11,7,139,M,40,7,5,89,-50,Severe
13,0,156,F,35,7,1,85,-71,Severe
18,4,220,F,18,6,1,73,-147,Severe
10,3,123,F,31,6,9,81,-42,Severe
14,0,168,F,97,12,11,155,-13,Severe
5,0,60,M,34,7,0,84,24,Well
10,9,129,M,76,10,10,130,1,Good
13,5,161,M,54,8,7,103,-58,Severe
14,7,175,M,19,6,1,73,-102,Severe
15,8,188,F,47,8,0,96,-92,Severe
10,9,129,M,49,8,2,98,-31,Severe
6,2,74,M,65,9,8,116,42,Well
5,3,63,F,20,6,2,74,11,Well
12,10,154,M,63,9,6,114,-40,Severe
8,10,106,M,51,8,4,100,-6,Severe
12,3,147,M,15,5,11,71,-76,Severe
17,9,213,M,53,8,6,102,-111,Severe
18,9,225,M,22,6,3,75,-150,Severe
8,4,100,F,74,10,7,127,27,Well
18,3,219,F,5,5,5,65,-154,Severe
15,11,191,M,94,12,7,151,-40,Severe
18,2,218,M,69,10,1,121,-97,Severe
17,7,211,F,103,13,6,162,-49,Severe
11,7,139,F,54,8,7,103,-36,Severe
18,7,223,M,21,6,2,74,-149,Severe
9,2,110,F,86,11,10,142,32,Well
16,4,196,M,35,7,1,85,-111,Severe
11,9,141,M,40,7,5,89,-52,Severe
17,11,215,M,106,13,10,166,-49,Severe
15,2,182,M,89,12,1,145,-37,Severe
5,5,65,F,35,7,1,85,20,Well
17,0,204,M,17,6,0,72,-132,Severe
11,9,141,M,21,6,2,74,-67,Severe
14,7,175,M,4,5,4,64,-111,Severe
18,0,216,F,7,5,6,66,-150,Severe
12,3,147,F,62,9,4,112,-35,Severe
8,10,106,M,110,14,3,171,65,Well
8,5,101,M,22,6,3,75,-26,Severe
18,6,222,F,109,14,1,169,-53,Severe
6,0,72,M,93,12,6,150,78,Well
11,5,137,F,92,12,5,149,12,Well
13,11,167,F,105,13,9,165,-2,Mild
12,10,154,F,89,12,1,145,-9,Severe
9,9,117,M,62,9,4,112,-5,Mild
17,2,206,M,95,12,9,153,-53,Severe
10,2,122,M,65,9,8,116,-6,Severe
16,9,201,M,83,11,6,138,-63,Severe
5,3,63,F,59,9,1,109,46,Well
11,2,134,F,80,11,3,135,1,Good
15,0,180,F,18,6,1,73,-107,Severe
16,4,196,M,66,9,9,117,-79,Severe
13,2,158,F,74,10,7,127,-31,Severe
14,2,170,F,23,6,4,76,-94,Severe
9,7,115,M,109,14,1,169,54,Well
9,1,109,F,23,6,4,76,-33,Severe
17,2,206,F,33,6,11,83,-123,Severe
5,1,61,M,66,9,9,117,56,Well
17,3,207,M,80,11,3,135,-72,Severe
17,7,211,M,87,11,11,143,-68,Severe
6,2,74,M,45,7,10,94,20,Well
18,5,221,F,70,10,2,122,-99,Severe
9,3,111,M,61,9,3,111,0,Neutral
11,1,133,F,91,12,4,148,15,Well
11,10,142,M,88,12,0,144,2,Good
5,9,69,M,68,10,0,120,51,Well
9,7,115,M,41,7,6,90,-25,Severe
18,5,221,F,64,9,7,115,-106,Severe
15,3,183,F,85,11,9,141,-42,Severe
9,7,115,M,30,6,9,81,-34,Severe
15,6,186,M,85,11,9,141,-45,Severe
14,2,170,M,44,7,9,93,-77,Severe
9,11,119,M,18,6,1,73,-46,Severe
11,11,143,M,72,10,4,124,-19,Severe
5,8,68,M,12,5,9,69,1,Good
15,6,186,M,45,7,10,94,-92,Severe
10,2,122,F,102,13,6,162,40,Well
11,9,141,M,105,13,9,165,24,Well
12,5,149,M,30,6,9,81,-68,Severe
11,6,138,F,53,8,6,102,-36,Severe
16,3,195,F,11,5,8,68,-127,Severe
14,3,171,F,79,11,1,133,-38,Severe
14,5,173,F,57,8,10,106,-67,Severe
15,1,181,F,11,5,8,68,-113,Severe
13,7,163,M,98,13,0,156,-7,Severe
16,5,197,M,24,6,5,77,-120,Severe
10,11,131,F,60,9,2,110,-21,Severe
9,6,114,M,35,7,1,85,-29,Severe
15,10,190,M,18,6,1,73,-117,Severe
10,3,123,F,41,7,6,90,-33,Severe
18,9,225,F,28,6,8,80,-145,Severe
14,7,175,M,104,13,7,163,-12,Severe
13,1,157,F,62,9,4,112,-45,Severe
15,10,190,M,26,6,6,78,-112,Severe
16,5,197,M,100,13,3,159,-38,Severe
16,9,201,F,60,9,2,110,-91,Severe
10,10,130,M,79,11,1,133,3,Good
13,1,157,F,35,7,1,85,-72,Severe
9,5,113,M,40,7,5,89,-24,Severe
12,3,147,M,4,5,4,64,-83,Severe
12,3,147,F,64,9,7,115,-32,Severe
9,8,116,M,92,12,5,149,33,Well
18,2,218,M,58,9,0,108,-110,Severe
8,7,103,M,34,7,0,84,-19,Severe
12,0,144,M,61,9,3,111,-33,Severe
13,1,157,M,106,13,10,166,9,Well
5,9,69,F,82,11,5,137,68,Well
14,3,171,M,62,9,4,112,-59,Severe
17,10,214,M,3,5,3,63,-151,Severe
6,2,74,M,31,6,9,81,7,Well
16,6,198,F,75,10,9,129,-69,Severe
17,0,204,M,73,10,6,126,-78,Severe
10,5,125,M,80,11,3,135,10,Well
13,1,157,M,110,14,3,171,14,Well
15,8,188,M,66,9,9,117,-71,Severe
7,8,92,M,106,13,10,166,74,Well
6,10,82,M,32,6,10,82,0,Neutral
12,7,151,M,26,6,6,78,-73,Severe
16,3,195,F,76,10,10,130,-65,Severe
17,9,213,M,69,10,1,121,-92,Severe
10,3,123,F,10,5,7,67,-56,Severe
17,7,211,M,91,12,4,148,-63,Severe
10,1,121,F,91,12,4,148,27,Well
5,5,65,F,75,10,9,129,64,Well
14,1,169,M,22,6,3,75,-94,Severe
14,10,178,M,69,10,1,121,-57,Severe
18,7,223,F,80,11,3,135,-88,Severe
18,0,216,F,39,7,5,89,-127,Severe
7,7,91,F,31,6,9,81,-10,Severe
6,3,75,M,30,6,9,81,6,Well
12,0,144,F,102,13,6,162,18,Well
15,6,186,F,14,5,10,70,-116,Severe
10,8,128,F,71,10,3,123,-5,Mild
13,10,166,M,74,10,7,127,-39,Severe
16,3,195,M,30,6,9,81,-114,Severe
17,0,204,M,31,6,9,81,-123,Severe
15,3,183,M,44,7,9,93,-90,Severe
8,3,99,M,20,6,2,74,-25,Severe
10,9,129,M,26,6,6,78,-51,Severe
17,10,214,M,28,6,8,80,-134,Severe
13,2,158,M,84,11,7,139,-19,Severe
15,1,181,M,60,9,2,110,-71,Severe
7,3,87,M,97,12,11,155,68,Well
14,3,171,M,24,6,5,77,-94,Severe
10,3,123,M,36,7,2,86,-37,Severe
16,1,193,F,66,9,9,117,-76,Severe
5,0,60,M,50,8,3,99,39,Well
13,6,162,F,94,12,7,151,-11,Severe
7,1,85,F,11,5,8,68,-17,Severe
13,3,159,F,68,10,0,120,-39,Severe
5,11,71,F,67,9,10,118,47,Well
13,5,161,M,30,6,9,81,-80,Severe
13,3,159,M,67,9,10,118,-41,Severe
16,9,201,F,73,10,6,126,-75,Severe
9,9,117,F,31,6,9,81,-36,Severe
14,9,177,M,82,11,5,137,-40,Severe
12,6,150,M,12,5,9,69,-81,Severe
10,3,123,F,88,12,0,144,21,Well
11,0,132,F,72,10,4,124,-8,Severe
11,11,143,F,8,5,6,66,-77,Severe
18,9,225,F,104,13,7,163,-62,Severe
12,0,144,M,46,7,11,95,-49,Severe
5,3,63,F,2,5,3,63,0,Neutral
17,2,206,M,80,11,3,135,-71,Severe
8,7,103,M,110,14,3,171,68,Well
8,6,102,M,41,7,6,90,-12,Severe
6,3,75,M,63,9,6,114,39,Well
11,5,137,M,105,13,9,165,28,Well
14,0,168,F,15,5,11,71,-97,Severe
6,7,79,F,7,5,6,66,-13,Severe
16,6,198,F,31,6,9,81,-117,Severe
9,3,111,M,110,14,3,171,60,Well
13,9,165,M,97,12,11,155,-10,Severe
6,8,80,M,48,8,1,97,17,Well
8,7,103,F,72,10,4,124,21,Well
17,11,215,M,34,7,0,84,-131,Severe
8,3,99,M,97,12,11,155,56,Well
15,7,187,M,92,12,5,149,-38,Severe
8,9,105,F,28,6,8,80,-25,Severe
17,4,208,F,44,7,9,93,-115,Severe
13,7,163,M,31,6,9,81,-82,Severe
10,3,123,M,32,6,10,82,-41,Severe
6,9,81,M,20,6,2,74,-7,Severe
15,10,190,M,37,7,3,87,-103,Severe
16,5,197,F,3,5,3,63,-134,Severe
10,6,126,M,107,13,11,167,41,Well
7,0,84,F,7,5,6,66,-18,Severe
5,8,68,F,15,5,11,71,3,Good
7,7,91,M,60,9,2,110,19,Well
11,5,137,F,71,10,3,123,-14,Severe
11,3,135,M,61,9,3,111,-24,Severe
16,0,192,M,86,11,10,142,-50,Severe
7,11,95,M,71,10,3,123,28,Well
6,7,79,M,14,5,10,70,-9,Severe
9,8,116,F,103,13,6,162,46,Well
12,6,150,M,66,9,9,117,-33,Severe
10,4,124,F,86,11,10,142,18,Well
14,2,170,F,46,7,11,95,-75,Severe
5,8,68,F,75,10,9,129,61,Well
15,2,182,F,53,8,6,102,-80,Severe
14,3,171,F,47,8,0,96,-75,Severe
16,9,201,F,16,5,11,71,-130,Severe
12,9,153,F,106,13,10,166,13,Well
12,9,153,F,59,9,1,109,-44,Severe
15,9,189,M,93,12,6,150,-39,Severe
7,9,93,F,25,6,5,77,-16,Severe
6,8,80,F,107,13,11,167,87,Well
14,9,177,M,66,9,9,117,-60,Severe
10,8,128,M,62,9,4,112,-16,Severe
7,3,87,F,94,12,7,151,64,Well
8,4,100,F,66,9,9,117,17,Well
11,2,134,F,32,6,10,82,-52,Severe
5,8,68,M,59,9,1,109,41,Well
16,6,198,M,10,5,7,67,-131,Severe
8,8,104,F,93,12,6,150,46,Well
11,10,142,F,2,5,3,63,-79,Severe
6,8,80,F,26,6,6,78,-2,Mild
14,7,175,F,38,7,4,88,-87,Severe
13,9,165,M,40,7,5,89,-76,Severe
9,9,117,M,71,10,3,123,6,Well
15,1,181,M,72,10,4,124,-57,Severe
11,2,134,M,28,6,8,80,-54,Severe
16,5,197,M,11,5,8,68,-129,Severe
18,7,223,F,2,5,3,63,-160,Severe
18,6,222,M,61,9,3,111,-111,Severe
9,0,108,F,90,12,3,147,39,Well
6,1,73,M,2,5,3,63,-10,Severe
11,9,141,M,88,12,0,144,3,Good
8,2,98,F,86,11,10,142,44,Well
10,11,131,F,68,10,0,120,-11,Severe
5,2,62,M,79,11,1,133,71,Well
14,6,174,F,63,9,6,114,-60,Severe
12,7,151,F,23,6,4,76,-75,Severe
15,3,183,F,65,9,8,116,-67,Severe
10,5,125,M,58,9,0,108,-17,Severe
18,5,221,F,78,11,0,132,-89,Severe
17,0,204,F,15,5,11,71,-133,Severe
16,4,196,M,87,11,11,143,-53,Severe
16,2,194,M,101,13,4,160,-34,Severe
8,4,100,M,93,12,6,150,50,Well
6,6,78,F,20,6,2,74,-4,Mild
11,1,133,M,36,7,2,86,-47,Severe
10,10,130,M,65,9,8,116,-14,Severe
16,11,203,F,44,7,9,93,-110,Severe
8,4,100,M,53,8,6,102,2,Good
7,6,90,M,105,13,9,165,75,Well
13,3,159,F,2,5,3,63,-96,Severe
10,4,124,M,109,14,1,169,45,Well
10,5,125,M,49,8,2,98,-27,Severe
5,1,61,F,61,9,3,111,50,Well
18,2,218,M,96,12,10,154,-64,Severe
9,8,116,F,15,5,11,71,-45,Severe
10,1,121,F,44,7,9,93,-28,Severe
9,0,108,M,68,10,0,120,12,Well
5,3,63,M,22,6,3,75,12,Well
10,2,122,M,47,8,0,96,-26,Severe
13,10,166,M,9,5,7,67,-99,Severe
16,6,198,M,20,6,2,74,-124,Severe
18,2,218,M,13,5,9,69,-149,Severe
12,0,144,F,15,5,11,71,-73,Severe
16,3,195,F,4,5,4,64,-131,Severe
10,7,127,M,58,9,0,108,-19,Severe
9,10,118,F,14,5,10,70,-48,Severe
13,9,165,F,82,11,5,137,-28,Severe
17,5,209,F,50,8,3,99,-110,Severe
11,1,133,M,35,7,1,85,-48,Severe
5,8,68,F,19,6,1,73,5,Good
10,1,121,F,89,12,1,145,24,Well
11,7,139,F,20,6,2,74,-65,Severe
11,11,143,M,29,6,8,80,-63,Severe
10,5,125,M,3,5,3,63,-62,Severe
6,8,80,M,45,7,10,94,14,Well
12,8,152,M,85,11,9,141,-11,Severe
14,3,171,M,38,7,4,88,-83,Severe
15,10,190,F,15,5,11,71,-119,Severe
8,6,102,F,54,8,7,103,1,Good
8,11,107,M,45,7,10,94,-13,Severe
11,5,137,M,18,6,1,73,-64,Severe
17,3,207,M,110,14,3,171,-36,Severe
14,9,177,M,64,9,7,115,-62,Severe
18,7,223,M,57,8,10,106,-117,Severe
18,1,217,M,104,13,7,163,-54,Severe
