BAY,BAM,BTM ,Gender,Score,AY,AM,ATM,D,ALD
13,7,163,F,8,7,0,84,-79,Severe
13,10,166,F,9,7,6,90,-76,Severe
6,0,72,M,12,11,6,138,66,Well
12,2,146,M,13,12,6,150,4,Good
7,7,91,F,12,11,6,138,47,Well
14,11,179,F,12,11,6,138,-41,Severe
13,4,160,F,6,6,6,78,-82,Severe
14,5,173,F,6,6,6,78,-95,Severe
10,3,123,F,7,6,6,78,-45,Severe
18,7,223,F,8,7,0,84,-139,Severe
15,4,184,F,10,8,6,102,-82,Severe
10,3,123,F,13,12,6,150,27,Well
18,9,225,M,8,7,0,84,-141,Severe
12,6,150,F,10,8,6,102,-48,Severe
9,10,118,F,8,7,0,84,-34,Severe
5,9,69,M,12,11,6,138,69,Well
16,11,203,M,7,6,6,78,-125,Severe
15,5,185,M,6,6,6,78,-107,Severe
17,11,215,F,15,16,0,192,-23,Severe
12,3,147,M,9,7,6,90,-57,Severe
6,7,79,M,12,11,6,138,59,Well
17,5,209,M,12,11,6,138,-71,Severe
5,7,67,F,6,6,6,78,11,Well
8,9,105,F,12,11,6,138,33,Well
8,2,98,M,8,7,0,84,-14,Severe
16,4,196,M,15,16,0,192,-4,Mild
17,5,209,M,11,10,0,120,-89,Severe
14,1,169,F,9,7,6,90,-79,Severe
9,8,116,F,14,14,0,168,52,Well
7,4,88,F,12,11,6,138,50,Well
7,8,92,F,11,10,0,120,28,Well
14,10,178,M,6,6,6,78,-100,Severe
13,6,162,F,11,10,0,120,-42,Severe
13,5,161,F,6,6,6,78,-83,Severe
18,10,226,F,6,6,6,78,-148,Severe
17,11,215,M,15,16,0,192,-23,Severe
9,5,113,M,10,8,6,102,-11,Severe
16,9,201,M,7,6,6,78,-123,Severe
17,10,214,F,14,14,0,168,-46,Severe
12,3,147,M,7,6,6,78,-69,Severe
7,3,87,M,14,14,0,168,81,Well
11,5,137,M,13,12,6,150,13,Well
10,0,120,F,6,6,6,78,-42,Severe
15,8,188,F,11,10,0,120,-68,Severe
10,4,124,F,10,8,6,102,-22,Severe
11,9,141,F,14,14,0,168,27,Well
10,4,124,M,14,14,0,168,44,Well
10,3,123,M,13,12,6,150,27,Well
11,2,134,M,10,8,6,102,-32,Severe
8,7,103,F,11,10,0,120,17,Well
8,2,98,M,11,10,0,120,22,Well
6,4,76,F,6,6,6,78,2,Good
9,7,115,F,8,7,0,84,-31,Severe
16,8,200,M,6,6,6,78,-122,Severe
9,4,112,M,9,7,6,90,-22,Severe
12,0,144,F,13,12,6,150,6,Well
10,6,126,F,10,8,6,102,-24,Severe
11,10,142,M,6,6,6,78,-64,Severe
10,10,130,F,14,14,0,168,38,Well
5,0,60,M,11,10,0,120,60,Well
14,9,177,F,6,6,6,78,-99,Severe
7,6,90,F,10,8,6,102,12,Well
18,6,222,F,15,16,0,192,-30,Severe
12,8,152,M,6,6,6,78,-74,Severe
8,9,105,M,14,14,0,168,63,Well
16,3,195,M,14,14,0,168,-27,Severe
6,1,73,F,9,7,6,90,17,Well
16,6,198,M,12,11,6,138,-60,Severe
10,10,130,M,14,14,0,168,38,Well
14,8,176,F,6,6,6,78,-98,Severe
13,9,165,F,9,7,6,90,-75,Severe
5,8,68,F,12,11,6,138,70,Well
15,2,182,F,9,7,6,90,-92,Severe
6,6,78,M,6,6,6,78,0,Neutral
10,8,128,F,11,10,0,120,-8,Severe
15,9,189,M,13,12,6,150,-39,Severe
6,6,78,F,6,6,6,78,0,Neutral
10,4,124,F,14,14,0,168,44,Well
17,2,206,F,10,8,6,102,-104,Severe
6,8,80,F,11,10,0,120,40,Well
6,9,81,F,9,7,6,90,9,Well
15,0,180,F,15,16,0,192,12,Well
17,8,212,F,8,7,0,84,-128,Severe
17,2,206,M,13,12,6,150,-56,Severe
5,4,64,M,11,10,0,120,56,Well
8,11,107,F,14,14,0,168,61,Well
10,10,130,M,12,11,6,138,8,Well
9,6,114,M,12,11,6,138,24,Well
14,0,168,F,15,16,0,192,24,Well
17,8,212,M,12,11,6,138,-74,Severe
11,2,134,F,11,10,0,120,-14,Severe
14,1,169,F,12,11,6,138,-31,Severe
11,6,138,M,9,7,6,90,-48,Severe
9,5,113,M,11,10,0,120,7,Well
17,5,209,M,6,6,6,78,-131,Severe
13,3,159,M,12,11,6,138,-21,Severe
11,0,132,F,15,16,0,192,60,Well
5,2,62,M,10,8,6,102,40,Well
7,6,90,F,15,16,0,192,102,Well
11,11,143,F,13,12,6,150,7,Well
12,5,149,F,7,6,6,78,-71,Severe
16,5,197,F,13,12,6,150,-47,Severe
8,7,103,M,8,7,0,84,-19,Severe
17,9,213,M,7,6,6,78,-135,Severe
12,3,147,F,7,6,6,78,-69,Severe
17,9,213,F,11,10,0,120,-93,Severe
16,7,199,F,6,6,6,78,-121,Severe
8,6,102,M,7,6,6,78,-24,Severe
7,10,94,M,6,6,6,78,-16,Severe
18,11,227,F,10,8,6,102,-125,Severe
12,5,149,M,8,7,0,84,-65,Severe
9,1,109,F,14,14,0,168,59,Well
9,1,109,F,13,12,6,150,41,Well
8,3,99,M,9,7,6,90,-9,Severe
6,8,80,F,10,8,6,102,22,Well
5,0,60,F,12,11,6,138,78,Well
5,8,68,M,6,6,6,78,10,Well
17,10,214,F,13,12,6,150,-64,Severe
11,8,140,F,14,14,0,168,28,Well
13,7,163,F,12,11,6,138,-25,Severe
17,11,215,M,13,12,6,150,-65,Severe
9,1,109,F,11,10,0,120,11,Well
6,8,80,F,6,6,6,78,-2,Mild
13,0,156,M,15,16,0,192,36,Well
14,2,170,M,11,10,0,120,-50,Severe
12,4,148,M,13,12,6,150,2,Good
7,1,85,M,12,11,6,138,53,Well
16,9,201,F,14,14,0,168,-33,Severe
12,2,146,F,10,8,6,102,-44,Severe
15,5,185,F,15,16,0,192,7,Well
18,4,220,M,7,6,6,78,-142,Severe
12,6,150,F,7,6,6,78,-72,Severe
18,11,227,F,13,12,6,150,-77,Severe
7,5,89,F,10,8,6,102,13,Well
6,3,75,F,12,11,6,138,63,Well
17,1,205,M,8,7,0,84,-121,Severe
7,2,86,M,10,8,6,102,16,Well
15,0,180,F,10,8,6,102,-78,Severe
12,7,151,F,8,7,0,84,-67,Severe
8,8,104,F,15,16,0,192,88,Well
5,7,67,F,14,14,0,168,101,Well
6,8,80,F,8,7,0,84,4,Good
13,10,166,M,8,7,0,84,-82,Severe
17,11,215,M,9,7,6,90,-125,Severe
10,10,130,F,15,16,0,192,62,Well
12,0,144,M,15,16,0,192,48,Well
12,10,154,F,6,6,6,78,-76,Severe
6,3,75,F,8,7,0,84,9,Well
11,11,143,M,10,8,6,102,-41,Severe
7,3,87,F,10,8,6,102,15,Well
17,2,206,M,9,7,6,90,-116,Severe
5,10,70,F,10,8,6,102,32,Well
17,2,206,M,6,6,6,78,-128,Severe
14,7,175,M,12,11,6,138,-37,Severe
5,1,61,F,11,10,0,120,59,Well
17,2,206,F,14,14,0,168,-38,Severe
9,0,108,F,13,12,6,150,42,Well
8,10,106,M,15,16,0,192,86,Well
16,3,195,F,8,7,0,84,-111,Severe
13,0,156,F,15,16,0,192,36,Well
10,11,131,M,6,6,6,78,-53,Severe
16,9,201,M,8,7,0,84,-117,Severe
8,2,98,M,13,12,6,150,52,Well
7,4,88,M,6,6,6,78,-10,Severe
11,4,136,M,12,11,6,138,2,Good
13,6,162,F,7,6,6,78,-84,Severe
5,2,62,F,6,6,6,78,16,Well
14,3,171,M,7,6,6,78,-93,Severe
13,7,163,M,8,7,0,84,-79,Severe
12,11,155,F,12,11,6,138,-17,Severe
13,11,167,M,15,16,0,192,25,Well
11,0,132,F,6,6,6,78,-54,Severe
7,6,90,M,14,14,0,168,78,Well
10,11,131,F,11,10,0,120,-11,Severe
10,5,125,F,7,6,6,78,-47,Severe
10,3,123,M,14,14,0,168,45,Well
15,11,191,M,11,10,0,120,-71,Severe
9,9,117,M,12,11,6,138,21,Well
11,10,142,F,8,7,0,84,-58,Severe
15,2,182,M,9,7,6,90,-92,Severe
17,2,206,F,11,10,0,120,-86,Severe
7,9,93,F,15,16,0,192,99,Well
6,6,78,F,11,10,0,120,42,Well
8,0,96,M,6,6,6,78,-18,Severe
10,1,121,M,12,11,6,138,17,Well
5,11,71,M,14,14,0,168,97,Well
18,9,225,F,12,11,6,138,-87,Severe
18,4,220,F,12,11,6,138,-82,Severe
13,3,159,F,14,14,0,168,9,Well
7,1,85,F,12,11,6,138,53,Well
8,2,98,F,9,7,6,90,-8,Severe
6,10,82,M,15,16,0,192,110,Well
14,5,173,M,13,12,6,150,-23,Severe
15,7,187,F,14,14,0,168,-19,Severe
16,0,192,M,9,7,6,90,-102,Severe
18,5,221,M,15,16,0,192,-29,Severe
8,1,97,F,6,6,6,78,-19,Severe
13,5,161,M,14,14,0,168,7,Well
16,3,195,M,10,8,6,102,-93,Severe
16,11,203,F,9,7,6,90,-113,Severe
8,11,107,F,11,10,0,120,13,Well
16,10,202,M,8,7,0,84,-118,Severe
16,10,202,M,11,10,0,120,-82,Severe
10,11,131,F,6,6,6,78,-53,Severe
8,4,100,M,6,6,6,78,-22,Severe
5,4,64,F,10,8,6,102,38,Well
5,1,61,M,8,7,0,84,23,Well
13,6,162,F,6,6,6,78,-84,Severe
12,10,154,M,7,6,6,78,-76,Severe
15,3,183,F,7,6,6,78,-105,Severe
15,2,182,F,12,11,6,138,-44,Severe
8,8,104,F,14,14,0,168,64,Well
16,7,199,M,13,12,6,150,-49,Severe
5,8,68,M,13,12,6,150,82,Well
6,1,73,M,9,7,6,90,17,Well
18,10,226,M,12,11,6,138,-88,Severe
9,11,119,M,6,6,6,78,-41,Severe
8,4,100,M,9,7,6,90,-10,Severe
17,2,206,F,9,7,6,90,-116,Severe
9,3,111,M,13,12,6,150,39,Well
7,2,86,F,8,7,0,84,-2,Mild
13,8,164,M,10,8,6,102,-62,Severe
6,10,82,M,8,7,0,84,2,Good
18,11,227,M,14,14,0,168,-59,Severe
18,8,224,F,15,16,0,192,-32,Severe
14,6,174,F,12,11,6,138,-36,Severe
8,5,101,M,13,12,6,150,49,Well
11,4,136,F,13,12,6,150,14,Well
7,6,90,F,11,10,0,120,30,Well
11,3,135,M,10,8,6,102,-33,Severe
12,5,149,F,12,11,6,138,-11,Severe
14,9,177,M,9,7,6,90,-87,Severe
15,4,184,F,6,6,6,78,-106,Severe
17,1,205,M,15,16,0,192,-13,Severe
18,1,217,F,7,6,6,78,-139,Severe
14,4,172,F,10,8,6,102,-70,Severe
13,4,160,F,13,12,6,150,-10,Severe
5,8,68,M,15,16,0,192,124,Well
13,1,157,F,9,7,6,90,-67,Severe
6,10,82,F,11,10,0,120,38,Well
5,10,70,M,14,14,0,168,98,Well
12,11,155,F,10,8,6,102,-53,Severe
11,0,132,M,15,16,0,192,60,Well
6,6,78,M,14,14,0,168,90,Well
16,1,193,M,13,12,6,150,-43,Severe
8,10,106,M,11,10,0,120,14,Well
13,2,158,M,9,7,6,90,-68,Severe
7,11,95,F,10,8,6,102,7,Well
15,3,183,F,12,11,6,138,-45,Severe
8,4,100,M,11,10,0,120,20,Well
8,6,102,M,10,8,6,102,0,Neutral
18,8,224,F,6,6,6,78,-146,Severe
6,6,78,F,9,7,6,90,12,Well
9,10,118,M,7,6,6,78,-40,Severe
11,10,142,F,11,10,0,120,-22,Severe
17,7,211,F,11,10,0,120,-91,Severe
13,2,158,F,15,16,0,192,34,Well
17,6,210,M,15,16,0,192,-18,Severe
7,9,93,F,9,7,6,90,-3,Mild
6,8,80,F,13,12,6,150,70,Well
8,9,105,F,9,7,6,90,-15,Severe
10,9,129,M,6,6,6,78,-51,Severe
12,1,145,F,11,10,0,120,-25,Severe
5,2,62,M,13,12,6,150,88,Well
12,0,144,F,11,10,0,120,-24,Severe
10,10,130,F,11,10,0,120,-10,Severe
8,8,104,F,7,6,6,78,-26,Severe
12,10,154,M,10,8,6,102,-52,Severe
9,3,111,M,9,7,6,90,-21,Severe
15,7,187,M,10,8,6,102,-85,Severe
9,9,117,F,6,6,6,78,-39,Severe
7,10,94,M,14,14,0,168,74,Well
17,7,211,M,13,12,6,150,-61,Severe
8,1,97,M,11,10,0,120,23,Well
15,8,188,F,13,12,6,150,-38,Severe
8,1,97,F,10,8,6,102,5,Good
11,8,140,M,13,12,6,150,10,Well
13,9,165,M,8,7,0,84,-81,Severe
17,3,207,F,6,6,6,78,-129,Severe
10,8,128,F,8,7,0,84,-44,Severe
18,1,217,M,7,6,6,78,-139,Severe
13,10,166,F,13,12,6,150,-16,Severe
18,7,223,F,11,10,0,120,-103,Severe
11,9,141,M,11,10,0,120,-21,Severe
9,8,116,M,13,12,6,150,34,Well
14,8,176,M,10,8,6,102,-74,Severe
10,5,125,M,10,8,6,102,-23,Severe
12,2,146,M,9,7,6,90,-56,Severe
18,11,227,M,8,7,0,84,-143,Severe
13,1,157,F,10,8,6,102,-55,Severe
17,8,212,M,15,16,0,192,-20,Severe
15,5,185,F,7,6,6,78,-107,Severe
6,4,76,M,15,16,0,192,116,Well
15,1,181,M,7,6,6,78,-103,Severe
16,5,197,M,14,14,0,168,-29,Severe
6,4,76,F,9,7,6,90,14,Well
11,3,135,M,6,6,6,78,-57,Severe
11,3,135,M,9,7,6,90,-45,Severe
6,5,77,M,14,14,0,168,91,Well
11,4,136,F,12,11,6,138,2,Good
11,2,134,F,15,16,0,192,58,Well
10,8,128,M,9,7,6,90,-38,Severe
7,8,92,F,9,7,6,90,-2,Mild
11,4,136,F,11,10,0,120,-16,Severe
11,1,133,F,14,14,0,168,35,Well
16,0,192,M,7,6,6,78,-114,Severe
5,11,71,F,7,6,6,78,7,Well
10,5,125,F,13,12,6,150,25,Well
14,10,178,F,10,8,6,102,-76,Severe
16,5,197,F,6,6,6,78,-119,Severe
12,7,151,F,7,6,6,78,-73,Severe
8,7,103,M,12,11,6,138,35,Well
7,2,86,F,13,12,6,150,64,Well
7,5,89,F,7,6,6,78,-11,Severe
7,5,89,M,7,6,6,78,-11,Severe
8,11,107,M,14,14,0,168,61,Well
12,5,149,M,12,11,6,138,-11,Severe
17,4,208,F,6,6,6,78,-130,Severe
5,10,70,F,15,16,0,192,122,Well
11,5,137,M,12,11,6,138,1,Good
16,7,199,M,12,11,6,138,-61,Severe
7,0,84,M,14,14,0,168,84,Well
10,8,128,F,10,8,6,102,-26,Severe
11,4,136,M,15,16,0,192,56,Well
5,3,63,M,6,6,6,78,15,Well
7,10,94,F,13,12,6,150,56,Well
18,5,221,M,11,10,0,120,-101,Severe
13,2,158,F,14,14,0,168,10,Well
7,4,88,F,11,10,0,120,32,Well
12,8,152,M,11,10,0,120,-32,Severe
10,6,126,M,15,16,0,192,66,Well
7,1,85,M,13,12,6,150,65,Well
9,10,118,F,12,11,6,138,20,Well
11,3,135,M,11,10,0,120,-15,Severe
14,5,173,M,10,8,6,102,-71,Severe
13,4,160,M,11,10,0,120,-40,Severe
14,1,169,F,6,6,6,78,-91,Severe
17,5,209,F,8,7,0,84,-125,Severe
18,0,216,F,9,7,6,90,-126,Severe
7,8,92,M,8,7,0,84,-8,Severe
9,5,113,M,14,14,0,168,55,Well
12,10,154,F,11,10,0,120,-34,Severe
12,9,153,M,15,16,0,192,39,Well
9,5,113,M,6,6,6,78,-35,Severe
14,8,176,M,15,16,0,192,16,Well
11,7,139,M,11,10,0,120,-19,Severe
13,5,161,M,13,12,6,150,-11,Severe
15,8,188,M,8,7,0,84,-104,Severe
18,7,223,M,15,16,0,192,-31,Severe
10,11,131,F,13,12,6,150,19,Well
5,3,63,M,12,11,6,138,75,Well
15,9,189,F,14,14,0,168,-21,Severe
11,2,134,M,9,7,6,90,-44,Severe
14,2,170,M,7,6,6,78,-92,Severe
18,5,221,M,10,8,6,102,-119,Severe
15,4,184,M,15,16,0,192,8,Well
7,10,94,F,12,11,6,138,44,Well
12,2,146,M,10,8,6,102,-44,Severe
8,0,96,M,12,11,6,138,42,Well
12,7,151,F,12,11,6,138,-13,Severe
14,0,168,M,15,16,0,192,24,Well
13,11,167,M,6,6,6,78,-89,Severe
6,3,75,F,11,10,0,120,45,Well
14,4,172,F,12,11,6,138,-34,Severe
17,3,207,M,12,11,6,138,-69,Severe
14,9,177,F,12,11,6,138,-39,Severe
9,9,117,M,14,14,0,168,51,Well
12,7,151,M,8,7,0,84,-67,Severe
6,1,73,F,13,12,6,150,77,Well
9,5,113,F,10,8,6,102,-11,Severe
14,6,174,F,7,6,6,78,-96,Severe
13,3,159,F,15,16,0,192,33,Well
7,10,94,M,12,11,6,138,44,Well
7,10,94,F,10,8,6,102,8,Well
7,6,90,F,14,14,0,168,78,Well
12,7,151,M,7,6,6,78,-73,Severe
18,6,222,F,9,7,6,90,-132,Severe
16,4,196,F,12,11,6,138,-58,Severe
7,8,92,M,13,12,6,150,58,Well
10,11,131,F,10,8,6,102,-29,Severe
17,10,214,M,8,7,0,84,-130,Severe
8,7,103,F,6,6,6,78,-25,Severe
13,4,160,M,9,7,6,90,-70,Severe
18,10,226,M,9,7,6,90,-136,Severe
7,6,90,M,11,10,0,120,30,Well
5,11,71,F,8,7,0,84,13,Well
14,7,175,M,9,7,6,90,-85,Severe
9,8,116,F,10,8,6,102,-14,Severe
17,6,210,F,11,10,0,120,-90,Severe
8,6,102,F,9,7,6,90,-12,Severe
13,6,162,M,11,10,0,120,-42,Severe
11,6,138,F,10,8,6,102,-36,Severe
12,1,145,M,11,10,0,120,-25,Severe
12,6,150,F,14,14,0,168,18,Well
14,6,174,M,14,14,0,168,-6,Severe
9,3,111,F,14,14,0,168,57,Well
9,9,117,M,8,7,0,84,-33,Severe
7,0,84,F,13,12,6,150,66,Well
18,6,222,M,7,6,6,78,-144,Severe
10,6,126,F,15,16,0,192,66,Well
18,2,218,M,15,16,0,192,-26,Severe
14,8,176,F,13,12,6,150,-26,Severe
7,4,88,F,10,8,6,102,14,Well
5,11,71,M,11,10,0,120,49,Well
14,1,169,F,10,8,6,102,-67,Severe
15,1,181,M,11,10,0,120,-61,Severe
10,7,127,M,14,14,0,168,41,Well
6,3,75,F,9,7,6,90,15,Well
15,0,180,F,11,10,0,120,-60,Severe
10,0,120,F,10,8,6,102,-18,Severe
13,1,157,M,9,7,6,90,-67,Severe
14,3,171,F,14,14,0,168,-3,Mild
6,10,82,F,14,14,0,168,86,Well
12,0,144,M,10,8,6,102,-42,Severe
17,9,213,F,13,12,6,150,-63,Severe
13,0,156,F,7,6,6,78,-78,Severe
13,4,160,M,12,11,6,138,-22,Severe
17,8,212,M,9,7,6,90,-122,Severe
10,4,124,F,13,12,6,150,26,Well
9,0,108,F,14,14,0,168,60,Well
18,8,224,F,11,10,0,120,-104,Severe
13,2,158,F,8,7,0,84,-74,Severe
12,11,155,M,12,11,6,138,-17,Severe
16,4,196,M,14,14,0,168,-28,Severe
15,7,187,M,9,7,6,90,-97,Severe
7,3,87,F,14,14,0,168,81,Well
11,8,140,M,8,7,0,84,-56,Severe
8,9,105,F,7,6,6,78,-27,Severe
16,11,203,F,10,8,6,102,-101,Severe
9,1,109,M,6,6,6,78,-31,Severe
8,3,99,M,6,6,6,78,-21,Severe
9,0,108,M,15,16,0,192,84,Well
8,3,99,F,15,16,0,192,93,Well
18,5,221,F,12,11,6,138,-83,Severe
18,1,217,M,10,8,6,102,-115,Severe
17,6,210,M,11,10,0,120,-90,Severe
9,11,119,M,15,16,0,192,73,Well
12,3,147,M,6,6,6,78,-69,Severe
12,10,154,F,14,14,0,168,14,Well
18,9,225,F,7,6,6,78,-147,Severe
5,7,67,M,11,10,0,120,53,Well
12,9,153,F,15,16,0,192,39,Well
7,5,89,M,9,7,6,90,1,Good
9,2,110,M,14,14,0,168,58,Well
11,9,141,M,8,7,0,84,-57,Severe
10,9,129,F,6,6,6,78,-51,Severe
18,3,219,M,8,7,0,84,-135,Severe
12,4,148,M,8,7,0,84,-64,Severe
7,9,93,F,8,7,0,84,-9,Severe
11,5,137,M,6,6,6,78,-59,Severe
7,4,88,M,8,7,0,84,-4,Mild
9,6,114,F,7,6,6,78,-36,Severe
8,8,104,M,10,8,6,102,-2,Mild
15,5,185,F,8,7,0,84,-101,Severe
10,3,123,F,9,7,6,90,-33,Severe
8,10,106,F,9,7,6,90,-16,Severe
11,1,133,F,11,10,0,120,-13,Severe
15,11,191,F,13,12,6,150,-41,Severe
7,8,92,M,10,8,6,102,10,Well
8,9,105,F,6,6,6,78,-27,Severe
6,5,77,M,11,10,0,120,43,Well
7,2,86,M,7,6,6,78,-8,Severe
9,3,111,M,14,14,0,168,57,Well
16,9,201,F,13,12,6,150,-51,Severe
7,3,87,M,15,16,0,192,105,Well
14,8,176,F,7,6,6,78,-98,Severe
15,4,184,M,10,8,6,102,-82,Severe
6,11,83,M,13,12,6,150,67,Well
14,11,179,F,6,6,6,78,-101,Severe
12,10,154,F,13,12,6,150,-4,Mild
16,3,195,F,14,14,0,168,-27,Severe
13,10,166,M,11,10,0,120,-46,Severe
11,0,132,M,9,7,6,90,-42,Severe
7,8,92,F,14,14,0,168,76,Well
16,2,194,F,15,16,0,192,-2,Mild
18,2,218,M,12,11,6,138,-80,Severe
18,4,220,M,15,16,0,192,-28,Severe
8,4,100,M,13,12,6,150,50,Well
11,2,134,F,7,6,6,78,-56,Severe
15,5,185,M,11,10,0,120,-65,Severe
15,7,187,M,13,12,6,150,-37,Severe
6,8,80,M,15,16,0,192,112,Well
13,9,165,F,10,8,6,102,-63,Severe
14,8,176,M,11,10,0,120,-56,Severe
5,7,67,M,6,6,6,78,11,Well
18,2,218,M,10,8,6,102,-116,Severe
6,9,81,F,7,6,6,78,-3,Mild
7,1,85,M,7,6,6,78,-7,Severe
8,4,100,F,9,7,6,90,-10,Severe
12,9,153,M,6,6,6,78,-75,Severe
5,5,65,F,14,14,0,168,103,Well
5,2,62,M,9,7,6,90,28,Well
9,6,114,M,11,10,0,120,6,Well
14,11,179,F,10,8,6,102,-77,Severe
5,1,61,F,14,14,0,168,107,Well
5,6,66,M,9,7,6,90,24,Well
11,8,140,F,12,11,6,138,-2,Mild
13,8,164,M,8,7,0,84,-80,Severe
6,6,78,M,10,8,6,102,24,Well
16,0,192,F,7,6,6,78,-114,Severe
16,2,194,M,12,11,6,138,-56,Severe
9,8,116,M,11,10,0,120,4,Good
5,7,67,F,8,7,0,84,17,Well
7,2,86,M,14,14,0,168,82,Well
18,5,221,M,7,6,6,78,-143,Severe
16,5,197,F,12,11,6,138,-59,Severe
12,9,153,F,6,6,6,78,-75,Severe
16,1,193,M,14,14,0,168,-25,Severe
14,9,177,M,12,11,6,138,-39,Severe
12,0,144,F,9,7,6,90,-54,Severe
16,7,199,M,7,6,6,78,-121,Severe
9,9,117,F,14,14,0,168,51,Well
10,3,123,M,9,7,6,90,-33,Severe
8,8,104,M,7,6,6,78,-26,Severe
5,10,70,M,15,16,0,192,122,Well
5,5,65,F,6,6,6,78,13,Well
6,11,83,F,15,16,0,192,109,Well
9,4,112,F,7,6,6,78,-34,Severe
6,0,72,M,11,10,0,120,48,Well
6,2,74,F,11,10,0,120,46,Well
7,8,92,M,12,11,6,138,46,Well
18,6,222,F,12,11,6,138,-84,Severe
12,1,145,M,6,6,6,78,-67,Severe
11,6,138,F,15,16,0,192,54,Well
8,6,102,M,6,6,6,78,-24,Severe
16,8,200,M,11,10,0,120,-80,Severe
13,8,164,M,7,6,6,78,-86,Severe
16,6,198,F,10,8,6,102,-96,Severe
16,11,203,F,6,6,6,78,-125,Severe
11,11,143,M,11,10,0,120,-23,Severe
17,8,212,F,6,6,6,78,-134,Severe
15,6,186,M,15,16,0,192,6,Well
15,9,189,F,9,7,6,90,-99,Severe
18,5,221,M,12,11,6,138,-83,Severe
12,1,145,F,9,7,6,90,-55,Severe
10,6,126,F,8,7,0,84,-42,Severe
9,8,116,F,9,7,6,90,-26,Severe
14,1,169,F,8,7,0,84,-85,Severe
13,1,157,F,8,7,0,84,-73,Severe
18,4,220,M,6,6,6,78,-142,Severe
15,4,184,M,13,12,6,150,-34,Severe
6,4,76,F,8,7,0,84,8,Well
8,4,100,F,10,8,6,102,2,Good
17,1,205,F,13,12,6,150,-55,Severe
13,7,163,F,13,12,6,150,-13,Severe
8,4,100,M,15,16,0,192,92,Well
13,10,166,F,6,6,6,78,-88,Severe
10,4,124,F,6,6,6,78,-46,Severe
9,9,117,F,8,7,0,84,-33,Severe
11,4,136,F,6,6,6,78,-58,Severe
15,1,181,F,11,10,0,120,-61,Severe
12,3,147,M,15,16,0,192,45,Well
16,2,194,M,14,14,0,168,-26,Severe
17,7,211,M,11,10,0,120,-91,Severe
14,11,179,M,9,7,6,90,-89,Severe
8,9,105,M,15,16,0,192,87,Well
5,3,63,M,7,6,6,78,15,Well
16,11,203,F,7,6,6,78,-125,Severe
8,2,98,M,12,11,6,138,40,Well
13,10,166,F,8,7,0,84,-82,Severe
9,9,117,M,7,6,6,78,-39,Severe
15,3,183,M,12,11,6,138,-45,Severe
12,2,146,M,11,10,0,120,-26,Severe
13,9,165,F,7,6,6,78,-87,Severe
7,9,93,F,12,11,6,138,45,Well
13,8,164,F,9,7,6,90,-74,Severe
5,1,61,F,6,6,6,78,17,Well
16,10,202,F,9,7,6,90,-112,Severe
18,0,216,F,7,6,6,78,-138,Severe
7,8,92,M,15,16,0,192,100,Well
10,3,123,M,6,6,6,78,-45,Severe
10,7,127,M,15,16,0,192,65,Well
16,0,192,F,10,8,6,102,-90,Severe
10,9,129,F,8,7,0,84,-45,Severe
10,6,126,F,9,7,6,90,-36,Severe
15,1,181,F,9,7,6,90,-91,Severe
13,1,157,M,12,11,6,138,-19,Severe
5,9,69,F,7,6,6,78,9,Well
12,0,144,F,7,6,6,78,-66,Severe
10,3,123,F,15,16,0,192,69,Well
14,0,168,M,13,12,6,150,-18,Severe
12,3,147,F,15,16,0,192,45,Well
13,7,163,F,11,10,0,120,-43,Severe
14,10,178,F,14,14,0,168,-10,Severe
17,10,214,M,6,6,6,78,-136,Severe
18,11,227,M,7,6,6,78,-149,Severe
17,7,211,F,7,6,6,78,-133,Severe
7,7,91,F,8,7,0,84,-7,Severe
5,7,67,F,13,12,6,150,83,Well
10,8,128,F,13,12,6,150,22,Well
5,2,62,F,13,12,6,150,88,Well
9,5,113,F,6,6,6,78,-35,Severe
7,3,87,M,11,10,0,120,33,Well
9,6,114,M,15,16,0,192,78,Well
8,3,99,F,12,11,6,138,39,Well
14,7,175,F,9,7,6,90,-85,Severe
8,2,98,F,10,8,6,102,4,Good
11,3,135,F,8,7,0,84,-51,Severe
13,7,163,F,15,16,0,192,29,Well
15,11,191,M,8,7,0,84,-107,Severe
7,2,86,M,6,6,6,78,-8,Severe
7,1,85,F,13,12,6,150,65,Well
11,11,143,M,15,16,0,192,49,Well
7,5,89,M,15,16,0,192,103,Well
9,11,119,M,14,14,0,168,49,Well
16,0,192,M,10,8,6,102,-90,Severe
10,9,129,M,7,6,6,78,-51,Severe
15,3,183,F,11,10,0,120,-63,Severe
18,0,216,M,6,6,6,78,-138,Severe
16,8,200,F,11,10,0,120,-80,Severe
10,5,125,F,8,7,0,84,-41,Severe
9,7,115,M,14,14,0,168,53,Well
14,1,169,M,10,8,6,102,-67,Severe
18,2,218,M,13,12,6,150,-68,Severe
5,6,66,F,9,7,6,90,24,Well
14,2,170,M,9,7,6,90,-80,Severe
12,9,153,M,8,7,0,84,-69,Severe
5,4,64,M,15,16,0,192,128,Well
6,2,74,M,6,6,6,78,4,Good
9,2,110,M,10,8,6,102,-8,Severe
6,11,83,M,15,16,0,192,109,Well
16,4,196,M,8,7,0,84,-112,Severe
6,4,76,M,6,6,6,78,2,Good
10,11,131,M,7,6,6,78,-53,Severe
10,10,130,F,9,7,6,90,-40,Severe
14,3,171,M,8,7,0,84,-87,Severe
15,1,181,M,14,14,0,168,-13,Severe
6,8,80,F,15,16,0,192,112,Well
6,5,77,M,6,6,6,78,1,Good
16,3,195,M,9,7,6,90,-105,Severe
10,0,120,M,10,8,6,102,-18,Severe
8,4,100,M,7,6,6,78,-22,Severe
8,5,101,F,6,6,6,78,-23,Severe
9,2,110,M,7,6,6,78,-32,Severe
8,0,96,M,7,6,6,78,-18,Severe
13,11,167,F,15,16,0,192,25,Well
13,1,157,F,13,12,6,150,-7,Severe
7,5,89,M,12,11,6,138,49,Well
12,10,154,F,12,11,6,138,-16,Severe
7,8,92,M,6,6,6,78,-14,Severe
9,2,110,F,7,6,6,78,-32,Severe
5,3,63,F,12,11,6,138,75,Well
9,0,108,F,12,11,6,138,30,Well
14,2,170,M,14,14,0,168,-2,Mild
14,5,173,M,11,10,0,120,-53,Severe
15,11,191,F,6,6,6,78,-113,Severe
12,0,144,M,9,7,6,90,-54,Severe
9,2,110,F,11,10,0,120,10,Well
7,3,87,F,11,10,0,120,33,Well
7,4,88,M,10,8,6,102,14,Well
10,10,130,F,13,12,6,150,20,Well
13,7,163,M,13,12,6,150,-13,Severe
17,0,204,M,12,11,6,138,-66,Severe
11,8,140,F,13,12,6,150,10,Well
8,3,99,F,7,6,6,78,-21,Severe
13,1,157,F,15,16,0,192,35,Well
17,10,214,F,8,7,0,84,-130,Severe
18,9,225,M,9,7,6,90,-135,Severe
18,11,227,F,15,16,0,192,-35,Severe
6,2,74,M,8,7,0,84,10,Well
13,0,156,M,13,12,6,150,-6,Severe
11,5,137,F,14,14,0,168,31,Well
14,9,177,F,13,12,6,150,-27,Severe
11,6,138,F,9,7,6,90,-48,Severe
18,1,217,F,6,6,6,78,-139,Severe
9,5,113,M,7,6,6,78,-35,Severe
12,2,146,F,8,7,0,84,-62,Severe
13,11,167,F,13,12,6,150,-17,Severe
11,2,134,F,6,6,6,78,-56,Severe
11,10,142,M,12,11,6,138,-4,Mild
5,9,69,F,15,16,0,192,123,Well
14,8,176,M,9,7,6,90,-86,Severe
10,8,128,F,6,6,6,78,-50,Severe
16,8,200,M,13,12,6,150,-50,Severe
13,11,167,F,14,14,0,168,1,Good
11,1,133,F,15,16,0,192,59,Well
18,5,221,F,7,6,6,78,-143,Severe
6,2,74,M,11,10,0,120,46,Well
9,11,119,M,7,6,6,78,-41,Severe
17,7,211,F,12,11,6,138,-73,Severe
9,2,110,F,6,6,6,78,-32,Severe
17,6,210,F,12,11,6,138,-72,Severe
9,8,116,F,7,6,6,78,-38,Severe
15,10,190,F,15,16,0,192,2,Good
7,7,91,M,15,16,0,192,101,Well
7,5,89,M,10,8,6,102,13,Well
13,3,159,M,8,7,0,84,-75,Severe
13,4,160,F,14,14,0,168,8,Well
6,4,76,M,12,11,6,138,62,Well
5,2,62,F,11,10,0,120,58,Well
14,8,176,M,8,7,0,84,-92,Severe
8,0,96,M,8,7,0,84,-12,Severe
5,10,70,M,13,12,6,150,80,Well
8,3,99,M,8,7,0,84,-15,Severe
11,3,135,F,12,11,6,138,3,Good
16,2,194,M,15,16,0,192,-2,Mild
18,1,217,M,11,10,0,120,-97,Severe
5,5,65,F,15,16,0,192,127,Well
18,4,220,F,7,6,6,78,-142,Severe
14,8,176,F,11,10,0,120,-56,Severe
10,7,127,F,8,7,0,84,-43,Severe
8,7,103,M,11,10,0,120,17,Well
8,6,102,F,11,10,0,120,18,Well
8,5,101,F,13,12,6,150,49,Well
5,6,66,M,10,8,6,102,36,Well
11,5,137,M,10,8,6,102,-35,Severe
9,7,115,M,6,6,6,78,-37,Severe
5,1,61,M,15,16,0,192,131,Well
9,11,119,F,10,8,6,102,-17,Severe
6,4,76,F,7,6,6,78,2,Good
8,4,100,M,14,14,0,168,68,Well
6,1,73,F,6,6,6,78,5,Good
9,4,112,F,9,7,6,90,-22,Severe
18,4,220,F,15,16,0,192,-28,Severe
15,0,180,F,12,11,6,138,-42,Severe
5,2,62,M,14,14,0,168,106,Well
15,5,185,F,10,8,6,102,-83,Severe
9,10,118,M,12,11,6,138,20,Well
17,4,208,M,11,10,0,120,-88,Severe
8,0,96,F,8,7,0,84,-12,Severe
18,1,217,F,15,16,0,192,-25,Severe
11,4,136,F,14,14,0,168,32,Well
8,2,98,M,15,16,0,192,94,Well
14,0,168,F,12,11,6,138,-30,Severe
11,4,136,F,15,16,0,192,56,Well
15,7,187,M,14,14,0,168,-19,Severe
15,7,187,M,8,7,0,84,-103,Severe
6,4,76,F,13,12,6,150,74,Well
5,9,69,F,13,12,6,150,81,Well
11,4,136,M,11,10,0,120,-16,Severe
7,7,91,F,13,12,6,150,59,Well
12,5,149,F,6,6,6,78,-71,Severe
8,6,102,M,9,7,6,90,-12,Severe
17,0,204,F,13,12,6,150,-54,Severe
9,0,108,M,8,7,0,84,-24,Severe
10,9,129,M,9,7,6,90,-39,Severe
15,8,188,F,9,7,6,90,-98,Severe
13,2,158,F,9,7,6,90,-68,Severe
12,5,149,F,8,7,0,84,-65,Severe
8,0,96,F,14,14,0,168,72,Well
16,3,195,F,9,7,6,90,-105,Severe
8,6,102,M,14,14,0,168,66,Well
6,7,79,F,6,6,6,78,-1,Mild
18,1,217,M,13,12,6,150,-67,Severe
17,9,213,M,14,14,0,168,-45,Severe
16,9,201,M,14,14,0,168,-33,Severe
9,11,119,M,11,10,0,120,1,Good
7,9,93,M,9,7,6,90,-3,Mild
8,11,107,F,10,8,6,102,-5,Mild
9,3,111,M,11,10,0,120,9,Well
16,3,195,F,12,11,6,138,-57,Severe
6,5,77,F,15,16,0,192,115,Well
18,9,225,F,9,7,6,90,-135,Severe
9,9,117,F,11,10,0,120,3,Good
10,0,120,F,9,7,6,90,-30,Severe
16,7,199,M,8,7,0,84,-115,Severe
15,10,190,F,9,7,6,90,-100,Severe
15,3,183,F,14,14,0,168,-15,Severe
6,11,83,F,8,7,0,84,1,Good
10,10,130,F,8,7,0,84,-46,Severe
18,4,220,F,11,10,0,120,-100,Severe
5,5,65,M,11,10,0,120,55,Well
7,5,89,F,15,16,0,192,103,Well
18,2,218,F,15,16,0,192,-26,Severe
12,10,154,M,9,7,6,90,-64,Severe
12,10,154,F,15,16,0,192,38,Well
5,11,71,F,15,16,0,192,121,Well
5,6,66,M,14,14,0,168,102,Well
8,11,107,M,9,7,6,90,-17,Severe
17,10,214,M,9,7,6,90,-124,Severe
16,3,195,F,11,10,0,120,-75,Severe
10,4,124,F,11,10,0,120,-4,Mild
14,3,171,F,8,7,0,84,-87,Severe
13,8,164,F,14,14,0,168,4,Good
16,2,194,F,6,6,6,78,-116,Severe
14,7,175,F,14,14,0,168,-7,Severe
14,3,171,M,14,14,0,168,-3,Mild
15,1,181,F,12,11,6,138,-43,Severe
5,4,64,F,8,7,0,84,20,Well
6,0,72,M,13,12,6,150,78,Well
9,10,118,F,15,16,0,192,74,Well
15,8,188,F,10,8,6,102,-86,Severe
13,5,161,F,7,6,6,78,-83,Severe
13,1,157,F,7,6,6,78,-79,Severe
6,1,73,M,7,6,6,78,5,Good
16,7,199,M,15,16,0,192,-7,Severe
10,8,128,M,8,7,0,84,-44,Severe
17,2,206,M,14,14,0,168,-38,Severe
12,10,154,M,8,7,0,84,-70,Severe
8,0,96,F,6,6,6,78,-18,Severe
9,0,108,M,12,11,6,138,30,Well
12,4,148,M,11,10,0,120,-28,Severe
14,7,175,M,10,8,6,102,-73,Severe
7,6,90,M,6,6,6,78,-12,Severe
13,5,161,M,9,7,6,90,-71,Severe
12,4,148,F,10,8,6,102,-46,Severe
14,0,168,F,7,6,6,78,-90,Severe
6,8,80,F,9,7,6,90,10,Well
15,1,181,M,13,12,6,150,-31,Severe
8,0,96,F,15,16,0,192,96,Well
16,4,196,F,8,7,0,84,-112,Severe
18,1,217,F,8,7,0,84,-133,Severe
18,6,222,M,15,16,0,192,-30,Severe
13,8,164,F,6,6,6,78,-86,Severe
18,7,223,M,6,6,6,78,-145,Severe
10,0,120,M,13,12,6,150,30,Well
15,0,180,M,9,7,6,90,-90,Severe
13,4,160,M,6,6,6,78,-82,Severe
17,8,212,F,9,7,6,90,-122,Severe
16,5,197,M,8,7,0,84,-113,Severe
5,11,71,M,12,11,6,138,67,Well
10,10,130,M,11,10,0,120,-10,Severe
7,10,94,M,11,10,0,120,26,Well
14,10,178,F,12,11,6,138,-40,Severe
7,2,86,M,12,11,6,138,52,Well
9,4,112,M,13,12,6,150,38,Well
11,0,132,F,11,10,0,120,-12,Severe
17,10,214,M,14,14,0,168,-46,Severe
5,8,68,F,6,6,6,78,10,Well
13,9,165,M,13,12,6,150,-15,Severe
10,9,129,F,14,14,0,168,39,Well
14,0,168,M,12,11,6,138,-30,Severe
17,7,211,F,10,8,6,102,-109,Severe
15,1,181,F,14,14,0,168,-13,Severe
15,9,189,M,12,11,6,138,-51,Severe
18,11,227,M,15,16,0,192,-35,Severe
6,8,80,M,10,8,6,102,22,Well
17,4,208,M,12,11,6,138,-70,Severe
11,9,141,M,7,6,6,78,-63,Severe
17,5,209,M,7,6,6,78,-131,Severe
14,5,173,F,12,11,6,138,-35,Severe
18,0,216,M,11,10,0,120,-96,Severe
9,0,108,M,9,7,6,90,-18,Severe
13,5,161,M,6,6,6,78,-83,Severe
7,2,86,M,9,7,6,90,4,Good
9,4,112,M,8,7,0,84,-28,Severe
10,6,126,M,12,11,6,138,12,Well
13,7,163,M,12,11,6,138,-25,Severe
5,9,69,M,15,16,0,192,123,Well
14,2,170,M,6,6,6,78,-92,Severe
17,10,214,F,10,8,6,102,-112,Severe
5,8,68,F,10,8,6,102,34,Well
5,6,66,F,14,14,0,168,102,Well
12,11,155,M,13,12,6,150,-5,Mild
18,9,225,F,14,14,0,168,-57,Severe
9,10,118,M,13,12,6,150,32,Well
8,11,107,M,8,7,0,84,-23,Severe
6,7,79,M,15,16,0,192,113,Well
7,6,90,M,15,16,0,192,102,Well
10,7,127,F,7,6,6,78,-49,Severe
17,7,211,M,14,14,0,168,-43,Severe
17,7,211,M,12,11,6,138,-73,Severe
6,8,80,M,8,7,0,84,4,Good
11,7,139,M,13,12,6,150,11,Well
5,8,68,F,8,7,0,84,16,Well
17,5,209,F,14,14,0,168,-41,Severe
12,6,150,F,15,16,0,192,42,Well
7,0,84,F,10,8,6,102,18,Well
17,1,205,M,7,6,6,78,-127,Severe
8,10,106,F,15,16,0,192,86,Well
5,7,67,F,10,8,6,102,35,Well
17,7,211,M,9,7,6,90,-121,Severe
16,4,196,M,13,12,6,150,-46,Severe
17,0,204,M,7,6,6,78,-126,Severe
12,2,146,M,15,16,0,192,46,Well
5,3,63,M,11,10,0,120,57,Well
15,7,187,F,10,8,6,102,-85,Severe
5,2,62,F,14,14,0,168,106,Well
7,9,93,F,10,8,6,102,9,Well
16,2,194,M,9,7,6,90,-104,Severe
8,7,103,M,10,8,6,102,-1,Mild
17,0,204,M,14,14,0,168,-36,Severe
16,7,199,F,14,14,0,168,-31,Severe
18,10,226,F,8,7,0,84,-142,Severe
9,7,115,M,10,8,6,102,-13,Severe
17,1,205,M,14,14,0,168,-37,Severe
10,11,131,F,8,7,0,84,-47,Severe
7,1,85,M,14,14,0,168,83,Well
14,10,178,F,11,10,0,120,-58,Severe
11,1,133,M,10,8,6,102,-31,Severe
8,5,101,F,9,7,6,90,-11,Severe
13,5,161,M,10,8,6,102,-59,Severe
17,4,208,M,7,6,6,78,-130,Severe
6,9,81,F,6,6,6,78,-3,Mild
10,5,125,F,14,14,0,168,43,Well
14,6,174,M,10,8,6,102,-72,Severe
16,5,197,M,11,10,0,120,-77,Severe
13,7,163,F,7,6,6,78,-85,Severe
17,10,214,F,15,16,0,192,-22,Severe
13,8,164,F,8,7,0,84,-80,Severe
11,10,142,M,15,16,0,192,50,Well
8,9,105,M,13,12,6,150,45,Well
14,3,171,M,13,12,6,150,-21,Severe
15,6,186,F,11,10,0,120,-66,Severe
11,9,141,F,10,8,6,102,-39,Severe
7,1,85,M,11,10,0,120,35,Well
7,0,84,F,14,14,0,168,84,Well
7,5,89,M,6,6,6,78,-11,Severe
10,2,122,M,7,6,6,78,-44,Severe
14,10,178,M,9,7,6,90,-88,Severe
11,1,133,F,10,8,6,102,-31,Severe
15,6,186,F,15,16,0,192,6,Well
6,3,75,M,13,12,6,150,75,Well
5,5,65,F,7,6,6,78,13,Well
11,7,139,F,8,7,0,84,-55,Severe
18,7,223,F,10,8,6,102,-121,Severe
12,3,147,F,9,7,6,90,-57,Severe
10,3,123,M,15,16,0,192,69,Well
13,7,163,M,6,6,6,78,-85,Severe
13,2,158,M,15,16,0,192,34,Well
16,9,201,M,10,8,6,102,-99,Severe
5,1,61,M,14,14,0,168,107,Well
18,4,220,M,8,7,0,84,-136,Severe
10,2,122,F,10,8,6,102,-20,Severe
8,4,100,F,7,6,6,78,-22,Severe
17,8,212,M,8,7,0,84,-128,Severe
8,8,104,M,15,16,0,192,88,Well
12,8,152,F,14,14,0,168,16,Well
17,6,210,F,15,16,0,192,-18,Severe
9,10,118,M,11,10,0,120,2,Good
14,10,178,F,9,7,6,90,-88,Severe
11,9,141,M,6,6,6,78,-63,Severe
15,2,182,M,13,12,6,150,-32,Severe
15,9,189,M,11,10,0,120,-69,Severe
11,9,141,F,9,7,6,90,-51,Severe
12,9,153,M,13,12,6,150,-3,Mild
6,1,73,F,8,7,0,84,11,Well
11,9,141,M,15,16,0,192,51,Well
18,7,223,M,7,6,6,78,-145,Severe
10,6,126,F,12,11,6,138,12,Well
6,7,79,F,8,7,0,84,5,Good
15,5,185,M,9,7,6,90,-95,Severe
5,5,65,F,8,7,0,84,19,Well
10,10,130,F,12,11,6,138,8,Well
13,2,158,F,7,6,6,78,-80,Severe
15,9,189,M,15,16,0,192,3,Good
6,5,77,F,7,6,6,78,1,Good
9,1,109,F,10,8,6,102,-7,Severe
12,7,151,M,11,10,0,120,-31,Severe
16,3,195,M,12,11,6,138,-57,Severe
7,6,90,F,8,7,0,84,-6,Severe
18,0,216,M,14,14,0,168,-48,Severe
6,6,78,M,11,10,0,120,42,Well
9,2,110,M,13,12,6,150,40,Well
11,11,143,M,7,6,6,78,-65,Severe
17,9,213,F,14,14,0,168,-45,Severe
16,3,195,F,13,12,6,150,-45,Severe
13,1,157,M,6,6,6,78,-79,Severe
18,2,218,M,6,6,6,78,-140,Severe
18,1,217,M,12,11,6,138,-79,Severe
12,2,146,F,6,6,6,78,-68,Severe
11,0,132,F,14,14,0,168,36,Well
8,11,107,M,12,11,6,138,31,Well
10,10,130,F,6,6,6,78,-52,Severe
17,4,208,F,10,8,6,102,-106,Severe
6,3,75,M,15,16,0,192,117,Well
11,10,142,M,13,12,6,150,8,Well
12,1,145,F,6,6,6,78,-67,Severe
8,11,107,F,13,12,6,150,43,Well
6,2,74,M,9,7,6,90,16,Well
18,8,224,M,6,6,6,78,-146,Severe
13,9,165,M,7,6,6,78,-87,Severe
18,0,216,M,13,12,6,150,-66,Severe
10,2,122,F,12,11,6,138,16,Well
8,2,98,F,12,11,6,138,40,Well
17,5,209,M,14,14,0,168,-41,Severe
14,8,176,F,10,8,6,102,-74,Severe
16,6,198,F,13,12,6,150,-48,Severe
10,9,129,M,8,7,0,84,-45,Severe
12,10,154,F,10,8,6,102,-52,Severe
15,1,181,M,15,16,0,192,11,Well
6,7,79,M,13,12,6,150,71,Well
17,3,207,F,13,12,6,150,-57,Severe
17,11,215,F,14,14,0,168,-47,Severe
16,9,201,F,11,10,0,120,-81,Severe
13,1,157,F,14,14,0,168,11,Well
11,1,133,F,9,7,6,90,-43,Severe
15,4,184,F,11,10,0,120,-64,Severe
12,3,147,M,14,14,0,168,21,Well
13,2,158,M,12,11,6,138,-20,Severe
16,8,200,M,7,6,6,78,-122,Severe
7,6,90,F,9,7,6,90,0,Neutral
15,8,188,F,12,11,6,138,-50,Severe
11,2,134,F,13,12,6,150,16,Well
13,7,163,M,14,14,0,168,5,Good
11,0,132,M,6,6,6,78,-54,Severe
11,3,135,M,12,11,6,138,3,Good
13,8,164,M,14,14,0,168,4,Good
7,8,92,F,6,6,6,78,-14,Severe
16,3,195,F,10,8,6,102,-93,Severe
13,9,165,F,15,16,0,192,27,Well
10,0,120,M,15,16,0,192,72,Well
6,9,81,F,13,12,6,150,69,Well
13,1,157,F,6,6,6,78,-79,Severe
14,7,175,M,13,12,6,150,-25,Severe
12,2,146,F,12,11,6,138,-8,Severe
15,9,189,M,14,14,0,168,-21,Severe
17,8,212,F,12,11,6,138,-74,Severe
5,1,61,M,12,11,6,138,77,Well
18,8,224,M,10,8,6,102,-122,Severe
6,10,82,F,6,6,6,78,-4,Mild
7,9,93,M,6,6,6,78,-15,Severe
10,1,121,F,7,6,6,78,-43,Severe
7,1,85,F,6,6,6,78,-7,Severe
15,4,184,F,14,14,0,168,-16,Severe
15,2,182,M,12,11,6,138,-44,Severe
6,5,77,M,15,16,0,192,115,Well
9,8,116,M,12,11,6,138,22,Well
7,0,84,F,15,16,0,192,108,Well
13,7,163,F,14,14,0,168,5,Good
12,4,148,M,6,6,6,78,-70,Severe
8,6,102,M,13,12,6,150,48,Well
14,5,173,F,9,7,6,90,-83,Severe
14,5,173,F,8,7,0,84,-89,Severe
5,6,66,F,12,11,6,138,72,Well
12,6,150,F,13,12,6,150,0,Neutral
5,4,64,M,12,11,6,138,74,Well
5,4,64,F,14,14,0,168,104,Well
14,11,179,M,12,11,6,138,-41,Severe
13,3,159,F,10,8,6,102,-57,Severe
16,1,193,F,8,7,0,84,-109,Severe
9,5,113,F,13,12,6,150,37,Well
10,8,128,M,10,8,6,102,-26,Severe
12,4,148,F,14,14,0,168,20,Well
11,9,141,M,13,12,6,150,9,Well
16,0,192,F,6,6,6,78,-114,Severe
13,4,160,F,11,10,0,120,-40,Severe
8,0,96,F,12,11,6,138,42,Well
13,6,162,M,6,6,6,78,-84,Severe
15,5,185,F,14,14,0,168,-17,Severe
16,10,202,M,6,6,6,78,-124,Severe
16,11,203,M,13,12,6,150,-53,Severe
5,10,70,F,8,7,0,84,14,Well
10,11,131,F,12,11,6,138,7,Well
5,11,71,M,8,7,0,84,13,Well
13,7,163,M,7,6,6,78,-85,Severe
5,0,60,M,10,8,6,102,42,Well
14,7,175,F,8,7,0,84,-91,Severe
5,6,66,M,12,11,6,138,72,Well
12,4,148,F,13,12,6,150,2,Good
16,2,194,M,6,6,6,78,-116,Severe
9,10,118,M,9,7,6,90,-28,Severe
7,11,95,M,15,16,0,192,97,Well
12,8,152,F,7,6,6,78,-74,Severe
7,9,93,F,13,12,6,150,57,Well
6,10,82,M,10,8,6,102,20,Well
15,6,186,F,8,7,0,84,-102,Severe
11,6,138,F,13,12,6,150,12,Well
5,5,65,F,13,12,6,150,85,Well
11,1,133,M,6,6,6,78,-55,Severe
13,11,167,M,8,7,0,84,-83,Severe
12,2,146,M,12,11,6,138,-8,Severe
5,3,63,F,11,10,0,120,57,Well
8,6,102,F,12,11,6,138,36,Well
14,5,173,M,15,16,0,192,19,Well
8,5,101,M,15,16,0,192,91,Well
17,6,210,M,9,7,6,90,-120,Severe
13,11,167,F,8,7,0,84,-83,Severe
17,0,204,F,12,11,6,138,-66,Severe
7,9,93,F,7,6,6,78,-15,Severe
7,9,93,M,13,12,6,150,57,Well
14,4,172,M,9,7,6,90,-82,Severe
16,10,202,F,6,6,6,78,-124,Severe
17,6,210,F,14,14,0,168,-42,Severe
15,10,190,M,10,8,6,102,-88,Severe
9,6,114,F,14,14,0,168,54,Well
9,3,111,M,7,6,6,78,-33,Severe
18,3,219,M,13,12,6,150,-69,Severe
12,9,153,F,7,6,6,78,-75,Severe
9,9,117,F,12,11,6,138,21,Well
6,6,78,M,9,7,6,90,12,Well
10,10,130,M,10,8,6,102,-28,Severe
12,0,144,F,15,16,0,192,48,Well
17,9,213,F,8,7,0,84,-129,Severe
9,11,119,M,10,8,6,102,-17,Severe
8,0,96,F,10,8,6,102,6,Well
16,4,196,M,10,8,6,102,-94,Severe
5,0,60,F,14,14,0,168,108,Well
15,11,191,F,11,10,0,120,-71,Severe
15,11,191,F,12,11,6,138,-53,Severe
7,11,95,F,12,11,6,138,43,Well
8,3,99,F,11,10,0,120,21,Well
18,10,226,F,13,12,6,150,-76,Severe
7,11,95,F,15,16,0,192,97,Well
10,2,122,M,10,8,6,102,-20,Severe
5,7,67,M,14,14,0,168,101,Well
18,9,225,M,13,12,6,150,-75,Severe
7,0,84,M,15,16,0,192,108,Well
5,11,71,M,7,6,6,78,7,Well
14,2,170,F,10,8,6,102,-68,Severe
9,1,109,M,15,16,0,192,83,Well
14,8,176,F,14,14,0,168,-8,Severe
16,3,195,M,11,10,0,120,-75,Severe
13,6,162,M,7,6,6,78,-84,Severe
11,9,141,F,7,6,6,78,-63,Severe
9,8,116,F,8,7,0,84,-32,Severe
5,2,62,F,9,7,6,90,28,Well
13,1,157,F,12,11,6,138,-19,Severe
15,9,189,F,12,11,6,138,-51,Severe
14,4,172,F,15,16,0,192,20,Well
12,0,144,F,10,8,6,102,-42,Severe
14,6,174,F,6,6,6,78,-96,Severe
13,4,160,M,7,6,6,78,-82,Severe
8,2,98,F,11,10,0,120,22,Well
12,1,145,M,13,12,6,150,5,Good
14,0,168,M,7,6,6,78,-90,Severe
13,11,167,M,12,11,6,138,-29,Severe
7,6,90,F,6,6,6,78,-12,Severe
8,11,107,F,6,6,6,78,-29,Severe
9,2,110,F,10,8,6,102,-8,Severe
8,11,107,M,13,12,6,150,43,Well
6,5,77,F,6,6,6,78,1,Good
17,0,204,F,10,8,6,102,-102,Severe
14,6,174,F,8,7,0,84,-90,Severe
14,4,172,F,8,7,0,84,-88,Severe
9,1,109,M,12,11,6,138,29,Well
6,6,78,F,12,11,6,138,60,Well
8,1,97,F,14,14,0,168,71,Well
18,5,221,F,11,10,0,120,-101,Severe
5,0,60,F,15,16,0,192,132,Well
10,8,128,M,12,11,6,138,10,Well
5,8,68,M,7,6,6,78,10,Well
15,1,181,M,6,6,6,78,-103,Severe
14,1,169,F,11,10,0,120,-49,Severe
9,1,109,M,11,10,0,120,11,Well
17,1,205,F,10,8,6,102,-103,Severe
6,5,77,F,8,7,0,84,7,Well
11,0,132,M,12,11,6,138,6,Well
7,3,87,F,15,16,0,192,105,Well
17,10,214,M,10,8,6,102,-112,Severe
7,7,91,M,10,8,6,102,11,Well
13,8,164,M,12,11,6,138,-26,Severe
8,2,98,F,13,12,6,150,52,Well
18,2,218,M,7,6,6,78,-140,Severe
14,2,170,M,10,8,6,102,-68,Severe
6,7,79,M,14,14,0,168,89,Well
8,1,97,M,12,11,6,138,41,Well
16,0,192,F,9,7,6,90,-102,Severe
9,10,118,F,9,7,6,90,-28,Severe
16,11,203,M,15,16,0,192,-11,Severe
9,0,108,F,15,16,0,192,84,Well
12,5,149,M,7,6,6,78,-71,Severe
6,10,82,M,6,6,6,78,-4,Mild
16,5,197,M,9,7,6,90,-107,Severe
5,11,71,F,11,10,0,120,49,Well
11,8,140,M,7,6,6,78,-62,Severe
14,4,172,M,8,7,0,84,-88,Severe
8,0,96,F,9,7,6,90,-6,Severe
18,11,227,F,6,6,6,78,-149,Severe
11,8,140,M,9,7,6,90,-50,Severe
18,6,222,M,13,12,6,150,-72,Severe
13,9,165,F,14,14,0,168,3,Good
7,0,84,M,13,12,6,150,66,Well
14,10,178,F,7,6,6,78,-100,Severe
14,3,171,M,12,11,6,138,-33,Severe
15,2,182,M,15,16,0,192,10,Well
9,5,113,F,11,10,0,120,7,Well
8,1,97,M,14,14,0,168,71,Well
15,0,180,M,6,6,6,78,-102,Severe
14,8,176,M,13,12,6,150,-26,Severe
13,9,165,M,6,6,6,78,-87,Severe
13,6,162,F,14,14,0,168,6,Well
15,10,190,M,15,16,0,192,2,Good
12,7,151,F,15,16,0,192,41,Well
17,4,208,M,15,16,0,192,-16,Severe
10,7,127,F,9,7,6,90,-37,Severe
12,4,148,F,15,16,0,192,44,Well
5,4,64,M,8,7,0,84,20,Well
6,1,73,M,11,10,0,120,47,Well
16,3,195,M,7,6,6,78,-117,Severe
14,11,179,M,7,6,6,78,-101,Severe
13,2,158,F,6,6,6,78,-80,Severe
8,7,103,F,13,12,6,150,47,Well
5,11,71,M,15,16,0,192,121,Well
15,7,187,F,7,6,6,78,-109,Severe
5,4,64,F,7,6,6,78,14,Well
14,10,178,F,8,7,0,84,-94,Severe
10,10,130,F,7,6,6,78,-52,Severe
12,7,151,M,6,6,6,78,-73,Severe
10,1,121,M,10,8,6,102,-19,Severe
10,3,123,M,10,8,6,102,-21,Severe
5,2,62,F,7,6,6,78,16,Well
8,3,99,M,13,12,6,150,51,Well
15,0,180,F,9,7,6,90,-90,Severe
7,7,91,M,12,11,6,138,47,Well
11,6,138,F,7,6,6,78,-60,Severe
12,9,153,F,12,11,6,138,-15,Severe
13,8,164,M,11,10,0,120,-44,Severe
10,8,128,M,11,10,0,120,-8,Severe
13,0,156,F,12,11,6,138,-18,Severe
16,9,201,M,6,6,6,78,-123,Severe
18,0,216,F,11,10,0,120,-96,Severe
13,9,165,F,13,12,6,150,-15,Severe
6,2,74,F,7,6,6,78,4,Good
11,5,137,F,13,12,6,150,13,Well
7,7,91,M,13,12,6,150,59,Well
18,3,219,M,11,10,0,120,-99,Severe
12,8,152,F,12,11,6,138,-14,Severe
7,8,92,F,10,8,6,102,10,Well
16,0,192,M,13,12,6,150,-42,Severe
12,4,148,F,9,7,6,90,-58,Severe
13,8,164,M,13,12,6,150,-14,Severe
8,5,101,M,9,7,6,90,-11,Severe
6,2,74,M,7,6,6,78,4,Good
18,8,224,M,9,7,6,90,-134,Severe
12,7,151,M,15,16,0,192,41,Well
18,9,225,F,8,7,0,84,-141,Severe
18,9,225,M,15,16,0,192,-33,Severe
9,10,118,F,10,8,6,102,-16,Severe
16,7,199,F,13,12,6,150,-49,Severe
18,8,224,F,9,7,6,90,-134,Severe
11,7,139,M,12,11,6,138,-1,Mild
10,2,122,M,8,7,0,84,-38,Severe
17,11,215,M,8,7,0,84,-131,Severe
17,6,210,M,8,7,0,84,-126,Severe
16,1,193,F,9,7,6,90,-103,Severe
16,11,203,F,11,10,0,120,-83,Severe
17,2,206,M,10,8,6,102,-104,Severe
7,9,93,M,15,16,0,192,99,Well
9,7,115,F,13,12,6,150,35,Well
11,0,132,M,10,8,6,102,-30,Severe
7,8,92,M,14,14,0,168,76,Well
11,7,139,F,15,16,0,192,53,Well
13,11,167,M,10,8,6,102,-65,Severe
10,5,125,M,7,6,6,78,-47,Severe
6,8,80,M,13,12,6,150,70,Well
6,10,82,F,9,7,6,90,8,Well
18,6,222,F,13,12,6,150,-72,Severe
8,11,107,M,6,6,6,78,-29,Severe
13,3,159,M,6,6,6,78,-81,Severe
7,6,90,M,13,12,6,150,60,Well
9,3,111,M,6,6,6,78,-33,Severe
15,3,183,F,10,8,6,102,-81,Severe
16,7,199,F,8,7,0,84,-115,Severe
16,8,200,M,14,14,0,168,-32,Severe
10,11,131,F,14,14,0,168,37,Well
7,8,92,F,8,7,0,84,-8,Severe
12,10,154,M,15,16,0,192,38,Well
16,6,198,M,7,6,6,78,-120,Severe
15,3,183,M,9,7,6,90,-93,Severe
14,4,172,M,7,6,6,78,-94,Severe
9,0,108,M,10,8,6,102,-6,Severe
8,7,103,F,7,6,6,78,-25,Severe
9,2,110,F,12,11,6,138,28,Well
13,0,156,F,6,6,6,78,-78,Severe
15,9,189,F,7,6,6,78,-111,Severe
13,2,158,M,8,7,0,84,-74,Severe
11,6,138,F,8,7,0,84,-54,Severe
18,3,219,F,11,10,0,120,-99,Severe
5,1,61,F,13,12,6,150,89,Well
16,6,198,M,11,10,0,120,-78,Severe
17,9,213,M,10,8,6,102,-111,Severe
7,10,94,F,14,14,0,168,74,Well
10,1,121,M,8,7,0,84,-37,Severe
9,4,112,F,11,10,0,120,8,Well
5,1,61,M,10,8,6,102,41,Well
14,6,174,M,11,10,0,120,-54,Severe
5,9,69,F,12,11,6,138,69,Well
6,6,78,M,7,6,6,78,0,Neutral
17,3,207,F,11,10,0,120,-87,Severe
6,3,75,F,13,12,6,150,75,Well
15,5,185,F,6,6,6,78,-107,Severe
15,0,180,M,15,16,0,192,12,Well
9,10,118,F,11,10,0,120,2,Good
5,3,63,M,9,7,6,90,27,Well
6,9,81,M,10,8,6,102,21,Well
5,6,66,M,11,10,0,120,54,Well
17,9,213,M,15,16,0,192,-21,Severe
6,10,82,M,7,6,6,78,-4,Mild
6,0,72,M,14,14,0,168,96,Well
7,7,91,F,7,6,6,78,-13,Severe
13,11,167,F,11,10,0,120,-47,Severe
14,6,174,M,9,7,6,90,-84,Severe
13,4,160,F,12,11,6,138,-22,Severe
7,11,95,M,13,12,6,150,55,Well
15,1,181,F,15,16,0,192,11,Well
14,1,169,M,14,14,0,168,-1,Mild
8,5,101,F,11,10,0,120,19,Well
14,11,179,F,13,12,6,150,-29,Severe
17,6,210,F,6,6,6,78,-132,Severe
15,8,188,M,14,14,0,168,-20,Severe
6,9,81,F,14,14,0,168,87,Well
18,8,224,F,8,7,0,84,-140,Severe
16,11,203,F,12,11,6,138,-65,Severe
14,9,177,F,10,8,6,102,-75,Severe
9,5,113,M,15,16,0,192,79,Well
8,10,106,F,6,6,6,78,-28,Severe
11,10,142,F,7,6,6,78,-64,Severe
15,10,190,F,6,6,6,78,-112,Severe
16,7,199,F,15,16,0,192,-7,Severe
5,10,70,F,12,11,6,138,68,Well
14,7,175,M,8,7,0,84,-91,Severe
13,4,160,M,14,14,0,168,8,Well
13,7,163,F,6,6,6,78,-85,Severe
6,7,79,F,9,7,6,90,11,Well
14,9,177,F,15,16,0,192,15,Well
13,10,166,M,15,16,0,192,26,Well
6,0,72,M,10,8,6,102,30,Well
15,8,188,M,12,11,6,138,-50,Severe
17,11,215,F,13,12,6,150,-65,Severe
6,10,82,M,12,11,6,138,56,Well
5,2,62,F,15,16,0,192,130,Well
6,3,75,M,11,10,0,120,45,Well
9,11,119,F,8,7,0,84,-35,Severe
10,4,124,M,6,6,6,78,-46,Severe
9,1,109,M,10,8,6,102,-7,Severe
11,1,133,F,8,7,0,84,-49,Severe
18,1,217,M,8,7,0,84,-133,Severe
14,9,177,M,6,6,6,78,-99,Severe
5,6,66,M,7,6,6,78,12,Well
18,8,224,M,14,14,0,168,-56,Severe
16,5,197,F,11,10,0,120,-77,Severe
14,0,168,F,14,14,0,168,0,Neutral
8,10,106,M,9,7,6,90,-16,Severe
13,9,165,M,11,10,0,120,-45,Severe
6,0,72,F,13,12,6,150,78,Well
5,6,66,F,7,6,6,78,12,Well
14,2,170,F,6,6,6,78,-92,Severe
13,8,164,F,15,16,0,192,28,Well
12,5,149,M,9,7,6,90,-59,Severe
17,4,208,F,8,7,0,84,-124,Severe
16,7,199,M,10,8,6,102,-97,Severe
13,2,158,M,13,12,6,150,-8,Severe
5,7,67,M,9,7,6,90,23,Well
13,11,167,M,9,7,6,90,-77,Severe
9,4,112,F,8,7,0,84,-28,Severe
7,2,86,F,11,10,0,120,34,Well
7,10,94,F,9,7,6,90,-4,Mild
13,5,161,M,7,6,6,78,-83,Severe
15,7,187,M,11,10,0,120,-67,Severe
13,6,162,M,14,14,0,168,6,Well
13,6,162,M,12,11,6,138,-24,Severe
14,4,172,F,6,6,6,78,-94,Severe
15,11,191,M,9,7,6,90,-101,Severe
14,0,168,M,14,14,0,168,0,Neutral
11,8,140,F,15,16,0,192,52,Well
15,0,180,M,11,10,0,120,-60,Severe
11,9,141,F,12,11,6,138,-3,Mild
14,0,168,F,13,12,6,150,-18,Severe
6,0,72,M,7,6,6,78,6,Well
6,9,81,F,11,10,0,120,39,Well
15,0,180,M,14,14,0,168,-12,Severe
10,2,122,F,8,7,0,84,-38,Severe
15,11,191,M,6,6,6,78,-113,Severe
16,11,203,M,10,8,6,102,-101,Severe
18,6,222,F,8,7,0,84,-138,Severe
12,8,152,M,14,14,0,168,16,Well
6,0,72,F,10,8,6,102,30,Well
5,0,60,F,7,6,6,78,18,Well
12,1,145,M,14,14,0,168,23,Well
9,6,114,F,12,11,6,138,24,Well
15,6,186,M,13,12,6,150,-36,Severe
13,6,162,M,8,7,0,84,-78,Severe
15,11,191,F,10,8,6,102,-89,Severe
18,6,222,M,11,10,0,120,-102,Severe
8,8,104,M,11,10,0,120,16,Well
12,3,147,F,12,11,6,138,-9,Severe
5,2,62,F,8,7,0,84,22,Well
5,10,70,M,9,7,6,90,20,Well
7,5,89,F,12,11,6,138,49,Well
8,1,97,F,7,6,6,78,-19,Severe
7,7,91,M,11,10,0,120,29,Well
11,3,135,M,14,14,0,168,33,Well
14,1,169,M,6,6,6,78,-91,Severe
11,5,137,M,9,7,6,90,-47,Severe
9,0,108,M,14,14,0,168,60,Well
14,4,172,F,9,7,6,90,-82,Severe
12,11,155,F,11,10,0,120,-35,Severe
12,1,145,F,13,12,6,150,5,Good
11,4,136,F,10,8,6,102,-34,Severe
16,4,196,F,10,8,6,102,-94,Severe
11,1,133,M,9,7,6,90,-43,Severe
12,4,148,M,14,14,0,168,20,Well
13,10,166,F,14,14,0,168,2,Good
11,11,143,M,8,7,0,84,-59,Severe
6,5,77,F,10,8,6,102,25,Well
8,6,102,F,14,14,0,168,66,Well
10,3,123,F,6,6,6,78,-45,Severe
18,6,222,M,8,7,0,84,-138,Severe
16,5,197,F,8,7,0,84,-113,Severe
7,6,90,M,10,8,6,102,12,Well
14,6,174,M,6,6,6,78,-96,Severe
8,7,103,M,7,6,6,78,-25,Severe
16,2,194,F,14,14,0,168,-26,Severe
18,7,223,M,14,14,0,168,-55,Severe
17,1,205,F,15,16,0,192,-13,Severe
10,4,124,M,15,16,0,192,68,Well
9,0,108,F,8,7,0,84,-24,Severe
16,6,198,F,7,6,6,78,-120,Severe
11,6,138,M,14,14,0,168,30,Well
11,10,142,M,9,7,6,90,-52,Severe
8,10,106,M,10,8,6,102,-4,Mild
8,11,107,M,7,6,6,78,-29,Severe
14,7,175,F,13,12,6,150,-25,Severe
11,2,134,M,14,14,0,168,34,Well
11,11,143,F,11,10,0,120,-23,Severe
8,8,104,M,12,11,6,138,34,Well
15,6,186,M,12,11,6,138,-48,Severe
17,9,213,F,9,7,6,90,-123,Severe
16,6,198,M,6,6,6,78,-120,Severe
8,5,101,M,8,7,0,84,-17,Severe
14,1,169,M,11,10,0,120,-49,Severe
13,6,162,M,10,8,6,102,-60,Severe
14,2,170,F,12,11,6,138,-32,Severe
16,5,197,M,13,12,6,150,-47,Severe
12,7,151,M,13,12,6,150,-1,Mild
18,1,217,F,9,7,6,90,-127,Severe
14,10,178,M,14,14,0,168,-10,Severe
17,2,206,F,15,16,0,192,-14,Severe
11,3,135,F,13,12,6,150,15,Well
16,10,202,M,15,16,0,192,-10,Severe
5,1,61,F,10,8,6,102,41,Well
12,5,149,M,14,14,0,168,19,Well
18,8,224,M,7,6,6,78,-146,Severe
18,5,221,F,9,7,6,90,-131,Severe
12,3,147,M,10,8,6,102,-45,Severe
18,9,225,F,6,6,6,78,-147,Severe
5,1,61,M,11,10,0,120,59,Well
9,1,109,F,8,7,0,84,-25,Severe
11,6,138,M,6,6,6,78,-60,Severe
17,4,208,F,11,10,0,120,-88,Severe
13,11,167,M,11,10,0,120,-47,Severe
12,6,150,M,12,11,6,138,-12,Severe
6,11,83,M,6,6,6,78,-5,Mild
7,10,94,M,10,8,6,102,8,Well
17,2,206,F,8,7,0,84,-122,Severe
8,0,96,M,14,14,0,168,72,Well
10,2,122,F,11,10,0,120,-2,Mild
9,1,109,F,6,6,6,78,-31,Severe
15,0,180,F,13,12,6,150,-30,Severe
11,10,142,M,14,14,0,168,26,Well
6,1,73,F,11,10,0,120,47,Well
5,11,71,M,10,8,6,102,31,Well
5,0,60,M,8,7,0,84,24,Well
13,3,159,M,10,8,6,102,-57,Severe
10,3,123,M,12,11,6,138,15,Well
17,3,207,M,8,7,0,84,-123,Severe
10,0,120,F,12,11,6,138,18,Well
10,11,131,M,11,10,0,120,-11,Severe
8,0,96,M,10,8,6,102,6,Well
15,10,190,F,14,14,0,168,-22,Severe
5,7,67,M,10,8,6,102,35,Well
13,2,158,F,10,8,6,102,-56,Severe
6,4,76,M,10,8,6,102,26,Well
15,2,182,M,8,7,0,84,-98,Severe
5,9,69,F,14,14,0,168,99,Well
5,4,64,F,11,10,0,120,56,Well
15,9,189,M,8,7,0,84,-105,Severe
5,4,64,F,13,12,6,150,86,Well
9,7,115,M,7,6,6,78,-37,Severe
15,1,181,M,9,7,6,90,-91,Severe
15,10,190,F,13,12,6,150,-40,Severe
5,7,67,M,7,6,6,78,11,Well
11,1,133,M,14,14,0,168,35,Well
9,0,108,F,9,7,6,90,-18,Severe
12,8,152,F,9,7,6,90,-62,Severe
7,4,88,F,9,7,6,90,2,Good
9,8,116,F,12,11,6,138,22,Well
13,3,159,M,7,6,6,78,-81,Severe
11,1,133,F,7,6,6,78,-55,Severe
11,3,135,F,15,16,0,192,57,Well
9,7,115,F,15,16,0,192,77,Well
6,6,78,F,8,7,0,84,6,Well
17,10,214,M,11,10,0,120,-94,Severe
16,4,196,M,12,11,6,138,-58,Severe
11,7,139,M,6,6,6,78,-61,Severe
7,8,92,M,11,10,0,120,28,Well
17,4,208,M,6,6,6,78,-130,Severe
18,4,220,M,10,8,6,102,-118,Severe
15,6,186,F,7,6,6,78,-108,Severe
13,6,162,F,13,12,6,150,-12,Severe
8,4,100,M,8,7,0,84,-16,Severe
17,4,208,F,12,11,6,138,-70,Severe
11,2,134,F,8,7,0,84,-50,Severe
15,2,182,F,8,7,0,84,-98,Severe
5,9,69,M,11,10,0,120,51,Well
14,5,173,M,8,7,0,84,-89,Severe
11,3,135,M,13,12,6,150,15,Well
14,11,179,F,14,14,0,168,-11,Severe
8,0,96,F,7,6,6,78,-18,Severe
12,4,148,M,12,11,6,138,-10,Severe
18,6,222,F,7,6,6,78,-144,Severe
10,7,127,F,13,12,6,150,23,Well
18,1,217,F,11,10,0,120,-97,Severe
11,3,135,M,15,16,0,192,57,Well
11,4,136,M,6,6,6,78,-58,Severe
8,6,102,F,13,12,6,150,48,Well
15,10,190,F,11,10,0,120,-70,Severe
7,0,84,M,6,6,6,78,-6,Severe
10,1,121,M,11,10,0,120,-1,Mild
10,7,127,F,11,10,0,120,-7,Severe
9,2,110,F,13,12,6,150,40,Well
5,1,61,F,15,16,0,192,131,Well
14,0,168,M,10,8,6,102,-66,Severe
17,3,207,M,10,8,6,102,-105,Severe
6,7,79,M,7,6,6,78,-1,Mild
10,3,123,M,11,10,0,120,-3,Mild
5,8,68,M,14,14,0,168,100,Well
16,8,200,F,12,11,6,138,-62,Severe
12,1,145,M,9,7,6,90,-55,Severe
6,10,82,M,13,12,6,150,68,Well
5,9,69,F,10,8,6,102,33,Well
12,11,155,M,9,7,6,90,-65,Severe
17,8,212,F,13,12,6,150,-62,Severe
12,9,153,F,11,10,0,120,-33,Severe
13,10,166,M,13,12,6,150,-16,Severe
10,8,128,F,15,16,0,192,64,Well
12,0,144,M,11,10,0,120,-24,Severe
5,10,70,M,7,6,6,78,8,Well
17,3,207,F,15,16,0,192,-15,Severe
16,6,198,F,14,14,0,168,-30,Severe
9,4,112,M,14,14,0,168,56,Well
9,11,119,F,13,12,6,150,31,Well
11,1,133,F,6,6,6,78,-55,Severe
10,11,131,M,8,7,0,84,-47,Severe
18,6,222,M,14,14,0,168,-54,Severe
11,3,135,M,8,7,0,84,-51,Severe
7,11,95,F,11,10,0,120,25,Well
5,0,60,M,13,12,6,150,90,Well
8,2,98,M,10,8,6,102,4,Good
18,0,216,M,15,16,0,192,-24,Severe
17,4,208,F,15,16,0,192,-16,Severe
18,11,227,M,9,7,6,90,-137,Severe
6,2,74,M,13,12,6,150,76,Well
14,8,176,M,6,6,6,78,-98,Severe
6,1,73,F,10,8,6,102,29,Well
17,5,209,F,9,7,6,90,-119,Severe
12,9,153,F,9,7,6,90,-63,Severe
9,7,115,M,13,12,6,150,35,Well
8,11,107,M,10,8,6,102,-5,Mild
14,10,178,M,11,10,0,120,-58,Severe
6,2,74,F,10,8,6,102,28,Well
11,5,137,M,14,14,0,168,31,Well
5,2,62,F,12,11,6,138,76,Well
7,0,84,F,12,11,6,138,54,Well
9,6,114,M,14,14,0,168,54,Well
11,9,141,F,8,7,0,84,-57,Severe
15,4,184,M,6,6,6,78,-106,Severe
7,7,91,F,14,14,0,168,77,Well
14,9,177,F,7,6,6,78,-99,Severe
14,3,171,M,10,8,6,102,-69,Severe
18,4,220,M,12,11,6,138,-82,Severe
17,1,205,F,6,6,6,78,-127,Severe
13,6,162,M,13,12,6,150,-12,Severe
14,6,174,F,10,8,6,102,-72,Severe
16,4,196,F,6,6,6,78,-118,Severe
14,11,179,F,9,7,6,90,-89,Severe
8,6,102,F,8,7,0,84,-18,Severe
7,1,85,M,9,7,6,90,5,Good
12,8,152,F,10,8,6,102,-50,Severe
11,2,134,M,6,6,6,78,-56,Severe
5,7,67,M,8,7,0,84,17,Well
5,3,63,F,10,8,6,102,39,Well
18,4,220,F,13,12,6,150,-70,Severe
14,6,174,F,11,10,0,120,-54,Severe
10,7,127,M,7,6,6,78,-49,Severe
15,1,181,F,7,6,6,78,-103,Severe
10,5,125,M,9,7,6,90,-35,Severe
6,2,74,F,9,7,6,90,16,Well
13,5,161,F,9,7,6,90,-71,Severe
6,8,80,F,14,14,0,168,88,Well
12,7,151,F,13,12,6,150,-1,Mild
6,11,83,F,6,6,6,78,-5,Mild
9,9,117,F,13,12,6,150,33,Well
9,4,112,M,7,6,6,78,-34,Severe
11,2,134,F,14,14,0,168,34,Well
17,1,205,F,9,7,6,90,-115,Severe
7,5,89,F,6,6,6,78,-11,Severe
16,10,202,F,12,11,6,138,-64,Severe
15,10,190,M,13,12,6,150,-40,Severe
11,5,137,F,9,7,6,90,-47,Severe
15,5,185,F,12,11,6,138,-47,Severe
7,10,94,F,8,7,0,84,-10,Severe
13,2,158,F,13,12,6,150,-8,Severe
13,7,163,F,10,8,6,102,-61,Severe
14,10,178,M,12,11,6,138,-40,Severe
12,5,149,F,9,7,6,90,-59,Severe
7,0,84,F,8,7,0,84,0,Neutral
14,4,172,F,13,12,6,150,-22,Severe
18,5,221,F,14,14,0,168,-53,Severe
9,2,110,M,12,11,6,138,28,Well
18,3,219,M,9,7,6,90,-129,Severe
18,3,219,M,15,16,0,192,-27,Severe
17,0,204,M,15,16,0,192,-12,Severe
12,6,150,M,7,6,6,78,-72,Severe
9,6,114,F,9,7,6,90,-24,Severe
13,9,165,F,8,7,0,84,-81,Severe
6,10,82,F,13,12,6,150,68,Well
14,9,177,M,10,8,6,102,-75,Severe
8,1,97,M,9,7,6,90,-7,Severe
8,5,101,M,12,11,6,138,37,Well
8,3,99,M,15,16,0,192,93,Well
10,6,126,M,13,12,6,150,24,Well
18,10,226,M,6,6,6,78,-148,Severe
9,7,115,F,6,6,6,78,-37,Severe
5,7,67,F,9,7,6,90,23,Well
9,6,114,M,7,6,6,78,-36,Severe
5,7,67,F,12,11,6,138,71,Well
12,0,144,F,8,7,0,84,-60,Severe
18,8,224,M,13,12,6,150,-74,Severe
8,10,106,M,6,6,6,78,-28,Severe
6,1,73,F,7,6,6,78,5,Good
16,7,199,M,9,7,6,90,-109,Severe
10,4,124,F,15,16,0,192,68,Well
7,6,90,F,7,6,6,78,-12,Severe
17,7,211,M,15,16,0,192,-19,Severe
9,1,109,F,9,7,6,90,-19,Severe
15,7,187,M,6,6,6,78,-109,Severe
12,6,150,M,14,14,0,168,18,Well
6,2,74,F,14,14,0,168,94,Well
16,3,195,M,8,7,0,84,-111,Severe
16,9,201,M,9,7,6,90,-111,Severe
17,4,208,M,13,12,6,150,-58,Severe
15,6,186,M,6,6,6,78,-108,Severe
16,5,197,M,7,6,6,78,-119,Severe
8,4,100,M,12,11,6,138,38,Well
18,6,222,F,6,6,6,78,-144,Severe
18,7,223,M,10,8,6,102,-121,Severe
17,8,212,M,7,6,6,78,-134,Severe
6,3,75,M,10,8,6,102,27,Well
11,1,133,M,7,6,6,78,-55,Severe
10,3,123,F,12,11,6,138,15,Well
15,11,191,M,15,16,0,192,1,Good
15,2,182,F,10,8,6,102,-80,Severe
9,10,118,F,14,14,0,168,50,Well
16,4,196,M,11,10,0,120,-76,Severe
10,0,120,F,15,16,0,192,72,Well
11,11,143,M,14,14,0,168,25,Well
11,4,136,F,9,7,6,90,-46,Severe
6,10,82,F,15,16,0,192,110,Well
9,5,113,F,8,7,0,84,-29,Severe
8,7,103,M,14,14,0,168,65,Well
7,5,89,F,14,14,0,168,79,Well
8,3,99,M,11,10,0,120,21,Well
11,10,142,F,9,7,6,90,-52,Severe
14,4,172,M,14,14,0,168,-4,Mild
13,2,158,M,11,10,0,120,-38,Severe
5,7,67,F,7,6,6,78,11,Well
9,0,108,F,7,6,6,78,-30,Severe
8,9,105,M,7,6,6,78,-27,Severe
16,10,202,F,8,7,0,84,-118,Severe
11,11,143,F,15,16,0,192,49,Well
17,6,210,M,10,8,6,102,-108,Severe
13,0,156,F,8,7,0,84,-72,Severe
11,6,138,F,11,10,0,120,-18,Severe
17,7,211,M,10,8,6,102,-109,Severe
7,7,91,M,14,14,0,168,77,Well
13,1,157,F,11,10,0,120,-37,Severe
15,3,183,M,11,10,0,120,-63,Severe
6,0,72,M,15,16,0,192,120,Well
9,11,119,M,8,7,0,84,-35,Severe
12,5,149,F,10,8,6,102,-47,Severe
16,8,200,M,8,7,0,84,-116,Severe
16,1,193,F,15,16,0,192,-1,Mild
16,1,193,M,15,16,0,192,-1,Mild
13,9,165,F,6,6,6,78,-87,Severe
11,7,139,F,7,6,6,78,-61,Severe
7,1,85,M,8,7,0,84,-1,Mild
8,3,99,M,12,11,6,138,39,Well
12,5,149,M,6,6,6,78,-71,Severe
18,2,218,M,9,7,6,90,-128,Severe
10,8,128,M,13,12,6,150,22,Well
14,6,174,F,13,12,6,150,-24,Severe
9,6,114,M,13,12,6,150,36,Well
15,10,190,F,7,6,6,78,-112,Severe
8,2,98,F,15,16,0,192,94,Well
15,0,180,M,13,12,6,150,-30,Severe
6,0,72,F,15,16,0,192,120,Well
12,8,152,M,8,7,0,84,-68,Severe
10,6,126,M,10,8,6,102,-24,Severe
17,9,213,F,6,6,6,78,-135,Severe
9,4,112,M,15,16,0,192,80,Well
13,5,161,M,15,16,0,192,31,Well
18,10,226,F,12,11,6,138,-88,Severe
8,3,99,F,8,7,0,84,-15,Severe
9,10,118,M,10,8,6,102,-16,Severe
8,2,98,F,6,6,6,78,-20,Severe
9,6,114,M,8,7,0,84,-30,Severe
7,9,93,M,7,6,6,78,-15,Severe
15,9,189,M,6,6,6,78,-111,Severe
10,0,120,M,6,6,6,78,-42,Severe
9,2,110,M,15,16,0,192,82,Well
14,1,169,M,9,7,6,90,-79,Severe
18,2,218,F,6,6,6,78,-140,Severe
10,2,122,F,13,12,6,150,28,Well
18,4,220,F,14,14,0,168,-52,Severe
9,9,117,F,10,8,6,102,-15,Severe
10,4,124,M,10,8,6,102,-22,Severe
8,11,107,M,11,10,0,120,13,Well
14,2,170,M,12,11,6,138,-32,Severe
9,8,116,M,10,8,6,102,-14,Severe
8,9,105,F,11,10,0,120,15,Well
9,11,119,F,14,14,0,168,49,Well
17,11,215,M,11,10,0,120,-95,Severe
13,2,158,M,6,6,6,78,-80,Severe
15,7,187,F,15,16,0,192,5,Good
6,2,74,M,12,11,6,138,64,Well
17,1,205,M,10,8,6,102,-103,Severe
17,2,206,F,13,12,6,150,-56,Severe
14,1,169,M,8,7,0,84,-85,Severe
6,7,79,M,6,6,6,78,-1,Mild
16,6,198,F,8,7,0,84,-114,Severe
9,3,111,F,12,11,6,138,27,Well
14,3,171,F,7,6,6,78,-93,Severe
16,11,203,F,8,7,0,84,-119,Severe
10,1,121,M,15,16,0,192,71,Well
16,3,195,M,6,6,6,78,-117,Severe
7,7,91,M,6,6,6,78,-13,Severe
17,11,215,F,12,11,6,138,-77,Severe
10,2,122,M,12,11,6,138,16,Well
7,2,86,F,12,11,6,138,52,Well
9,9,117,F,9,7,6,90,-27,Severe
12,3,147,F,11,10,0,120,-27,Severe
10,2,122,F,7,6,6,78,-44,Severe
8,6,102,F,15,16,0,192,90,Well
15,4,184,M,9,7,6,90,-94,Severe
15,5,185,M,7,6,6,78,-107,Severe
10,6,126,F,11,10,0,120,-6,Severe
10,7,127,M,12,11,6,138,11,Well
9,10,118,M,8,7,0,84,-34,Severe
6,6,78,F,15,16,0,192,114,Well
7,4,88,F,6,6,6,78,-10,Severe
14,9,177,M,14,14,0,168,-9,Severe
6,7,79,F,11,10,0,120,41,Well
8,10,106,F,14,14,0,168,62,Well
10,8,128,F,9,7,6,90,-38,Severe
11,7,139,M,15,16,0,192,53,Well
5,8,68,M,8,7,0,84,16,Well
12,3,147,M,13,12,6,150,3,Good
14,9,177,M,11,10,0,120,-57,Severe
5,1,61,M,7,6,6,78,17,Well
14,3,171,M,15,16,0,192,21,Well
16,10,202,M,13,12,6,150,-52,Severe
18,10,226,M,13,12,6,150,-76,Severe
18,8,224,M,8,7,0,84,-140,Severe
16,4,196,F,14,14,0,168,-28,Severe
11,8,140,M,15,16,0,192,52,Well
14,9,177,M,8,7,0,84,-93,Severe
7,0,84,F,9,7,6,90,6,Well
15,8,188,M,13,12,6,150,-38,Severe
16,6,198,F,6,6,6,78,-120,Severe
15,6,186,M,9,7,6,90,-96,Severe
17,5,209,M,13,12,6,150,-59,Severe
11,0,132,M,8,7,0,84,-48,Severe
10,7,127,M,9,7,6,90,-37,Severe
15,10,190,M,8,7,0,84,-106,Severe
15,10,190,F,8,7,0,84,-106,Severe
6,3,75,M,12,11,6,138,63,Well
18,4,220,M,14,14,0,168,-52,Severe
5,9,69,F,9,7,6,90,21,Well
12,11,155,F,7,6,6,78,-77,Severe
13,9,165,M,10,8,6,102,-63,Severe
15,5,185,M,8,7,0,84,-101,Severe
9,2,110,M,11,10,0,120,10,Well
12,4,148,M,10,8,6,102,-46,Severe
15,7,187,F,8,7,0,84,-103,Severe
17,8,212,F,7,6,6,78,-134,Severe
5,6,66,M,8,7,0,84,18,Well
8,2,98,M,14,14,0,168,70,Well
8,6,102,M,12,11,6,138,36,Well
7,2,86,F,15,16,0,192,106,Well
17,0,204,F,15,16,0,192,-12,Severe
15,7,187,F,13,12,6,150,-37,Severe
17,3,207,F,7,6,6,78,-129,Severe
17,11,215,M,6,6,6,78,-137,Severe
12,11,155,F,13,12,6,150,-5,Mild
10,8,128,M,14,14,0,168,40,Well
18,0,216,F,12,11,6,138,-78,Severe
17,3,207,M,7,6,6,78,-129,Severe
14,10,178,M,10,8,6,102,-76,Severe
13,1,157,M,10,8,6,102,-55,Severe
11,2,134,F,12,11,6,138,4,Good
8,11,107,F,12,11,6,138,31,Well
18,11,227,F,7,6,6,78,-149,Severe
9,7,115,F,11,10,0,120,5,Good
14,5,173,M,12,11,6,138,-35,Severe
16,0,192,F,13,12,6,150,-42,Severe
12,4,148,M,15,16,0,192,44,Well
11,6,138,F,12,11,6,138,0,Neutral
15,6,186,F,12,11,6,138,-48,Severe
9,9,117,M,11,10,0,120,3,Good
15,4,184,F,7,6,6,78,-106,Severe
14,10,178,M,13,12,6,150,-28,Severe
12,10,154,M,6,6,6,78,-76,Severe
9,7,115,M,15,16,0,192,77,Well
15,11,191,M,13,12,6,150,-41,Severe
11,5,137,F,10,8,6,102,-35,Severe
11,0,132,F,8,7,0,84,-48,Severe
13,5,161,F,8,7,0,84,-77,Severe
5,8,68,F,13,12,6,150,82,Well
8,10,106,F,8,7,0,84,-22,Severe
9,3,111,M,10,8,6,102,-9,Severe
5,8,68,M,10,8,6,102,34,Well
5,5,65,M,14,14,0,168,103,Well
15,5,185,M,14,14,0,168,-17,Severe
11,11,143,M,9,7,6,90,-53,Severe
16,10,202,M,9,7,6,90,-112,Severe
16,10,202,M,10,8,6,102,-100,Severe
16,3,195,F,7,6,6,78,-117,Severe
11,8,140,F,8,7,0,84,-56,Severe
5,0,60,F,6,6,6,78,18,Well
10,4,124,F,12,11,6,138,14,Well
18,7,223,F,7,6,6,78,-145,Severe
9,1,109,F,15,16,0,192,83,Well
15,3,183,M,14,14,0,168,-15,Severe
8,6,102,F,6,6,6,78,-24,Severe
9,4,112,M,10,8,6,102,-10,Severe
18,2,218,F,11,10,0,120,-98,Severe
15,1,181,M,12,11,6,138,-43,Severe
7,2,86,F,7,6,6,78,-8,Severe
18,7,223,F,9,7,6,90,-133,Severe
5,1,61,M,6,6,6,78,17,Well
6,5,77,M,12,11,6,138,61,Well
13,10,166,M,14,14,0,168,2,Good
9,0,108,F,11,10,0,120,12,Well
15,7,187,F,11,10,0,120,-67,Severe
15,9,189,F,8,7,0,84,-105,Severe
15,2,182,F,7,6,6,78,-104,Severe
18,10,226,M,11,10,0,120,-106,Severe
6,2,74,F,15,16,0,192,118,Well
18,9,225,M,14,14,0,168,-57,Severe
12,6,150,M,10,8,6,102,-48,Severe
11,2,134,F,10,8,6,102,-32,Severe
13,6,162,F,15,16,0,192,30,Well
18,10,226,F,9,7,6,90,-136,Severe
13,0,156,M,7,6,6,78,-78,Severe
16,5,197,M,6,6,6,78,-119,Severe
15,3,183,F,13,12,6,150,-33,Severe
9,4,112,F,6,6,6,78,-34,Severe
10,7,127,F,14,14,0,168,41,Well
12,0,144,M,6,6,6,78,-66,Severe
6,11,83,F,9,7,6,90,7,Well
17,9,213,F,12,11,6,138,-75,Severe
5,5,65,M,15,16,0,192,127,Well
18,8,224,F,14,14,0,168,-56,Severe
14,11,179,M,6,6,6,78,-101,Severe
7,8,92,M,7,6,6,78,-14,Severe
10,9,129,F,11,10,0,120,-9,Severe
14,8,176,M,14,14,0,168,-8,Severe
7,1,85,F,10,8,6,102,17,Well
17,11,215,M,7,6,6,78,-137,Severe
7,11,95,M,9,7,6,90,-5,Mild
6,9,81,M,13,12,6,150,69,Well
15,11,191,F,14,14,0,168,-23,Severe
8,7,103,F,15,16,0,192,89,Well
6,4,76,M,9,7,6,90,14,Well
11,5,137,M,11,10,0,120,-17,Severe
9,9,117,M,6,6,6,78,-39,Severe
10,9,129,M,15,16,0,192,63,Well
5,1,61,F,12,11,6,138,77,Well
14,0,168,M,9,7,6,90,-78,Severe
18,4,220,M,13,12,6,150,-70,Severe
9,11,119,F,12,11,6,138,19,Well
12,6,150,F,9,7,6,90,-60,Severe
13,6,162,F,12,11,6,138,-24,Severe
10,6,126,M,11,10,0,120,-6,Severe
13,3,159,F,12,11,6,138,-21,Severe
16,8,200,F,6,6,6,78,-122,Severe
15,6,186,F,9,7,6,90,-96,Severe
10,5,125,F,6,6,6,78,-47,Severe
13,3,159,M,14,14,0,168,9,Well
18,2,218,F,14,14,0,168,-50,Severe
15,10,190,M,12,11,6,138,-52,Severe
7,4,88,F,14,14,0,168,80,Well
10,7,127,M,10,8,6,102,-25,Severe
16,1,193,F,7,6,6,78,-115,Severe
7,10,94,M,15,16,0,192,98,Well
8,10,106,F,10,8,6,102,-4,Mild
17,4,208,M,10,8,6,102,-106,Severe
18,1,217,M,14,14,0,168,-49,Severe
15,2,182,M,10,8,6,102,-80,Severe
9,5,113,F,7,6,6,78,-35,Severe
18,4,220,M,9,7,6,90,-130,Severe
12,11,155,M,15,16,0,192,37,Well
16,0,192,M,6,6,6,78,-114,Severe
17,2,206,M,7,6,6,78,-128,Severe
7,1,85,F,7,6,6,78,-7,Severe
5,3,63,F,9,7,6,90,27,Well
15,3,183,F,6,6,6,78,-105,Severe
15,4,184,M,14,14,0,168,-16,Severe
5,6,66,F,11,10,0,120,54,Well
15,10,190,F,12,11,6,138,-52,Severe
13,10,166,M,12,11,6,138,-28,Severe
5,7,67,M,15,16,0,192,125,Well
7,3,87,M,7,6,6,78,-9,Severe
10,7,127,F,10,8,6,102,-25,Severe
5,10,70,F,14,14,0,168,98,Well
13,11,167,M,13,12,6,150,-17,Severe
17,11,215,F,8,7,0,84,-131,Severe
12,11,155,F,15,16,0,192,37,Well
11,10,142,F,6,6,6,78,-64,Severe
14,2,170,F,15,16,0,192,22,Well
12,11,155,F,14,14,0,168,13,Well
7,1,85,F,15,16,0,192,107,Well
15,9,189,M,9,7,6,90,-99,Severe
9,1,109,M,13,12,6,150,41,Well
12,8,152,F,15,16,0,192,40,Well
7,6,90,F,12,11,6,138,48,Well
14,11,179,F,8,7,0,84,-95,Severe
12,8,152,M,7,6,6,78,-74,Severe
6,5,77,F,14,14,0,168,91,Well
7,8,92,F,15,16,0,192,100,Well
5,7,67,M,12,11,6,138,71,Well
7,9,93,F,6,6,6,78,-15,Severe
5,4,64,M,14,14,0,168,104,Well
10,1,121,F,9,7,6,90,-31,Severe
6,4,76,F,11,10,0,120,44,Well
11,6,138,M,12,11,6,138,0,Neutral
12,6,150,M,13,12,6,150,0,Neutral
14,6,174,M,12,11,6,138,-36,Severe
18,1,217,F,12,11,6,138,-79,Severe
9,1,109,M,14,14,0,168,59,Well
9,3,111,F,10,8,6,102,-9,Severe
8,7,103,M,13,12,6,150,47,Well
16,6,198,M,10,8,6,102,-96,Severe
18,9,225,F,15,16,0,192,-33,Severe
7,4,88,F,8,7,0,84,-4,Mild
13,5,161,F,13,12,6,150,-11,Severe
10,4,124,F,9,7,6,90,-34,Severe
10,0,120,F,14,14,0,168,48,Well
16,11,203,F,13,12,6,150,-53,Severe
15,10,190,M,6,6,6,78,-112,Severe
18,11,227,M,13,12,6,150,-77,Severe
8,3,99,F,9,7,6,90,-9,Severe
13,11,167,F,7,6,6,78,-89,Severe
6,4,76,F,14,14,0,168,92,Well
8,0,96,M,11,10,0,120,24,Well
17,2,206,M,12,11,6,138,-68,Severe
15,7,187,F,12,11,6,138,-49,Severe
6,9,81,M,14,14,0,168,87,Well
16,10,202,F,13,12,6,150,-52,Severe
18,8,224,M,15,16,0,192,-32,Severe
17,9,213,F,10,8,6,102,-111,Severe
16,11,203,F,14,14,0,168,-35,Severe
17,10,214,F,7,6,6,78,-136,Severe
16,7,199,F,10,8,6,102,-97,Severe
6,11,83,F,11,10,0,120,37,Well
15,5,185,F,13,12,6,150,-35,Severe
6,11,83,M,7,6,6,78,-5,Mild
13,3,159,M,11,10,0,120,-39,Severe
6,2,74,F,8,7,0,84,10,Well
12,9,153,M,7,6,6,78,-75,Severe
5,7,67,F,11,10,0,120,53,Well
6,7,79,M,9,7,6,90,11,Well
8,10,106,F,11,10,0,120,14,Well
18,7,223,F,6,6,6,78,-145,Severe
6,9,81,F,8,7,0,84,3,Good
9,9,117,M,13,12,6,150,33,Well
13,8,164,M,9,7,6,90,-74,Severe
5,4,64,F,6,6,6,78,14,Well
12,3,147,F,10,8,6,102,-45,Severe
13,10,166,M,9,7,6,90,-76,Severe
18,9,225,F,13,12,6,150,-75,Severe
15,8,188,M,10,8,6,102,-86,Severe
17,9,213,M,8,7,0,84,-129,Severe
17,6,210,M,7,6,6,78,-132,Severe
6,9,81,F,10,8,6,102,21,Well
16,9,201,F,8,7,0,84,-117,Severe
16,0,192,F,11,10,0,120,-72,Severe
17,2,206,M,15,16,0,192,-14,Severe
17,6,210,M,13,12,6,150,-60,Severe
5,0,60,M,7,6,6,78,18,Well
14,8,176,M,7,6,6,78,-98,Severe
11,11,143,F,6,6,6,78,-65,Severe
5,2,62,F,10,8,6,102,40,Well
15,6,186,F,14,14,0,168,-18,Severe
8,5,101,F,15,16,0,192,91,Well
17,3,207,M,9,7,6,90,-117,Severe
16,11,203,M,14,14,0,168,-35,Severe
8,9,105,F,13,12,6,150,45,Well
17,0,204,M,13,12,6,150,-54,Severe
8,10,106,M,8,7,0,84,-22,Severe
18,9,225,F,11,10,0,120,-105,Severe
12,10,154,F,9,7,6,90,-64,Severe
15,4,184,F,15,16,0,192,8,Well
14,7,175,F,7,6,6,78,-97,Severe
8,8,104,F,13,12,6,150,46,Well
7,6,90,M,8,7,0,84,-6,Severe
5,1,61,F,9,7,6,90,29,Well
8,1,97,F,11,10,0,120,23,Well
9,6,114,F,11,10,0,120,6,Well
18,7,223,M,8,7,0,84,-139,Severe
18,0,216,M,12,11,6,138,-78,Severe
5,10,70,F,13,12,6,150,80,Well
15,0,180,F,7,6,6,78,-102,Severe
8,1,97,M,15,16,0,192,95,Well
14,7,175,M,15,16,0,192,17,Well
15,4,184,F,8,7,0,84,-100,Severe
7,10,94,F,7,6,6,78,-16,Severe
5,5,65,M,7,6,6,78,13,Well
17,5,209,M,9,7,6,90,-119,Severe
12,0,144,M,7,6,6,78,-66,Severe
14,7,175,M,11,10,0,120,-55,Severe
16,0,192,M,14,14,0,168,-24,Severe
17,1,205,F,7,6,6,78,-127,Severe
6,0,72,F,12,11,6,138,66,Well
7,3,87,M,10,8,6,102,15,Well
17,3,207,M,11,10,0,120,-87,Severe
7,10,94,F,11,10,0,120,26,Well
18,6,222,F,10,8,6,102,-120,Severe
5,5,65,M,12,11,6,138,73,Well
12,1,145,F,10,8,6,102,-43,Severe
12,10,154,F,7,6,6,78,-76,Severe
5,3,63,M,13,12,6,150,87,Well
11,7,139,M,10,8,6,102,-37,Severe
12,7,151,F,10,8,6,102,-49,Severe
14,11,179,F,15,16,0,192,13,Well
12,2,146,F,14,14,0,168,22,Well
15,3,183,M,6,6,6,78,-105,Severe
12,6,150,F,11,10,0,120,-30,Severe
17,7,211,F,6,6,6,78,-133,Severe
18,6,222,F,11,10,0,120,-102,Severe
8,9,105,M,10,8,6,102,-3,Mild
6,11,83,F,12,11,6,138,55,Well
7,2,86,M,13,12,6,150,64,Well
6,6,78,F,10,8,6,102,24,Well
11,1,133,F,13,12,6,150,17,Well
11,7,139,M,7,6,6,78,-61,Severe
18,9,225,M,7,6,6,78,-147,Severe
6,10,82,M,9,7,6,90,8,Well
12,4,148,F,11,10,0,120,-28,Severe
12,1,145,M,10,8,6,102,-43,Severe
11,9,141,F,11,10,0,120,-21,Severe
9,6,114,F,15,16,0,192,78,Well
16,3,195,M,13,12,6,150,-45,Severe
6,11,83,M,14,14,0,168,85,Well
7,1,85,M,6,6,6,78,-7,Severe
18,1,217,M,9,7,6,90,-127,Severe
9,8,116,M,9,7,6,90,-26,Severe
8,7,103,M,6,6,6,78,-25,Severe
18,11,227,F,9,7,6,90,-137,Severe
18,8,224,M,11,10,0,120,-104,Severe
7,4,88,M,9,7,6,90,2,Good
17,5,209,F,10,8,6,102,-107,Severe
17,2,206,M,11,10,0,120,-86,Severe
16,2,194,M,7,6,6,78,-116,Severe
17,10,214,F,12,11,6,138,-76,Severe
15,8,188,M,11,10,0,120,-68,Severe
15,2,182,M,6,6,6,78,-104,Severe
10,6,126,F,7,6,6,78,-48,Severe
15,6,186,M,10,8,6,102,-84,Severe
15,0,180,F,6,6,6,78,-102,Severe
10,10,130,M,13,12,6,150,20,Well
5,2,62,M,11,10,0,120,58,Well
16,5,197,M,15,16,0,192,-5,Mild
11,8,140,M,6,6,6,78,-62,Severe
10,1,121,F,8,7,0,84,-37,Severe
9,7,115,M,12,11,6,138,23,Well
10,11,131,M,9,7,6,90,-41,Severe
6,3,75,F,6,6,6,78,3,Good
8,6,102,M,15,16,0,192,90,Well
11,7,139,M,9,7,6,90,-49,Severe
6,10,82,F,12,11,6,138,56,Well
7,2,86,F,6,6,6,78,-8,Severe
15,10,190,F,10,8,6,102,-88,Severe
15,2,182,M,11,10,0,120,-62,Severe
9,7,115,F,7,6,6,78,-37,Severe
17,9,213,F,7,6,6,78,-135,Severe
9,5,113,F,9,7,6,90,-23,Severe
7,2,86,M,8,7,0,84,-2,Mild
16,8,200,M,9,7,6,90,-110,Severe
12,11,155,M,10,8,6,102,-53,Severe
7,9,93,M,10,8,6,102,9,Well
6,7,79,M,11,10,0,120,41,Well
9,11,119,F,9,7,6,90,-29,Severe
8,4,100,F,15,16,0,192,92,Well
17,10,214,F,11,10,0,120,-94,Severe
8,8,104,F,11,10,0,120,16,Well
17,8,212,F,14,14,0,168,-44,Severe
14,4,172,F,11,10,0,120,-52,Severe
10,4,124,M,7,6,6,78,-46,Severe
10,8,128,F,7,6,6,78,-50,Severe
15,6,186,M,7,6,6,78,-108,Severe
7,3,87,F,8,7,0,84,-3,Mild
16,9,201,M,15,16,0,192,-9,Severe
18,0,216,F,8,7,0,84,-132,Severe
11,1,133,M,11,10,0,120,-13,Severe
5,0,60,M,6,6,6,78,18,Well
16,10,202,M,14,14,0,168,-34,Severe
14,2,170,M,8,7,0,84,-86,Severe
13,11,167,F,6,6,6,78,-89,Severe
5,5,65,F,11,10,0,120,55,Well
11,11,143,F,9,7,6,90,-53,Severe
14,4,172,F,14,14,0,168,-4,Mild
5,4,64,M,10,8,6,102,38,Well
15,5,185,F,11,10,0,120,-65,Severe
18,3,219,F,13,12,6,150,-69,Severe
16,0,192,F,8,7,0,84,-108,Severe
7,11,95,F,7,6,6,78,-17,Severe
13,7,163,M,10,8,6,102,-61,Severe
9,11,119,F,15,16,0,192,73,Well
10,7,127,M,8,7,0,84,-43,Severe
10,4,124,M,9,7,6,90,-34,Severe
8,11,107,F,9,7,6,90,-17,Severe
6,6,78,F,14,14,0,168,90,Well
14,0,168,F,11,10,0,120,-48,Severe
11,6,138,M,7,6,6,78,-60,Severe
17,8,212,M,10,8,6,102,-110,Severe
11,11,143,F,8,7,0,84,-59,Severe
10,11,131,M,15,16,0,192,61,Well
16,0,192,M,8,7,0,84,-108,Severe
10,2,122,M,14,14,0,168,46,Well
6,1,73,F,14,14,0,168,95,Well
12,5,149,F,13,12,6,150,1,Good
5,7,67,M,13,12,6,150,83,Well
7,7,91,M,9,7,6,90,-1,Mild
18,7,223,F,12,11,6,138,-85,Severe
14,1,169,F,7,6,6,78,-91,Severe
8,0,96,F,13,12,6,150,54,Well
16,7,199,M,11,10,0,120,-79,Severe
16,1,193,M,10,8,6,102,-91,Severe
11,6,138,M,10,8,6,102,-36,Severe
14,9,177,M,15,16,0,192,15,Well
14,10,178,F,6,6,6,78,-100,Severe
11,8,140,F,11,10,0,120,-20,Severe
9,4,112,M,6,6,6,78,-34,Severe
9,0,108,M,7,6,6,78,-30,Severe
15,7,187,F,9,7,6,90,-97,Severe
11,8,140,F,9,7,6,90,-50,Severe
5,1,61,M,13,12,6,150,89,Well
16,10,202,M,7,6,6,78,-124,Severe
8,8,104,F,6,6,6,78,-26,Severe
14,6,174,F,14,14,0,168,-6,Severe
8,4,100,M,10,8,6,102,2,Good
5,4,64,F,12,11,6,138,74,Well
12,1,145,F,14,14,0,168,23,Well
16,9,201,F,15,16,0,192,-9,Severe
15,5,185,M,12,11,6,138,-47,Severe
16,0,192,F,15,16,0,192,0,Neutral
18,7,223,M,12,11,6,138,-85,Severe
10,2,122,F,6,6,6,78,-44,Severe
11,5,137,M,7,6,6,78,-59,Severe
17,11,215,M,10,8,6,102,-113,Severe
17,5,209,M,10,8,6,102,-107,Severe
7,10,94,F,6,6,6,78,-16,Severe
8,8,104,M,9,7,6,90,-14,Severe
12,7,151,F,11,10,0,120,-31,Severe
7,11,95,F,13,12,6,150,55,Well
10,2,122,M,6,6,6,78,-44,Severe
13,2,158,M,10,8,6,102,-56,Severe
13,1,157,M,14,14,0,168,11,Well
16,3,195,M,15,16,0,192,-3,Mild
18,7,223,M,9,7,6,90,-133,Severe
12,11,155,M,7,6,6,78,-77,Severe
13,9,165,F,12,11,6,138,-27,Severe
16,4,196,M,7,6,6,78,-118,Severe
14,9,177,F,9,7,6,90,-87,Severe
8,7,103,M,9,7,6,90,-13,Severe
5,10,70,M,11,10,0,120,50,Well
16,8,200,M,12,11,6,138,-62,Severe
12,3,147,F,6,6,6,78,-69,Severe
16,1,193,F,13,12,6,150,-43,Severe
9,8,116,M,6,6,6,78,-38,Severe
10,8,128,F,12,11,6,138,10,Well
10,0,120,M,8,7,0,84,-36,Severe
18,10,226,M,8,7,0,84,-142,Severe
5,9,69,F,8,7,0,84,15,Well
11,3,135,F,7,6,6,78,-57,Severe
12,5,149,M,15,16,0,192,43,Well
10,1,121,F,12,11,6,138,17,Well
17,6,210,M,14,14,0,168,-42,Severe
6,10,82,F,7,6,6,78,-4,Mild
17,5,209,F,12,11,6,138,-71,Severe
11,3,135,F,10,8,6,102,-33,Severe
7,4,88,M,11,10,0,120,32,Well
9,0,108,F,10,8,6,102,-6,Severe
12,8,152,M,13,12,6,150,-2,Mild
17,1,205,F,8,7,0,84,-121,Severe
18,4,220,F,9,7,6,90,-130,Severe
18,8,224,F,7,6,6,78,-146,Severe
7,0,84,M,11,10,0,120,36,Well
15,2,182,F,14,14,0,168,-14,Severe
7,5,89,F,8,7,0,84,-5,Mild
9,1,109,F,7,6,6,78,-31,Severe
17,9,213,M,9,7,6,90,-123,Severe
18,2,218,M,8,7,0,84,-134,Severe
9,3,111,M,15,16,0,192,81,Well
18,5,221,M,14,14,0,168,-53,Severe
8,2,98,F,7,6,6,78,-20,Severe
8,11,107,F,15,16,0,192,85,Well
13,3,159,F,13,12,6,150,-9,Severe
16,11,203,M,8,7,0,84,-119,Severe
17,4,208,F,14,14,0,168,-40,Severe
5,2,62,M,8,7,0,84,22,Well
6,6,78,M,15,16,0,192,114,Well
7,5,89,F,13,12,6,150,61,Well
9,7,115,F,14,14,0,168,53,Well
8,4,100,F,13,12,6,150,50,Well
9,0,108,M,13,12,6,150,42,Well
12,4,148,M,9,7,6,90,-58,Severe
16,4,196,F,7,6,6,78,-118,Severe
5,11,71,F,10,8,6,102,31,Well
6,4,76,F,10,8,6,102,26,Well
13,3,159,M,9,7,6,90,-69,Severe
17,0,204,M,8,7,0,84,-120,Severe
11,9,141,M,10,8,6,102,-39,Severe
6,0,72,F,8,7,0,84,12,Well
9,2,110,M,8,7,0,84,-26,Severe
8,0,96,F,11,10,0,120,24,Well
6,0,72,M,6,6,6,78,6,Well
7,0,84,M,12,11,6,138,54,Well
13,0,156,F,13,12,6,150,-6,Severe
14,9,177,F,11,10,0,120,-57,Severe
17,7,211,M,6,6,6,78,-133,Severe
7,6,90,M,9,7,6,90,0,Neutral
15,8,188,F,6,6,6,78,-110,Severe
8,5,101,M,11,10,0,120,19,Well
8,2,98,M,9,7,6,90,-8,Severe
16,9,201,M,12,11,6,138,-63,Severe
5,5,65,F,9,7,6,90,25,Well
10,11,131,F,7,6,6,78,-53,Severe
5,4,64,M,9,7,6,90,26,Well
8,8,104,M,14,14,0,168,64,Well
9,8,116,M,14,14,0,168,52,Well
13,11,167,F,12,11,6,138,-29,Severe
15,11,191,M,14,14,0,168,-23,Severe
7,11,95,F,8,7,0,84,-11,Severe
5,11,71,M,6,6,6,78,7,Well
12,4,148,F,12,11,6,138,-10,Severe
7,10,94,F,15,16,0,192,98,Well
16,6,198,F,15,16,0,192,-6,Severe
15,6,186,F,10,8,6,102,-84,Severe
17,11,215,F,9,7,6,90,-125,Severe
6,2,74,M,10,8,6,102,28,Well
11,5,137,F,11,10,0,120,-17,Severe
18,2,218,F,8,7,0,84,-134,Severe
9,0,108,M,6,6,6,78,-30,Severe
18,0,216,F,10,8,6,102,-114,Severe
16,8,200,F,15,16,0,192,-8,Severe
16,2,194,M,10,8,6,102,-92,Severe
12,5,149,M,10,8,6,102,-47,Severe
17,3,207,F,9,7,6,90,-117,Severe
17,9,213,M,13,12,6,150,-63,Severe
8,4,100,F,11,10,0,120,20,Well
11,5,137,M,8,7,0,84,-53,Severe
14,3,171,F,11,10,0,120,-51,Severe
9,1,109,M,7,6,6,78,-31,Severe
11,10,142,M,10,8,6,102,-40,Severe
10,5,125,F,15,16,0,192,67,Well
6,6,78,F,13,12,6,150,72,Well
10,5,125,F,9,7,6,90,-35,Severe
15,4,184,M,7,6,6,78,-106,Severe
13,4,160,M,15,16,0,192,32,Well
8,10,106,M,7,6,6,78,-28,Severe
9,3,111,F,11,10,0,120,9,Well
7,6,90,M,12,11,6,138,48,Well
12,9,153,F,13,12,6,150,-3,Mild
7,3,87,F,13,12,6,150,63,Well
16,5,197,F,9,7,6,90,-107,Severe
12,6,150,F,8,7,0,84,-66,Severe
15,6,186,F,6,6,6,78,-108,Severe
8,4,100,F,8,7,0,84,-16,Severe
5,11,71,F,14,14,0,168,97,Well
16,9,201,F,7,6,6,78,-123,Severe
5,6,66,F,15,16,0,192,126,Well
6,6,78,M,12,11,6,138,60,Well
17,4,208,M,9,7,6,90,-118,Severe
10,11,131,F,15,16,0,192,61,Well
6,11,83,M,8,7,0,84,1,Good
8,5,101,F,7,6,6,78,-23,Severe
7,2,86,M,11,10,0,120,34,Well
12,5,149,M,13,12,6,150,1,Good
16,8,200,F,8,7,0,84,-116,Severe
10,6,126,F,13,12,6,150,24,Well
15,7,187,M,7,6,6,78,-109,Severe
15,3,183,M,13,12,6,150,-33,Severe
12,4,148,F,8,7,0,84,-64,Severe
13,1,157,M,8,7,0,84,-73,Severe
18,10,226,F,14,14,0,168,-58,Severe
8,3,99,M,10,8,6,102,3,Good
12,6,150,M,8,7,0,84,-66,Severe
17,5,209,F,7,6,6,78,-131,Severe
12,8,152,F,13,12,6,150,-2,Mild
13,10,166,F,11,10,0,120,-46,Severe
14,5,173,M,9,7,6,90,-83,Severe
6,7,79,M,10,8,6,102,23,Well
17,5,209,F,13,12,6,150,-59,Severe
14,5,173,F,15,16,0,192,19,Well
18,5,221,F,6,6,6,78,-143,Severe
5,4,64,M,13,12,6,150,86,Well
13,11,167,F,10,8,6,102,-65,Severe
14,3,171,F,9,7,6,90,-81,Severe
18,6,222,F,14,14,0,168,-54,Severe
15,11,191,M,7,6,6,78,-113,Severe
6,5,77,F,11,10,0,120,43,Well
17,11,215,F,7,6,6,78,-137,Severe
12,9,153,F,10,8,6,102,-51,Severe
15,10,190,M,11,10,0,120,-70,Severe
13,4,160,F,15,16,0,192,32,Well
10,10,130,M,8,7,0,84,-46,Severe
16,10,202,F,11,10,0,120,-82,Severe
10,9,129,F,15,16,0,192,63,Well
8,1,97,M,10,8,6,102,5,Good
13,0,156,F,10,8,6,102,-54,Severe
15,1,181,F,13,12,6,150,-31,Severe
7,10,94,M,9,7,6,90,-4,Mild
6,9,81,M,15,16,0,192,111,Well
8,4,100,F,6,6,6,78,-22,Severe
18,0,216,M,10,8,6,102,-114,Severe
6,3,75,F,15,16,0,192,117,Well
13,1,157,M,7,6,6,78,-79,Severe
8,9,105,M,11,10,0,120,15,Well
7,5,89,M,11,10,0,120,31,Well
18,2,218,M,14,14,0,168,-50,Severe
14,2,170,F,14,14,0,168,-2,Mild
12,2,146,F,15,16,0,192,46,Well
16,6,198,F,11,10,0,120,-78,Severe
18,1,217,F,13,12,6,150,-67,Severe
7,0,84,M,9,7,6,90,6,Well
5,11,71,F,12,11,6,138,67,Well
12,11,155,F,9,7,6,90,-65,Severe
17,7,211,F,9,7,6,90,-121,Severe
6,3,75,M,14,14,0,168,93,Well
7,3,87,F,7,6,6,78,-9,Severe
7,4,88,M,15,16,0,192,104,Well
10,6,126,F,14,14,0,168,42,Well
5,6,66,F,13,12,6,150,84,Well
18,3,219,F,12,11,6,138,-81,Severe
14,7,175,M,7,6,6,78,-97,Severe
9,5,113,M,12,11,6,138,25,Well
16,11,203,F,15,16,0,192,-11,Severe
7,4,88,M,14,14,0,168,80,Well
12,7,151,M,12,11,6,138,-13,Severe
12,6,150,M,6,6,6,78,-72,Severe
16,6,198,M,13,12,6,150,-48,Severe
17,3,207,F,12,11,6,138,-69,Severe
18,6,222,M,10,8,6,102,-120,Severe
13,2,158,F,11,10,0,120,-38,Severe
5,5,65,M,8,7,0,84,19,Well
13,3,159,F,7,6,6,78,-81,Severe
9,11,119,F,6,6,6,78,-41,Severe
15,10,190,M,14,14,0,168,-22,Severe
18,3,219,F,8,7,0,84,-135,Severe
6,4,76,F,12,11,6,138,62,Well
5,10,70,F,11,10,0,120,50,Well
13,8,164,M,6,6,6,78,-86,Severe
5,10,70,F,9,7,6,90,20,Well
12,8,152,F,11,10,0,120,-32,Severe
8,1,97,M,6,6,6,78,-19,Severe
10,11,131,M,10,8,6,102,-29,Severe
13,11,167,F,9,7,6,90,-77,Severe
10,6,126,M,14,14,0,168,42,Well
12,5,149,F,14,14,0,168,19,Well
14,9,177,M,13,12,6,150,-27,Severe
11,10,142,F,14,14,0,168,26,Well
17,8,212,M,11,10,0,120,-92,Severe
15,4,184,M,11,10,0,120,-64,Severe
6,7,79,F,15,16,0,192,113,Well
17,4,208,F,13,12,6,150,-58,Severe
16,7,199,F,7,6,6,78,-121,Severe
18,0,216,F,13,12,6,150,-66,Severe
7,11,95,M,7,6,6,78,-17,Severe
14,6,174,M,8,7,0,84,-90,Severe
15,2,182,M,7,6,6,78,-104,Severe
11,1,133,M,15,16,0,192,59,Well
16,1,193,F,12,11,6,138,-55,Severe
13,5,161,F,12,11,6,138,-23,Severe
5,1,61,M,9,7,6,90,29,Well
8,0,96,M,9,7,6,90,-6,Severe
9,2,110,F,9,7,6,90,-20,Severe
15,6,186,M,8,7,0,84,-102,Severe
14,11,179,M,15,16,0,192,13,Well
14,4,172,M,12,11,6,138,-34,Severe
14,9,177,M,7,6,6,78,-99,Severe
18,2,218,F,12,11,6,138,-80,Severe
11,0,132,M,11,10,0,120,-12,Severe
11,11,143,F,10,8,6,102,-41,Severe
6,6,78,M,8,7,0,84,6,Well
5,0,60,M,9,7,6,90,30,Well
11,9,141,F,6,6,6,78,-63,Severe
8,3,99,F,13,12,6,150,51,Well
5,4,64,M,6,6,6,78,14,Well
13,8,164,F,11,10,0,120,-44,Severe
9,8,116,F,6,6,6,78,-38,Severe
12,1,145,F,12,11,6,138,-7,Severe
12,3,147,M,11,10,0,120,-27,Severe
10,9,129,F,10,8,6,102,-27,Severe
6,8,80,M,9,7,6,90,10,Well
17,2,206,F,6,6,6,78,-128,Severe
12,1,145,M,12,11,6,138,-7,Severe
6,9,81,M,6,6,6,78,-3,Mild
14,0,168,M,8,7,0,84,-84,Severe
11,10,142,F,13,12,6,150,8,Well
13,4,160,M,10,8,6,102,-58,Severe
5,4,64,M,7,6,6,78,14,Well
8,7,103,F,10,8,6,102,-1,Mild
9,10,118,F,7,6,6,78,-40,Severe
5,4,64,F,15,16,0,192,128,Well
18,10,226,F,10,8,6,102,-124,Severe
8,9,105,F,8,7,0,84,-21,Severe
11,4,136,M,8,7,0,84,-52,Severe
14,10,178,M,15,16,0,192,14,Well
11,9,141,M,9,7,6,90,-51,Severe
18,3,219,F,6,6,6,78,-141,Severe
5,3,63,F,8,7,0,84,21,Well
11,2,134,M,11,10,0,120,-14,Severe
8,6,102,M,8,7,0,84,-18,Severe
8,1,97,F,8,7,0,84,-13,Severe
11,11,143,F,12,11,6,138,-5,Mild
14,3,171,F,12,11,6,138,-33,Severe
15,8,188,M,15,16,0,192,4,Good
18,2,218,F,13,12,6,150,-68,Severe
16,5,197,F,14,14,0,168,-29,Severe
14,10,178,F,15,16,0,192,14,Well
9,3,111,F,9,7,6,90,-21,Severe
12,1,145,F,7,6,6,78,-67,Severe
5,2,62,M,15,16,0,192,130,Well
17,7,211,M,8,7,0,84,-127,Severe
11,5,137,F,7,6,6,78,-59,Severe
15,1,181,F,8,7,0,84,-97,Severe
5,11,71,F,9,7,6,90,19,Well
15,2,182,F,15,16,0,192,10,Well
8,4,100,F,12,11,6,138,38,Well
11,4,136,M,10,8,6,102,-34,Severe
11,9,141,F,13,12,6,150,9,Well
6,8,80,F,7,6,6,78,-2,Mild
7,0,84,F,6,6,6,78,-6,Severe
10,0,120,F,13,12,6,150,30,Well
9,5,113,F,15,16,0,192,79,Well
14,2,170,M,15,16,0,192,22,Well
16,5,197,F,15,16,0,192,-5,Mild
17,3,207,M,13,12,6,150,-57,Severe
12,2,146,M,14,14,0,168,22,Well
5,10,70,M,6,6,6,78,8,Well
10,3,123,M,7,6,6,78,-45,Severe
9,4,112,F,15,16,0,192,80,Well
14,8,176,F,8,7,0,84,-92,Severe
14,0,168,M,6,6,6,78,-90,Severe
11,8,140,M,10,8,6,102,-38,Severe
16,8,200,M,10,8,6,102,-98,Severe
10,4,124,F,7,6,6,78,-46,Severe
7,0,84,M,7,6,6,78,-6,Severe
17,0,204,F,14,14,0,168,-36,Severe
6,0,72,M,8,7,0,84,12,Well
16,9,201,M,11,10,0,120,-81,Severe
7,7,91,F,10,8,6,102,11,Well
18,7,223,F,13,12,6,150,-73,Severe
6,11,83,M,12,11,6,138,55,Well
11,10,142,F,10,8,6,102,-40,Severe
17,3,207,F,8,7,0,84,-123,Severe
14,5,173,F,13,12,6,150,-23,Severe
6,2,74,M,15,16,0,192,118,Well
14,0,168,F,8,7,0,84,-84,Severe
9,7,115,M,9,7,6,90,-25,Severe
15,9,189,M,7,6,6,78,-111,Severe
9,9,117,M,10,8,6,102,-15,Severe
9,7,115,F,9,7,6,90,-25,Severe
18,0,216,M,9,7,6,90,-126,Severe
10,3,123,M,8,7,0,84,-39,Severe
9,3,111,M,8,7,0,84,-27,Severe
16,10,202,F,10,8,6,102,-100,Severe
11,10,142,F,12,11,6,138,-4,Mild
7,8,92,F,7,6,6,78,-14,Severe
5,3,63,F,7,6,6,78,15,Well
8,1,97,F,15,16,0,192,95,Well
11,2,134,M,12,11,6,138,4,Good
6,6,78,F,7,6,6,78,0,Neutral
14,10,178,M,8,7,0,84,-94,Severe
7,7,91,F,15,16,0,192,101,Well
11,8,140,M,11,10,0,120,-20,Severe
14,5,173,F,11,10,0,120,-53,Severe
6,11,83,M,9,7,6,90,7,Well
9,11,119,M,12,11,6,138,19,Well
5,10,70,M,12,11,6,138,68,Well
13,4,160,F,9,7,6,90,-70,Severe
17,10,214,M,13,12,6,150,-64,Severe
11,3,135,M,7,6,6,78,-57,Severe
18,6,222,M,6,6,6,78,-144,Severe
12,2,146,F,13,12,6,150,4,Good
14,5,173,F,10,8,6,102,-71,Severe
12,9,153,F,8,7,0,84,-69,Severe
9,3,111,F,15,16,0,192,81,Well
15,9,189,F,13,12,6,150,-39,Severe
10,6,126,M,9,7,6,90,-36,Severe
10,1,121,F,6,6,6,78,-43,Severe
11,2,134,M,15,16,0,192,58,Well
18,3,219,F,15,16,0,192,-27,Severe
8,7,103,F,9,7,6,90,-13,Severe
5,11,71,F,13,12,6,150,79,Well
17,7,211,F,15,16,0,192,-19,Severe
12,11,155,F,8,7,0,84,-71,Severe
10,9,129,F,7,6,6,78,-51,Severe
7,9,93,M,12,11,6,138,45,Well
17,0,204,F,6,6,6,78,-126,Severe
10,4,124,M,11,10,0,120,-4,Mild
15,0,180,F,14,14,0,168,-12,Severe
6,7,79,M,8,7,0,84,5,Good
14,5,173,F,14,14,0,168,-5,Mild
18,2,218,M,11,10,0,120,-98,Severe
14,4,172,M,6,6,6,78,-94,Severe
9,6,114,F,8,7,0,84,-30,Severe
11,4,136,M,7,6,6,78,-58,Severe
10,8,128,M,7,6,6,78,-50,Severe
6,3,75,F,10,8,6,102,27,Well
14,0,168,M,11,10,0,120,-48,Severe
12,0,144,M,8,7,0,84,-60,Severe
8,8,104,F,8,7,0,84,-20,Severe
11,6,138,F,6,6,6,78,-60,Severe
14,11,179,F,11,10,0,120,-59,Severe
12,5,149,F,15,16,0,192,43,Well
16,8,200,F,7,6,6,78,-122,Severe
10,6,126,F,6,6,6,78,-48,Severe
13,8,164,F,12,11,6,138,-26,Severe
13,1,157,M,11,10,0,120,-37,Severe
5,6,66,M,6,6,6,78,12,Well
10,7,127,M,11,10,0,120,-7,Severe
16,0,192,F,12,11,6,138,-54,Severe
18,0,216,F,6,6,6,78,-138,Severe
10,5,125,M,12,11,6,138,13,Well
7,10,94,M,7,6,6,78,-16,Severe
10,10,130,M,9,7,6,90,-40,Severe
18,10,226,M,7,6,6,78,-148,Severe
17,8,212,M,6,6,6,78,-134,Severe
13,5,161,M,11,10,0,120,-41,Severe
9,1,109,M,9,7,6,90,-19,Severe
18,3,219,F,7,6,6,78,-141,Severe
16,9,201,F,9,7,6,90,-111,Severe
6,2,74,M,14,14,0,168,94,Well
11,7,139,M,14,14,0,168,29,Well
15,8,188,M,6,6,6,78,-110,Severe
17,11,215,M,14,14,0,168,-47,Severe
11,8,140,M,12,11,6,138,-2,Mild
9,6,114,F,10,8,6,102,-12,Severe
8,2,98,M,6,6,6,78,-20,Severe
16,11,203,M,6,6,6,78,-125,Severe
11,0,132,F,12,11,6,138,6,Well
13,7,163,F,9,7,6,90,-73,Severe
16,9,201,M,13,12,6,150,-51,Severe
5,3,63,M,10,8,6,102,39,Well
14,9,177,F,8,7,0,84,-93,Severe
9,3,111,F,7,6,6,78,-33,Severe
17,8,212,F,11,10,0,120,-92,Severe
16,4,196,M,9,7,6,90,-106,Severe
10,0,120,F,11,10,0,120,0,Neutral
12,8,152,M,12,11,6,138,-14,Severe
9,0,108,F,6,6,6,78,-30,Severe
18,10,226,M,15,16,0,192,-34,Severe
11,0,132,F,7,6,6,78,-54,Severe
14,3,171,M,6,6,6,78,-93,Severe
15,9,189,F,15,16,0,192,3,Good
14,2,170,F,13,12,6,150,-20,Severe
11,10,142,M,8,7,0,84,-58,Severe
14,3,171,F,10,8,6,102,-69,Severe
15,6,186,F,13,12,6,150,-36,Severe
10,6,126,M,8,7,0,84,-42,Severe
5,5,65,M,6,6,6,78,13,Well
9,0,108,M,11,10,0,120,12,Well
5,3,63,M,8,7,0,84,21,Well
18,11,227,M,11,10,0,120,-107,Severe
7,5,89,M,13,12,6,150,61,Well
5,5,65,M,10,8,6,102,37,Well
7,7,91,F,6,6,6,78,-13,Severe
14,3,171,F,13,12,6,150,-21,Severe
10,7,127,F,15,16,0,192,65,Well
18,0,216,F,14,14,0,168,-48,Severe
7,0,84,F,11,10,0,120,36,Well
12,10,154,M,11,10,0,120,-34,Severe
7,0,84,M,10,8,6,102,18,Well
18,1,217,F,10,8,6,102,-115,Severe
9,4,112,F,13,12,6,150,38,Well
6,3,75,M,8,7,0,84,9,Well
7,4,88,M,13,12,6,150,62,Well
17,0,204,F,9,7,6,90,-114,Severe
8,5,101,M,6,6,6,78,-23,Severe
17,7,211,M,7,6,6,78,-133,Severe
13,0,156,M,6,6,6,78,-78,Severe
17,11,215,F,6,6,6,78,-137,Severe
13,10,166,M,7,6,6,78,-88,Severe
14,5,173,M,7,6,6,78,-95,Severe
11,1,133,M,12,11,6,138,5,Good
5,5,65,M,13,12,6,150,85,Well
13,6,162,F,10,8,6,102,-60,Severe
12,2,146,F,11,10,0,120,-26,Severe
6,9,81,F,15,16,0,192,111,Well
6,11,83,M,10,8,6,102,19,Well
8,3,99,F,10,8,6,102,3,Good
18,10,226,F,15,16,0,192,-34,Severe
12,6,150,M,9,7,6,90,-60,Severe
7,4,88,M,12,11,6,138,50,Well
18,3,219,F,9,7,6,90,-129,Severe
11,6,138,M,11,10,0,120,-18,Severe
15,11,191,F,9,7,6,90,-101,Severe
7,5,89,F,9,7,6,90,1,Good
10,3,123,F,8,7,0,84,-39,Severe
13,6,162,F,8,7,0,84,-78,Severe
7,2,86,F,10,8,6,102,16,Well
5,0,60,F,11,10,0,120,60,Well
18,4,220,F,8,7,0,84,-136,Severe
18,4,220,M,11,10,0,120,-100,Severe
5,11,71,M,13,12,6,150,79,Well
7,5,89,F,11,10,0,120,31,Well
12,7,151,F,6,6,6,78,-73,Severe
10,2,122,F,15,16,0,192,70,Well
7,1,85,M,10,8,6,102,17,Well
17,11,215,F,11,10,0,120,-95,Severe
16,1,193,M,12,11,6,138,-55,Severe
9,8,116,M,7,6,6,78,-38,Severe
18,9,225,M,11,10,0,120,-105,Severe
15,5,185,M,10,8,6,102,-83,Severe
6,4,76,M,8,7,0,84,8,Well
10,0,120,F,7,6,6,78,-42,Severe
17,3,207,M,6,6,6,78,-129,Severe
9,2,110,F,8,7,0,84,-26,Severe
13,3,159,F,8,7,0,84,-75,Severe
14,4,172,M,11,10,0,120,-52,Severe
6,2,74,F,12,11,6,138,64,Well
13,0,156,M,9,7,6,90,-66,Severe
15,2,182,F,11,10,0,120,-62,Severe
13,8,164,M,15,16,0,192,28,Well
7,10,94,M,8,7,0,84,-10,Severe
10,5,125,M,15,16,0,192,67,Well
7,3,87,M,8,7,0,84,-3,Mild
14,11,179,M,14,14,0,168,-11,Severe
10,5,125,F,10,8,6,102,-23,Severe
7,2,86,M,15,16,0,192,106,Well
7,11,95,M,14,14,0,168,73,Well
14,3,171,F,6,6,6,78,-93,Severe
6,8,80,M,12,11,6,138,58,Well
6,4,76,M,14,14,0,168,92,Well
9,8,116,M,15,16,0,192,76,Well
14,11,179,M,10,8,6,102,-77,Severe
6,9,81,M,8,7,0,84,3,Good
17,10,214,M,12,11,6,138,-76,Severe
8,6,102,M,11,10,0,120,18,Well
10,9,129,F,9,7,6,90,-39,Severe
9,3,111,M,12,11,6,138,27,Well
5,2,62,M,7,6,6,78,16,Well
14,7,175,F,10,8,6,102,-73,Severe
8,1,97,F,13,12,6,150,53,Well
8,2,98,F,14,14,0,168,70,Well
17,3,207,F,10,8,6,102,-105,Severe
7,9,93,M,14,14,0,168,75,Well
13,0,156,F,9,7,6,90,-66,Severe
13,10,166,F,7,6,6,78,-88,Severe
7,0,84,F,7,6,6,78,-6,Severe
17,6,210,F,7,6,6,78,-132,Severe
5,8,68,F,11,10,0,120,52,Well
10,8,128,M,15,16,0,192,64,Well
15,10,190,M,9,7,6,90,-100,Severe
11,8,140,F,6,6,6,78,-62,Severe
18,6,222,M,9,7,6,90,-132,Severe
16,2,194,F,10,8,6,102,-92,Severe
14,7,175,F,6,6,6,78,-97,Severe
5,8,68,M,9,7,6,90,22,Well
13,6,162,M,15,16,0,192,30,Well
16,9,201,F,12,11,6,138,-63,Severe
5,0,60,F,10,8,6,102,42,Well
13,4,160,M,13,12,6,150,-10,Severe
16,4,196,F,15,16,0,192,-4,Mild
17,1,205,F,11,10,0,120,-85,Severe
14,8,176,M,12,11,6,138,-38,Severe
8,11,107,F,7,6,6,78,-29,Severe
14,0,168,F,10,8,6,102,-66,Severe
9,10,118,M,15,16,0,192,74,Well
10,6,126,M,6,6,6,78,-48,Severe
13,11,167,M,14,14,0,168,1,Good
17,6,210,F,9,7,6,90,-120,Severe
18,8,224,M,12,11,6,138,-86,Severe
10,3,123,F,11,10,0,120,-3,Mild
5,11,71,F,6,6,6,78,7,Well
7,6,90,M,7,6,6,78,-12,Severe
15,4,184,F,9,7,6,90,-94,Severe
15,7,187,M,15,16,0,192,5,Good
16,10,202,M,12,11,6,138,-64,Severe
18,1,217,F,14,14,0,168,-49,Severe
6,9,81,M,9,7,6,90,9,Well
16,8,200,M,15,16,0,192,-8,Severe
13,9,165,F,11,10,0,120,-45,Severe
16,11,203,M,12,11,6,138,-65,Severe
9,11,119,M,13,12,6,150,31,Well
18,0,216,M,7,6,6,78,-138,Severe
7,10,94,M,13,12,6,150,56,Well
17,10,214,F,6,6,6,78,-136,Severe
17,7,211,F,14,14,0,168,-43,Severe
14,11,179,F,7,6,6,78,-101,Severe
10,2,122,M,13,12,6,150,28,Well
12,10,154,M,13,12,6,150,-4,Mild
6,11,83,F,14,14,0,168,85,Well
14,3,171,M,9,7,6,90,-81,Severe
16,6,198,F,12,11,6,138,-60,Severe
14,0,168,F,6,6,6,78,-90,Severe
8,3,99,M,14,14,0,168,69,Well
5,11,71,M,9,7,6,90,19,Well
14,7,175,M,14,14,0,168,-7,Severe
5,3,63,M,15,16,0,192,129,Well
12,10,154,F,8,7,0,84,-70,Severe
8,10,106,M,14,14,0,168,62,Well
5,0,60,M,14,14,0,168,108,Well
7,3,87,M,6,6,6,78,-9,Severe
17,5,209,M,15,16,0,192,-17,Severe
11,6,138,M,13,12,6,150,12,Well
14,1,169,M,7,6,6,78,-91,Severe
13,0,156,M,8,7,0,84,-72,Severe
8,11,107,M,15,16,0,192,85,Well
7,1,85,F,8,7,0,84,-1,Mild
18,11,227,M,6,6,6,78,-149,Severe
14,0,168,F,9,7,6,90,-78,Severe
12,10,154,M,12,11,6,138,-16,Severe
18,2,218,F,10,8,6,102,-116,Severe
13,9,165,M,9,7,6,90,-75,Severe
10,9,129,M,14,14,0,168,39,Well
7,4,88,F,7,6,6,78,-10,Severe
9,6,114,F,13,12,6,150,36,Well
7,1,85,F,9,7,6,90,5,Good
15,0,180,F,8,7,0,84,-96,Severe
6,11,83,F,13,12,6,150,67,Well
14,5,173,M,14,14,0,168,-5,Mild
10,5,125,M,11,10,0,120,-5,Mild
18,5,221,F,15,16,0,192,-29,Severe
10,1,121,M,9,7,6,90,-31,Severe
10,1,121,F,15,16,0,192,71,Well
12,4,148,F,6,6,6,78,-70,Severe
17,5,209,F,11,10,0,120,-89,Severe
15,8,188,F,7,6,6,78,-110,Severe
7,11,95,F,9,7,6,90,-5,Mild
13,7,163,M,11,10,0,120,-43,Severe
6,0,72,F,7,6,6,78,6,Well
13,4,160,F,10,8,6,102,-58,Severe
5,9,69,M,6,6,6,78,9,Well
18,3,219,M,7,6,6,78,-141,Severe
13,6,162,F,9,7,6,90,-72,Severe
12,6,150,F,6,6,6,78,-72,Severe
17,1,205,M,13,12,6,150,-55,Severe
6,3,75,F,14,14,0,168,93,Well
9,8,116,M,8,7,0,84,-32,Severe
18,2,218,F,7,6,6,78,-140,Severe
18,3,219,M,12,11,6,138,-81,Severe
5,0,60,F,13,12,6,150,90,Well
12,8,152,M,10,8,6,102,-50,Severe
15,4,184,F,12,11,6,138,-46,Severe
18,3,219,F,10,8,6,102,-117,Severe
6,7,79,F,13,12,6,150,71,Well
18,0,216,F,15,16,0,192,-24,Severe
10,3,123,F,14,14,0,168,45,Well
9,3,111,F,6,6,6,78,-33,Severe
7,11,95,M,11,10,0,120,25,Well
12,11,155,M,11,10,0,120,-35,Severe
15,11,191,M,10,8,6,102,-89,Severe
11,6,138,M,15,16,0,192,54,Well
18,11,227,F,12,11,6,138,-89,Severe
13,0,156,M,14,14,0,168,12,Well
14,7,175,F,12,11,6,138,-37,Severe
10,5,125,M,14,14,0,168,43,Well
5,9,69,M,14,14,0,168,99,Well
5,8,68,M,12,11,6,138,70,Well
10,1,121,M,14,14,0,168,47,Well
15,7,187,F,6,6,6,78,-109,Severe
17,1,205,M,12,11,6,138,-67,Severe
12,0,144,F,6,6,6,78,-66,Severe
18,5,221,M,9,7,6,90,-131,Severe
13,4,160,F,8,7,0,84,-76,Severe
5,5,65,M,9,7,6,90,25,Well
9,5,113,M,13,12,6,150,37,Well
10,9,129,M,12,11,6,138,9,Well
8,1,97,M,13,12,6,150,53,Well
14,8,176,F,12,11,6,138,-38,Severe
10,5,125,F,12,11,6,138,13,Well
15,3,183,F,8,7,0,84,-99,Severe
16,2,194,F,9,7,6,90,-104,Severe
8,1,97,M,8,7,0,84,-13,Severe
7,2,86,F,14,14,0,168,82,Well
8,5,101,F,10,8,6,102,1,Good
13,5,161,F,11,10,0,120,-41,Severe
16,1,193,M,8,7,0,84,-109,Severe
10,0,120,M,9,7,6,90,-30,Severe
11,1,133,F,12,11,6,138,5,Good
16,1,193,F,10,8,6,102,-91,Severe
12,2,146,F,9,7,6,90,-56,Severe
18,1,217,M,15,16,0,192,-25,Severe
6,11,83,F,7,6,6,78,-5,Mild
7,7,91,F,9,7,6,90,-1,Mild
12,7,151,M,14,14,0,168,17,Well
17,2,206,M,8,7,0,84,-122,Severe
17,1,205,M,6,6,6,78,-127,Severe
17,1,205,F,14,14,0,168,-37,Severe
16,1,193,M,9,7,6,90,-103,Severe
10,8,128,F,14,14,0,168,40,Well
8,7,103,F,12,11,6,138,35,Well
11,2,134,M,13,12,6,150,16,Well
14,4,172,M,10,8,6,102,-70,Severe
17,4,208,F,9,7,6,90,-118,Severe
18,3,219,M,10,8,6,102,-117,Severe
17,7,211,F,8,7,0,84,-127,Severe
5,6,66,M,15,16,0,192,126,Well
16,4,196,F,9,7,6,90,-106,Severe
9,2,110,F,15,16,0,192,82,Well
7,1,85,F,14,14,0,168,83,Well
13,0,156,F,11,10,0,120,-36,Severe
5,5,65,F,12,11,6,138,73,Well
8,0,96,M,13,12,6,150,54,Well
6,1,73,M,12,11,6,138,65,Well
17,10,214,F,9,7,6,90,-124,Severe
12,1,145,M,8,7,0,84,-61,Severe
12,11,155,M,14,14,0,168,13,Well
16,8,200,F,14,14,0,168,-32,Severe
8,3,99,F,14,14,0,168,69,Well
15,4,184,M,12,11,6,138,-46,Severe
10,10,130,F,10,8,6,102,-28,Severe
11,8,140,M,14,14,0,168,28,Well
16,7,199,M,14,14,0,168,-31,Severe
7,3,87,F,9,7,6,90,3,Good
18,11,227,M,10,8,6,102,-125,Severe
18,6,222,M,12,11,6,138,-84,Severe
7,1,85,F,11,10,0,120,35,Well
16,2,194,F,12,11,6,138,-56,Severe
14,3,171,F,15,16,0,192,21,Well
17,6,210,F,13,12,6,150,-60,Severe
17,5,209,F,15,16,0,192,-17,Severe
16,4,196,F,11,10,0,120,-76,Severe
18,7,223,M,11,10,0,120,-103,Severe
17,0,204,M,6,6,6,78,-126,Severe
16,0,192,M,15,16,0,192,0,Neutral
5,8,68,F,14,14,0,168,100,Well
14,7,175,F,11,10,0,120,-55,Severe
8,3,99,M,7,6,6,78,-21,Severe
14,1,169,F,15,16,0,192,23,Well
10,10,130,M,15,16,0,192,62,Well
16,7,199,F,11,10,0,120,-79,Severe
15,8,188,F,8,7,0,84,-104,Severe
5,9,69,M,9,7,6,90,21,Well
17,9,213,M,12,11,6,138,-75,Severe
15,11,191,F,8,7,0,84,-107,Severe
8,8,104,M,8,7,0,84,-20,Severe
7,3,87,M,9,7,6,90,3,Good
10,4,124,M,13,12,6,150,26,Well
6,8,80,M,7,6,6,78,-2,Mild
17,8,212,M,14,14,0,168,-44,Severe
14,1,169,M,15,16,0,192,23,Well
8,4,100,F,14,14,0,168,68,Well
12,8,152,M,9,7,6,90,-62,Severe
17,8,212,F,15,16,0,192,-20,Severe
14,11,179,M,13,12,6,150,-29,Severe
6,1,73,M,15,16,0,192,119,Well
11,9,141,F,15,16,0,192,51,Well
18,1,217,M,6,6,6,78,-139,Severe
8,9,105,F,14,14,0,168,63,Well
16,7,199,F,9,7,6,90,-109,Severe
5,2,62,M,12,11,6,138,76,Well
5,10,70,F,7,6,6,78,8,Well
11,3,135,F,11,10,0,120,-15,Severe
11,4,136,M,14,14,0,168,32,Well
5,9,69,M,8,7,0,84,15,Well
13,5,161,M,8,7,0,84,-77,Severe
14,9,177,F,14,14,0,168,-9,Severe
13,0,156,M,12,11,6,138,-18,Severe
11,0,132,M,7,6,6,78,-54,Severe
11,1,133,M,8,7,0,84,-49,Severe
9,11,119,F,11,10,0,120,1,Good
16,3,195,F,6,6,6,78,-117,Severe
7,5,89,M,14,14,0,168,79,Well
16,4,196,M,6,6,6,78,-118,Severe
15,5,185,M,13,12,6,150,-35,Severe
5,6,66,F,8,7,0,84,18,Well
14,2,170,F,9,7,6,90,-80,Severe
12,9,153,M,10,8,6,102,-51,Severe
14,2,170,F,8,7,0,84,-86,Severe
14,10,178,F,13,12,6,150,-28,Severe
10,5,125,M,6,6,6,78,-47,Severe
14,6,174,M,7,6,6,78,-96,Severe
10,8,128,M,6,6,6,78,-50,Severe
12,8,152,F,6,6,6,78,-74,Severe
5,3,63,M,14,14,0,168,105,Well
15,1,181,F,10,8,6,102,-79,Severe
9,5,113,M,9,7,6,90,-23,Severe
14,8,176,F,9,7,6,90,-86,Severe
15,0,180,M,8,7,0,84,-96,Severe
12,2,146,F,7,6,6,78,-68,Severe
12,1,145,M,15,16,0,192,47,Well
15,2,182,F,6,6,6,78,-104,Severe
10,0,120,M,12,11,6,138,18,Well
13,6,162,M,9,7,6,90,-72,Severe
12,7,151,M,10,8,6,102,-49,Severe
12,1,145,F,8,7,0,84,-61,Severe
17,1,205,M,9,7,6,90,-115,Severe
7,7,91,M,8,7,0,84,-7,Severe
18,5,221,F,8,7,0,84,-137,Severe
12,9,153,M,14,14,0,168,15,Well
10,0,120,M,14,14,0,168,48,Well
16,5,197,M,10,8,6,102,-95,Severe
9,5,113,M,8,7,0,84,-29,Severe
12,3,147,F,8,7,0,84,-63,Severe
6,8,80,M,11,10,0,120,40,Well
9,6,114,F,6,6,6,78,-36,Severe
14,2,170,M,13,12,6,150,-20,Severe
6,9,81,M,12,11,6,138,57,Well
8,1,97,M,7,6,6,78,-19,Severe
8,10,106,M,12,11,6,138,32,Well
16,0,192,M,11,10,0,120,-72,Severe
6,10,82,F,10,8,6,102,20,Well
6,5,77,M,9,7,6,90,13,Well
6,1,73,F,15,16,0,192,119,Well
18,11,227,F,8,7,0,84,-143,Severe
8,7,103,F,14,14,0,168,65,Well
8,5,101,M,7,6,6,78,-23,Severe
10,1,121,M,7,6,6,78,-43,Severe
14,1,169,M,12,11,6,138,-31,Severe
13,2,158,M,7,6,6,78,-80,Severe
17,9,213,F,15,16,0,192,-21,Severe
15,3,183,M,10,8,6,102,-81,Severe
14,5,173,M,6,6,6,78,-95,Severe
10,5,125,M,8,7,0,84,-41,Severe
9,11,119,M,9,7,6,90,-29,Severe
18,9,225,F,10,8,6,102,-123,Severe
18,11,227,M,12,11,6,138,-89,Severe
7,3,87,F,6,6,6,78,-9,Severe
17,0,204,F,8,7,0,84,-120,Severe
10,9,129,M,10,8,6,102,-27,Severe
6,5,77,M,7,6,6,78,1,Good
12,6,150,M,15,16,0,192,42,Well
10,0,120,M,7,6,6,78,-42,Severe
13,3,159,M,13,12,6,150,-9,Severe
17,3,207,M,15,16,0,192,-15,Severe
11,11,143,M,6,6,6,78,-65,Severe
9,6,114,M,6,6,6,78,-36,Severe
9,11,119,F,7,6,6,78,-41,Severe
8,10,106,F,12,11,6,138,32,Well
7,8,92,M,9,7,6,90,-2,Mild
11,7,139,F,6,6,6,78,-61,Severe
7,11,95,M,6,6,6,78,-17,Severe
15,0,180,M,12,11,6,138,-42,Severe
10,1,121,F,10,8,6,102,-19,Severe
11,5,137,F,12,11,6,138,1,Good
13,7,163,M,15,16,0,192,29,Well
6,1,73,M,13,12,6,150,77,Well
12,9,153,M,12,11,6,138,-15,Severe
5,9,69,F,6,6,6,78,9,Well
11,11,143,M,13,12,6,150,7,Well
13,7,163,M,9,7,6,90,-73,Severe
17,1,205,F,12,11,6,138,-67,Severe
13,3,159,F,9,7,6,90,-69,Severe
18,11,227,F,11,10,0,120,-107,Severe
12,0,144,M,12,11,6,138,-6,Severe
7,8,92,F,13,12,6,150,58,Well
6,8,80,F,12,11,6,138,58,Well
10,4,124,F,8,7,0,84,-40,Severe
10,0,120,F,8,7,0,84,-36,Severe
16,5,197,M,12,11,6,138,-59,Severe
10,1,121,M,6,6,6,78,-43,Severe
17,0,204,M,10,8,6,102,-102,Severe
11,0,132,F,9,7,6,90,-42,Severe
11,7,139,F,10,8,6,102,-37,Severe
11,2,134,M,8,7,0,84,-50,Severe
16,11,203,M,9,7,6,90,-113,Severe
16,10,202,F,7,6,6,78,-124,Severe
6,5,77,M,10,8,6,102,25,Well
9,2,110,M,9,7,6,90,-20,Severe
13,2,158,M,14,14,0,168,10,Well
5,0,60,F,8,7,0,84,24,Well
6,1,73,M,10,8,6,102,29,Well
9,7,115,M,11,10,0,120,5,Good
6,7,79,F,7,6,6,78,-1,Mild
14,2,170,F,7,6,6,78,-92,Severe
12,5,149,F,11,10,0,120,-29,Severe
6,8,80,M,6,6,6,78,-2,Mild
8,9,105,M,8,7,0,84,-21,Severe
16,8,200,F,10,8,6,102,-98,Severe
12,0,144,F,12,11,6,138,-6,Severe
9,6,114,M,10,8,6,102,-12,Severe
16,2,194,F,11,10,0,120,-74,Severe
16,4,196,F,13,12,6,150,-46,Severe
16,9,201,F,6,6,6,78,-123,Severe
18,7,223,M,13,12,6,150,-73,Severe
15,1,181,M,8,7,0,84,-97,Severe
11,3,135,F,14,14,0,168,33,Well
17,0,204,M,9,7,6,90,-114,Severe
14,5,173,F,7,6,6,78,-95,Severe
6,1,73,M,14,14,0,168,95,Well
7,4,88,M,7,6,6,78,-10,Severe
15,3,183,M,7,6,6,78,-105,Severe
13,10,166,F,10,8,6,102,-64,Severe
17,9,213,M,6,6,6,78,-135,Severe
8,3,99,F,6,6,6,78,-21,Severe
9,6,114,M,9,7,6,90,-24,Severe
15,3,183,M,15,16,0,192,9,Well
6,2,74,F,13,12,6,150,76,Well
18,10,226,M,10,8,6,102,-124,Severe
16,9,201,F,10,8,6,102,-99,Severe
11,8,140,F,7,6,6,78,-62,Severe
5,0,60,F,9,7,6,90,30,Well
16,10,202,F,14,14,0,168,-34,Severe
16,5,197,F,7,6,6,78,-119,Severe
6,5,77,F,9,7,6,90,13,Well
17,1,205,M,11,10,0,120,-85,Severe
16,1,193,M,7,6,6,78,-115,Severe
11,7,139,F,14,14,0,168,29,Well
5,6,66,F,6,6,6,78,12,Well
8,8,104,F,12,11,6,138,34,Well
18,5,221,M,13,12,6,150,-71,Severe
12,9,153,F,14,14,0,168,15,Well
15,9,189,F,6,6,6,78,-111,Severe
5,3,63,F,15,16,0,192,129,Well
14,2,170,F,11,10,0,120,-50,Severe
11,7,139,F,11,10,0,120,-19,Severe
8,10,106,M,13,12,6,150,44,Well
8,8,104,M,6,6,6,78,-26,Severe
8,5,101,F,12,11,6,138,37,Well
6,5,77,F,13,12,6,150,73,Well
17,2,206,F,12,11,6,138,-68,Severe
10,0,120,M,11,10,0,120,0,Neutral
14,11,179,M,8,7,0,84,-95,Severe
5,10,70,M,8,7,0,84,14,Well
7,11,95,M,10,8,6,102,7,Well
17,6,210,M,12,11,6,138,-72,Severe
7,7,91,F,11,10,0,120,29,Well
17,6,210,F,10,8,6,102,-108,Severe
6,3,75,M,7,6,6,78,3,Good
12,4,148,M,7,6,6,78,-70,Severe
10,11,131,M,12,11,6,138,7,Well
18,7,223,F,15,16,0,192,-31,Severe
16,1,193,F,14,14,0,168,-25,Severe
7,9,93,M,11,10,0,120,27,Well
11,2,134,F,9,7,6,90,-44,Severe
16,1,193,F,6,6,6,78,-115,Severe
10,1,121,F,13,12,6,150,29,Well
18,9,225,M,12,11,6,138,-87,Severe
15,9,189,F,11,10,0,120,-69,Severe
10,1,121,M,13,12,6,150,29,Well
8,5,101,M,10,8,6,102,1,Good
6,10,82,F,8,7,0,84,2,Good
16,1,193,M,6,6,6,78,-115,Severe
9,8,116,F,13,12,6,150,34,Well
9,4,112,F,14,14,0,168,56,Well
13,5,161,F,15,16,0,192,31,Well
17,4,208,M,8,7,0,84,-124,Severe
10,10,130,M,7,6,6,78,-52,Severe
17,4,208,M,14,14,0,168,-40,Severe
17,2,206,F,7,6,6,78,-128,Severe
15,3,183,M,8,7,0,84,-99,Severe
16,2,194,F,7,6,6,78,-116,Severe
7,0,84,M,8,7,0,84,0,Neutral
8,7,103,M,15,16,0,192,89,Well
15,4,184,F,13,12,6,150,-34,Severe
8,9,105,M,9,7,6,90,-15,Severe
12,3,147,M,12,11,6,138,-9,Severe
13,8,164,F,10,8,6,102,-62,Severe
11,0,132,F,13,12,6,150,18,Well
13,1,157,M,13,12,6,150,-7,Severe
6,4,76,F,15,16,0,192,116,Well
11,11,143,M,12,11,6,138,-5,Mild
13,0,156,M,10,8,6,102,-54,Severe
9,3,111,F,13,12,6,150,39,Well
11,7,139,F,9,7,6,90,-49,Severe
18,8,224,F,10,8,6,102,-122,Severe
16,1,193,M,11,10,0,120,-73,Severe
11,9,141,M,12,11,6,138,-3,Mild
18,9,225,M,6,6,6,78,-147,Severe
16,6,198,M,15,16,0,192,-6,Severe
12,11,155,M,8,7,0,84,-71,Severe
8,5,101,M,14,14,0,168,67,Well
11,0,132,M,13,12,6,150,18,Well
10,9,129,M,11,10,0,120,-9,Severe
15,9,189,M,10,8,6,102,-87,Severe
14,8,176,F,15,16,0,192,16,Well
11,6,138,F,14,14,0,168,30,Well
18,3,219,M,6,6,6,78,-141,Severe
18,3,219,F,14,14,0,168,-51,Severe
13,5,161,F,14,14,0,168,7,Well
14,6,174,F,15,16,0,192,18,Well
13,4,160,F,7,6,6,78,-82,Severe
13,4,160,M,8,7,0,84,-76,Severe
9,3,111,F,8,7,0,84,-27,Severe
6,3,75,M,6,6,6,78,3,Good
8,2,98,F,8,7,0,84,-14,Severe
17,9,213,M,11,10,0,120,-93,Severe
5,7,67,F,15,16,0,192,125,Well
10,4,124,M,12,11,6,138,14,Well
11,9,141,M,14,14,0,168,27,Well
10,10,130,M,6,6,6,78,-52,Severe
9,5,113,F,12,11,6,138,25,Well
10,5,125,F,11,10,0,120,-5,Mild
11,5,137,M,15,16,0,192,55,Well
8,9,105,F,15,16,0,192,87,Well
7,9,93,M,8,7,0,84,-9,Severe
11,5,137,F,8,7,0,84,-53,Severe
18,8,224,F,12,11,6,138,-86,Severe
12,11,155,M,6,6,6,78,-77,Severe
6,0,72,F,14,14,0,168,96,Well
16,6,198,M,14,14,0,168,-30,Severe
7,6,90,F,13,12,6,150,60,Well
10,9,129,M,13,12,6,150,21,Well
13,1,157,M,15,16,0,192,35,Well
15,4,184,M,8,7,0,84,-100,Severe
14,4,172,F,7,6,6,78,-94,Severe
9,10,118,F,6,6,6,78,-40,Severe
12,9,153,M,11,10,0,120,-33,Severe
16,11,203,M,11,10,0,120,-83,Severe
16,10,202,F,15,16,0,192,-10,Severe
15,11,191,F,15,16,0,192,1,Good
16,8,200,F,9,7,6,90,-110,Severe
15,0,180,M,10,8,6,102,-78,Severe
9,7,115,M,8,7,0,84,-31,Severe
15,8,188,F,14,14,0,168,-20,Severe
17,10,214,M,7,6,6,78,-136,Severe
6,10,82,M,11,10,0,120,38,Well
16,7,199,M,6,6,6,78,-121,Severe
16,0,192,F,14,14,0,168,-24,Severe
11,7,139,F,13,12,6,150,11,Well
13,0,156,M,11,10,0,120,-36,Severe
5,3,63,F,14,14,0,168,105,Well
5,3,63,F,13,12,6,150,87,Well
13,9,165,M,14,14,0,168,3,Good
12,8,152,F,8,7,0,84,-68,Severe
6,5,77,M,8,7,0,84,7,Well
8,8,104,M,13,12,6,150,46,Well
7,3,87,F,12,11,6,138,51,Well
11,0,132,M,14,14,0,168,36,Well
15,8,188,M,9,7,6,90,-98,Severe
6,0,72,F,11,10,0,120,48,Well
13,3,159,M,15,16,0,192,33,Well
11,11,143,F,14,14,0,168,25,Well
5,8,68,F,9,7,6,90,22,Well
10,11,131,M,14,14,0,168,37,Well
9,2,110,M,6,6,6,78,-32,Severe
15,3,183,F,15,16,0,192,9,Well
18,5,221,F,10,8,6,102,-119,Severe
13,3,159,F,11,10,0,120,-39,Severe
18,5,221,F,13,12,6,150,-71,Severe
18,7,223,F,14,14,0,168,-55,Severe
15,8,188,M,7,6,6,78,-110,Severe
9,10,118,M,14,14,0,168,50,Well
14,7,175,M,6,6,6,78,-97,Severe
17,6,210,F,8,7,0,84,-126,Severe
6,11,83,F,10,8,6,102,19,Well
12,6,150,M,11,10,0,120,-30,Severe
5,8,68,F,7,6,6,78,10,Well
12,5,149,M,11,10,0,120,-29,Severe
11,7,139,F,12,11,6,138,-1,Mild
6,1,73,M,6,6,6,78,5,Good
15,3,183,F,9,7,6,90,-93,Severe
9,10,118,M,6,6,6,78,-40,Severe
7,11,95,F,14,14,0,168,73,Well
8,10,106,F,13,12,6,150,44,Well
12,8,152,M,15,16,0,192,40,Well
15,10,190,M,7,6,6,78,-112,Severe
9,8,116,F,11,10,0,120,4,Good
11,3,135,F,6,6,6,78,-57,Severe
8,1,97,F,9,7,6,90,-7,Severe
16,3,195,F,15,16,0,192,-3,Mild
8,9,105,F,10,8,6,102,-3,Mild
11,10,142,M,11,10,0,120,-22,Severe
10,9,129,F,12,11,6,138,9,Well
10,7,127,M,13,12,6,150,23,Well
18,4,220,F,6,6,6,78,-142,Severe
9,4,112,M,12,11,6,138,26,Well
8,2,98,M,7,6,6,78,-20,Severe
12,7,151,F,9,7,6,90,-61,Severe
10,7,127,F,12,11,6,138,11,Well
7,8,92,F,12,11,6,138,46,Well
6,6,78,M,13,12,6,150,72,Well
17,3,207,F,14,14,0,168,-39,Severe
11,4,136,F,7,6,6,78,-58,Severe
7,1,85,M,15,16,0,192,107,Well
7,4,88,F,15,16,0,192,104,Well
10,11,131,F,9,7,6,90,-41,Severe
10,11,131,M,13,12,6,150,19,Well
16,2,194,F,8,7,0,84,-110,Severe
7,4,88,F,13,12,6,150,62,Well
8,10,106,F,7,6,6,78,-28,Severe
18,4,220,F,10,8,6,102,-118,Severe
6,1,73,M,8,7,0,84,11,Well
17,5,209,F,6,6,6,78,-131,Severe
17,5,209,M,8,7,0,84,-125,Severe
9,7,115,F,10,8,6,102,-13,Severe
18,2,218,F,9,7,6,90,-128,Severe
15,1,181,F,6,6,6,78,-103,Severe
16,2,194,F,13,12,6,150,-44,Severe
8,7,103,F,8,7,0,84,-19,Severe
12,4,148,F,7,6,6,78,-70,Severe
8,1,97,F,12,11,6,138,41,Well
12,0,144,F,14,14,0,168,24,Well
10,2,122,F,14,14,0,168,46,Well
11,10,142,F,15,16,0,192,50,Well
7,9,93,F,11,10,0,120,27,Well
5,3,63,F,6,6,6,78,15,Well
12,3,147,F,13,12,6,150,3,Good
6,0,72,F,9,7,6,90,18,Well
6,7,79,F,14,14,0,168,89,Well
6,10,82,M,14,14,0,168,86,Well
11,1,133,M,13,12,6,150,17,Well
13,10,166,M,6,6,6,78,-88,Severe
10,2,122,M,11,10,0,120,-2,Mild
15,5,185,M,15,16,0,192,7,Well
11,10,142,M,7,6,6,78,-64,Severe
12,3,147,M,8,7,0,84,-63,Severe
10,7,127,F,6,6,6,78,-49,Severe
12,11,155,F,6,6,6,78,-77,Severe
7,7,91,M,7,6,6,78,-13,Severe
15,2,182,M,14,14,0,168,-14,Severe
7,5,89,M,8,7,0,84,-5,Mild
5,4,64,F,9,7,6,90,26,Well
18,5,221,M,6,6,6,78,-143,Severe
11,11,143,F,7,6,6,78,-65,Severe
18,9,225,M,10,8,6,102,-123,Severe
6,5,77,M,13,12,6,150,73,Well
5,10,70,M,10,8,6,102,32,Well
17,0,204,F,7,6,6,78,-126,Severe
9,4,112,M,11,10,0,120,8,Well
14,1,169,F,13,12,6,150,-19,Severe
9,9,117,F,15,16,0,192,75,Well
13,0,156,F,14,14,0,168,12,Well
11,6,138,M,8,7,0,84,-54,Severe
12,9,153,M,9,7,6,90,-63,Severe
13,9,165,M,15,16,0,192,27,Well
5,2,62,M,6,6,6,78,16,Well
5,0,60,M,12,11,6,138,78,Well
14,4,172,M,13,12,6,150,-22,Severe
13,10,166,M,10,8,6,102,-64,Severe
16,2,194,M,8,7,0,84,-110,Severe
6,11,83,M,11,10,0,120,37,Well
6,9,81,F,12,11,6,138,57,Well
6,2,74,F,6,6,6,78,4,Good
9,2,110,F,14,14,0,168,58,Well
5,9,69,M,7,6,6,78,9,Well
17,6,210,M,6,6,6,78,-132,Severe
11,2,134,M,7,6,6,78,-56,Severe
16,2,194,M,11,10,0,120,-74,Severe
8,5,101,F,14,14,0,168,67,Well
18,10,226,F,11,10,0,120,-106,Severe
11,0,132,F,10,8,6,102,-30,Severe
5,10,70,F,6,6,6,78,8,Well
10,2,122,F,9,7,6,90,-32,Severe
16,7,199,F,12,11,6,138,-61,Severe
10,4,124,M,8,7,0,84,-40,Severe
8,5,101,F,8,7,0,84,-17,Severe
16,5,197,F,10,8,6,102,-95,Severe
15,9,189,F,10,8,6,102,-87,Severe
11,7,139,M,8,7,0,84,-55,Severe
14,6,174,M,15,16,0,192,18,Well
13,5,161,F,10,8,6,102,-59,Severe
12,2,146,M,8,7,0,84,-62,Severe
7,11,95,F,6,6,6,78,-17,Severe
12,0,144,M,14,14,0,168,24,Well
6,4,76,M,13,12,6,150,74,Well
16,6,198,F,9,7,6,90,-108,Severe
7,3,87,M,12,11,6,138,51,Well
12,7,151,F,14,14,0,168,17,Well
16,1,193,F,11,10,0,120,-73,Severe
14,6,174,M,13,12,6,150,-24,Severe
10,3,123,F,10,8,6,102,-21,Severe
11,4,136,M,9,7,6,90,-46,Severe
18,8,224,F,13,12,6,150,-74,Severe
9,10,118,F,13,12,6,150,32,Well
15,7,187,M,12,11,6,138,-49,Severe
17,0,204,M,11,10,0,120,-84,Severe
10,1,121,F,14,14,0,168,47,Well
6,9,81,M,11,10,0,120,39,Well
13,10,166,F,15,16,0,192,26,Well
11,8,140,F,10,8,6,102,-38,Severe
5,6,66,F,10,8,6,102,36,Well
12,3,147,F,14,14,0,168,21,Well
14,11,179,M,11,10,0,120,-59,Severe
8,8,104,F,9,7,6,90,-14,Severe
12,2,146,M,6,6,6,78,-68,Severe
13,9,165,M,12,11,6,138,-27,Severe
8,8,104,F,10,8,6,102,-2,Mild
6,7,79,F,12,11,6,138,59,Well
13,3,159,F,6,6,6,78,-81,Severe
8,9,105,M,6,6,6,78,-27,Severe
15,6,186,M,11,10,0,120,-66,Severe
14,6,174,F,9,7,6,90,-84,Severe
6,9,81,M,7,6,6,78,-3,Mild
5,8,68,M,11,10,0,120,52,Well
6,3,75,M,9,7,6,90,15,Well
12,6,150,F,12,11,6,138,-12,Severe
9,4,112,F,10,8,6,102,-10,Severe
6,0,72,F,6,6,6,78,6,Well
7,3,87,M,13,12,6,150,63,Well
12,1,145,F,15,16,0,192,47,Well
17,3,207,M,14,14,0,168,-39,Severe
8,0,96,M,15,16,0,192,96,Well
14,1,169,F,14,14,0,168,-1,Mild
18,10,226,M,14,14,0,168,-58,Severe
15,8,188,F,15,16,0,192,4,Good
17,0,204,F,11,10,0,120,-84,Severe
5,9,69,M,13,12,6,150,81,Well
15,6,186,M,14,14,0,168,-18,Severe
15,11,191,M,12,11,6,138,-53,Severe
17,8,212,F,10,8,6,102,-110,Severe
5,9,69,M,10,8,6,102,33,Well
7,2,86,F,9,7,6,90,4,Good
13,2,158,F,12,11,6,138,-20,Severe
9,7,115,F,12,11,6,138,23,Well
11,4,136,F,8,7,0,84,-52,Severe
18,5,221,M,8,7,0,84,-137,Severe
9,1,109,F,12,11,6,138,29,Well
9,9,117,M,9,7,6,90,-27,Severe
13,8,164,F,13,12,6,150,-14,Severe
15,1,181,M,10,8,6,102,-79,Severe
9,1,109,M,8,7,0,84,-25,Severe
15,2,182,F,13,12,6,150,-32,Severe
17,8,212,M,13,12,6,150,-62,Severe
6,5,77,F,12,11,6,138,61,Well
17,10,214,M,15,16,0,192,-22,Severe
8,6,102,F,10,8,6,102,0,Neutral
6,1,73,F,12,11,6,138,65,Well
6,8,80,M,14,14,0,168,88,Well
17,4,208,F,7,6,6,78,-130,Severe
5,9,69,F,11,10,0,120,51,Well
12,10,154,M,14,14,0,168,14,Well
6,4,76,M,11,10,0,120,44,Well
15,5,185,F,9,7,6,90,-95,Severe
16,8,200,F,13,12,6,150,-50,Severe
11,5,137,F,6,6,6,78,-59,Severe
10,2,122,M,9,7,6,90,-32,Severe
5,8,68,F,15,16,0,192,124,Well
12,0,144,M,13,12,6,150,6,Well
17,7,211,F,13,12,6,150,-61,Severe
18,3,219,M,14,14,0,168,-51,Severe
15,0,180,M,7,6,6,78,-102,Severe
14,4,172,M,15,16,0,192,20,Well
8,9,105,M,12,11,6,138,33,Well
14,7,175,F,15,16,0,192,17,Well
16,6,198,M,9,7,6,90,-108,Severe
10,6,126,M,7,6,6,78,-48,Severe
9,9,117,M,15,16,0,192,75,Well
16,6,198,M,8,7,0,84,-114,Severe
14,3,171,M,11,10,0,120,-51,Severe
13,5,161,M,12,11,6,138,-23,Severe
10,5,125,M,13,12,6,150,25,Well
5,6,66,M,13,12,6,150,84,Well
5,1,61,F,8,7,0,84,23,Well
17,11,215,M,12,11,6,138,-77,Severe
11,5,137,F,15,16,0,192,55,Well
17,11,215,F,10,8,6,102,-113,Severe
5,5,65,F,10,8,6,102,37,Well
6,3,75,F,7,6,6,78,3,Good
8,6,102,F,7,6,6,78,-24,Severe
6,7,79,F,10,8,6,102,23,Well
9,9,117,F,7,6,6,78,-39,Severe
5,0,60,M,15,16,0,192,132,Well
7,11,95,M,8,7,0,84,-11,Severe
18,11,227,F,14,14,0,168,-59,Severe
16,2,194,M,13,12,6,150,-44,Severe
7,9,93,F,14,14,0,168,75,Well
9,8,116,F,15,16,0,192,76,Well
9,4,112,F,12,11,6,138,26,Well
13,8,164,F,7,6,6,78,-86,Severe
12,7,151,M,9,7,6,90,-61,Severe
18,0,216,M,8,7,0,84,-132,Severe
6,0,72,M,9,7,6,90,18,Well
9,5,113,F,14,14,0,168,55,Well
12,1,145,M,7,6,6,78,-67,Severe
13,10,166,F,12,11,6,138,-28,Severe
14,1,169,M,13,12,6,150,-19,Severe
10,7,127,M,6,6,6,78,-49,Severe
13,11,167,M,7,6,6,78,-89,Severe
10,1,121,F,11,10,0,120,-1,Mild
8,11,107,F,8,7,0,84,-23,Severe
10,9,129,F,13,12,6,150,21,Well
15,11,191,F,7,6,6,78,-113,Severe
11,3,135,F,9,7,6,90,-45,Severe
11,4,136,M,13,12,6,150,14,Well
16,0,192,M,12,11,6,138,-54,Severe
10,2,122,M,15,16,0,192,70,Well
14,10,178,M,7,6,6,78,-100,Severe
5,1,61,F,7,6,6,78,17,Well
12,2,146,M,7,6,6,78,-68,Severe
18,10,226,F,7,6,6,78,-148,Severe
7,11,95,M,12,11,6,138,43,Well
6,4,76,M,7,6,6,78,2,Good
